country,year,type,age,f,m,total
Afghanistan,1997,sp,014,5,0,5
Afghanistan,1997,sp,1524,38,10,48
Afghanistan,1997,sp,2534,36,6,42
Afghanistan,1997,sp,3544,14,3,17
Afghanistan,1997,sp,4554,8,5,13
Afghanistan,1997,sp,5564,0,2,2
Afghanistan,1997,sp,65,1,0,1
Afghanistan,1998,sp,014,45,30,75
Afghanistan,1998,sp,1524,350,129,479
Afghanistan,1998,sp,2534,419,128,547
Afghanistan,1998,sp,3544,194,90,284
Afghanistan,1998,sp,4554,118,89,207
Afghanistan,1998,sp,5564,61,64,125
Afghanistan,1998,sp,65,20,41,61
Afghanistan,1999,sp,014,25,8,33
Afghanistan,1999,sp,1524,139,55,194
Afghanistan,1999,sp,2534,160,55,215
Afghanistan,1999,sp,3544,110,47,157
Afghanistan,1999,sp,4554,50,34,84
Afghanistan,1999,sp,5564,25,21,46
Afghanistan,1999,sp,65,8,8,16
Afghanistan,2000,sp,014,93,52,145
Afghanistan,2000,sp,1524,414,228,642
Afghanistan,2000,sp,2534,565,183,748
Afghanistan,2000,sp,3544,339,149,488
Afghanistan,2000,sp,4554,205,129,334
Afghanistan,2000,sp,5564,99,94,193
Afghanistan,2000,sp,65,36,80,116
Afghanistan,2001,sp,014,146,129,275
Afghanistan,2001,sp,1524,799,379,1178
Afghanistan,2001,sp,2534,888,349,1237
Afghanistan,2001,sp,3544,586,274,860
Afghanistan,2001,sp,4554,375,204,579
Afghanistan,2001,sp,5564,179,139,318
Afghanistan,2001,sp,65,89,103,192
Afghanistan,2002,sp,014,192,90,282
Afghanistan,2002,sp,1524,1119,476,1595
Afghanistan,2002,sp,2534,1251,481,1732
Afghanistan,2002,sp,3544,792,368,1160
Afghanistan,2002,sp,4554,526,246,772
Afghanistan,2002,sp,5564,320,241,561
Afghanistan,2002,sp,65,218,189,407
Afghanistan,2003,sp,014,245,127,372
Afghanistan,2003,sp,1524,1152,511,1663
Afghanistan,2003,sp,2534,1287,436,1723
Afghanistan,2003,sp,3544,814,284,1098
Afghanistan,2003,sp,4554,462,256,718
Afghanistan,2003,sp,5564,305,288,593
Afghanistan,2003,sp,65,158,203,361
Afghanistan,2004,sp,014,256,139,395
Afghanistan,2004,sp,1524,1360,537,1897
Afghanistan,2004,sp,2534,1561,568,2129
Afghanistan,2004,sp,3544,1096,360,1456
Afghanistan,2004,sp,4554,645,358,1003
Afghanistan,2004,sp,5564,413,386,799
Afghanistan,2004,sp,65,256,310,566
Afghanistan,2005,sp,014,320,151,471
Afghanistan,2005,sp,1524,1651,606,2257
Afghanistan,2005,sp,2534,1959,560,2519
Afghanistan,2005,sp,3544,1302,472,1774
Afghanistan,2005,sp,4554,869,453,1322
Afghanistan,2005,sp,5564,471,470,941
Afghanistan,2005,sp,65,246,419,665
Afghanistan,2006,sp,014,442,193,635
Afghanistan,2006,sp,1524,2139,837,2976
Afghanistan,2006,sp,2534,2340,791,3131
Afghanistan,2006,sp,3544,1654,574,2228
Afghanistan,2006,sp,4554,1006,572,1578
Afghanistan,2006,sp,5564,630,572,1202
Afghanistan,2006,sp,65,309,410,719
Afghanistan,2007,ep,014,NA,0,NA
Afghanistan,2007,ep,1524,NA,0,NA
Afghanistan,2007,ep,2534,NA,0,NA
Afghanistan,2007,ep,3544,NA,0,NA
Afghanistan,2007,ep,4554,NA,0,NA
Afghanistan,2007,ep,5564,NA,0,NA
Afghanistan,2007,ep,65,NA,0,NA
Afghanistan,2007,sn,014,NA,0,NA
Afghanistan,2007,sn,1524,NA,0,NA
Afghanistan,2007,sn,2534,NA,0,NA
Afghanistan,2007,sn,3544,NA,0,NA
Afghanistan,2007,sn,4554,NA,0,NA
Afghanistan,2007,sn,5564,NA,0,NA
Afghanistan,2007,sn,65,NA,0,NA
Afghanistan,2007,sp,014,475,186,661
Afghanistan,2007,sp,1524,2224,856,3080
Afghanistan,2007,sp,2534,2357,840,3197
Afghanistan,2007,sp,3544,1708,597,2305
Afghanistan,2007,sp,4554,1143,566,1709
Afghanistan,2007,sp,5564,771,630,1401
Afghanistan,2007,sp,65,353,507,860
Afghanistan,2008,sp,014,428,187,615
Afghanistan,2008,sp,1524,2094,941,3035
Afghanistan,2008,sp,2534,2449,773,3222
Afghanistan,2008,sp,3544,1614,545,2159
Afghanistan,2008,sp,4554,1149,570,1719
Afghanistan,2008,sp,5564,817,630,1447
Afghanistan,2008,sp,65,364,575,939
Afghanistan,2009,sp,014,439,200,639
Afghanistan,2009,sp,1524,2173,906,3079
Afghanistan,2009,sp,2534,2186,705,2891
Afghanistan,2009,sp,3544,1541,499,2040
Afghanistan,2009,sp,4554,1014,491,1505
Afghanistan,2009,sp,5564,764,596,1360
Afghanistan,2009,sp,65,419,570,989
Afghanistan,2010,sp,014,445,197,642
Afghanistan,2010,sp,1524,2107,986,3093
Afghanistan,2010,sp,2534,2263,819,3082
Afghanistan,2010,sp,3544,1455,491,1946
Afghanistan,2010,sp,4554,1112,490,1602
Afghanistan,2010,sp,5564,831,641,1472
Afghanistan,2010,sp,65,488,622,1110
Afghanistan,2011,sn,014,851,902,1753
Afghanistan,2011,sp,014,465,204,669
Afghanistan,2011,sp,1524,2167,1010,3177
Afghanistan,2011,sp,2534,2325,895,3220
Afghanistan,2011,sp,3544,1564,613,2177
Afghanistan,2011,sp,4554,1146,570,1716
Afghanistan,2011,sp,5564,903,700,1603
Afghanistan,2011,sp,65,535,692,1227
Afghanistan,2012,sn,014,1190,1265,2455
Afghanistan,2012,sp,014,400,188,588
Afghanistan,2012,sp,1524,2280,1116,3396
Afghanistan,2012,sp,2534,2204,801,3005
Afghanistan,2012,sp,3544,1482,586,2068
Afghanistan,2012,sp,4554,1150,521,1671
Afghanistan,2012,sp,5564,850,585,1435
Afghanistan,2012,sp,65,505,651,1156
Afghanistan,2013,rel,014,1749,1705,3454
Albania,1995,sp,014,0,0,0
Albania,1995,sp,1524,1,0,1
Albania,1995,sp,2534,0,0,0
Albania,1995,sp,3544,0,0,0
Albania,1995,sp,4554,13,19,32
Albania,1995,sp,5564,20,40,60
Albania,1995,sp,65,16,30,46
Albania,1997,sp,014,1,0,1
Albania,1997,sp,1524,16,23,39
Albania,1997,sp,2534,19,43,62
Albania,1997,sp,3544,14,33,47
Albania,1997,sp,4554,9,25,34
Albania,1997,sp,5564,10,21,31
Albania,1997,sp,65,8,19,27
Albania,1998,sp,014,2,1,3
Albania,1998,sp,1524,19,17,36
Albania,1998,sp,2534,11,21,32
Albania,1998,sp,3544,12,24,36
Albania,1998,sp,4554,13,18,31
Albania,1998,sp,5564,11,26,37
Albania,1998,sp,65,13,24,37
Albania,1999,sp,014,0,0,0
Albania,1999,sp,1524,5,13,18
Albania,1999,sp,2534,13,23,36
Albania,1999,sp,3544,11,25,36
Albania,1999,sp,4554,5,19,24
Albania,1999,sp,5564,8,15,23
Albania,1999,sp,65,16,15,31
Albania,2000,sp,014,3,2,5
Albania,2000,sp,1524,11,19,30
Albania,2000,sp,2534,10,21,31
Albania,2000,sp,3544,8,14,22
Albania,2000,sp,4554,8,24,32
Albania,2000,sp,5564,5,19,24
Albania,2000,sp,65,11,16,27
Albania,2001,sp,014,1,3,4
Albania,2001,sp,1524,12,13,25
Albania,2001,sp,2534,10,18,28
Albania,2001,sp,3544,5,17,22
Albania,2001,sp,4554,7,19,26
Albania,2001,sp,5564,7,20,27
Albania,2001,sp,65,9,30,39
Albania,2002,sp,014,2,0,2
Albania,2002,sp,1524,20,21,41
Albania,2002,sp,2534,19,27,46
Albania,2002,sp,3544,9,29,38
Albania,2002,sp,4554,6,19,25
Albania,2002,sp,5564,8,23,31
Albania,2002,sp,65,17,25,42
Albania,2003,sp,014,2,0,2
Albania,2003,sp,1524,13,28,41
Albania,2003,sp,2534,8,19,27
Albania,2003,sp,3544,6,32,38
Albania,2003,sp,4554,14,16,30
Albania,2003,sp,5564,12,22,34
Albania,2003,sp,65,20,19,39
Albania,2004,sp,014,2,5,7
Albania,2004,sp,1524,12,12,24
Albania,2004,sp,2534,12,19,31
Albania,2004,sp,3544,8,21,29
Albania,2004,sp,4554,11,24,35
Albania,2004,sp,5564,10,23,33
Albania,2004,sp,65,22,20,42
Albania,2005,sp,014,0,0,0
Albania,2005,sp,1524,3,26,29
Albania,2005,sp,2534,9,21,30
Albania,2005,sp,3544,5,16,21
Albania,2005,sp,4554,5,31,36
Albania,2005,sp,5564,5,20,25
Albania,2005,sp,65,18,37,55
Albania,2006,ep,014,7,9,16
Albania,2006,ep,1524,8,19,27
Albania,2006,ep,2534,10,11,21
Albania,2006,ep,3544,9,18,27
Albania,2006,ep,4554,12,12,24
Albania,2006,ep,5564,15,9,24
Albania,2006,ep,65,15,21,36
Albania,2006,sn,014,4,15,19
Albania,2006,sn,1524,6,4,10
Albania,2006,sn,2534,3,5,8
Albania,2006,sn,3544,5,2,7
Albania,2006,sn,4554,3,8,11
Albania,2006,sn,5564,5,9,14
Albania,2006,sn,65,12,25,37
Albania,2006,sp,014,2,5,7
Albania,2006,sp,1524,12,24,36
Albania,2006,sp,2534,8,19,27
Albania,2006,sp,3544,7,22,29
Albania,2006,sp,4554,7,21,28
Albania,2006,sp,5564,7,19,26
Albania,2006,sp,65,13,20,33
Albania,2007,ep,014,1,9,10
Albania,2007,ep,1524,8,18,26
Albania,2007,ep,2534,9,9,18
Albania,2007,ep,3544,8,10,18
Albania,2007,ep,4554,13,14,27
Albania,2007,ep,5564,12,8,20
Albania,2007,ep,65,14,19,33
Albania,2007,sn,014,5,10,15
Albania,2007,sn,1524,5,9,14
Albania,2007,sn,2534,2,4,6
Albania,2007,sn,3544,1,7,8
Albania,2007,sn,4554,6,11,17
Albania,2007,sn,5564,6,13,19
Albania,2007,sn,65,9,17,26
Albania,2007,sp,014,2,0,2
Albania,2007,sp,1524,13,19,32
Albania,2007,sp,2534,9,13,22
Albania,2007,sp,3544,7,16,23
Albania,2007,sp,4554,7,24,31
Albania,2007,sp,5564,11,16,27
Albania,2007,sp,65,9,19,28
Albania,2008,ep,014,3,0,3
Albania,2008,ep,1524,12,11,23
Albania,2008,ep,2534,7,12,19
Albania,2008,ep,3544,10,6,16
Albania,2008,ep,4554,12,15,27
Albania,2008,ep,5564,10,13,23
Albania,2008,ep,65,16,18,34
Albania,2008,sn,014,6,8,14
Albania,2008,sn,1524,7,8,15
Albania,2008,sn,2534,2,2,4
Albania,2008,sn,3544,7,7,14
Albania,2008,sn,4554,5,5,10
Albania,2008,sn,5564,3,7,10
Albania,2008,sn,65,10,10,20
Albania,2008,sp,014,1,1,2
Albania,2008,sp,1524,20,23,43
Albania,2008,sp,2534,10,26,36
Albania,2008,sp,3544,8,13,21
Albania,2008,sp,4554,5,19,24
Albania,2008,sp,5564,5,13,18
Albania,2008,sp,65,10,16,26
Albania,2009,ep,014,2,2,4
Albania,2009,ep,1524,5,16,21
Albania,2009,ep,2534,5,6,11
Albania,2009,ep,3544,11,7,18
Albania,2009,ep,4554,8,14,22
Albania,2009,ep,5564,8,19,27
Albania,2009,ep,65,18,15,33
Albania,2009,sn,014,4,7,11
Albania,2009,sn,1524,7,9,16
Albania,2009,sn,2534,3,5,8
Albania,2009,sn,3544,5,9,14
Albania,2009,sn,4554,10,8,18
Albania,2009,sn,5564,2,10,12
Albania,2009,sn,65,10,20,30
Albania,2009,sp,014,2,0,2
Albania,2009,sp,1524,15,22,37
Albania,2009,sp,2534,7,21,28
Albania,2009,sp,3544,6,12,18
Albania,2009,sp,4554,9,24,33
Albania,2009,sp,5564,4,15,19
Albania,2009,sp,65,12,22,34
Albania,2010,ep,014,2,4,6
Albania,2010,ep,1524,10,26,36
Albania,2010,ep,2534,6,15,21
Albania,2010,ep,3544,8,16,24
Albania,2010,ep,4554,4,13,17
Albania,2010,ep,5564,9,14,23
Albania,2010,ep,65,17,21,38
Albania,2010,sn,014,4,6,10
Albania,2010,sn,1524,4,9,13
Albania,2010,sn,2534,3,7,10
Albania,2010,sn,3544,3,10,13
Albania,2010,sn,4554,6,13,19
Albania,2010,sn,5564,3,13,16
Albania,2010,sn,65,6,18,24
Albania,2010,sp,014,2,0,2
Albania,2010,sp,1524,11,28,39
Albania,2010,sp,2534,7,17,24
Albania,2010,sp,3544,6,14,20
Albania,2010,sp,4554,3,16,19
Albania,2010,sp,5564,2,16,18
Albania,2010,sp,65,8,15,23
Albania,2011,ep,014,3,1,4
Albania,2011,ep,1524,9,17,26
Albania,2011,ep,2534,4,10,14
Albania,2011,ep,3544,6,4,10
Albania,2011,ep,4554,12,12,24
Albania,2011,ep,5564,11,15,26
Albania,2011,ep,65,11,13,24
Albania,2011,sn,014,0,2,2
Albania,2011,sn,1524,3,11,14
Albania,2011,sn,2534,4,5,9
Albania,2011,sn,3544,4,6,10
Albania,2011,sn,4554,2,13,15
Albania,2011,sn,5564,10,17,27
Albania,2011,sn,65,9,19,28
Albania,2011,sp,014,1,0,1
Albania,2011,sp,1524,14,29,43
Albania,2011,sp,2534,10,26,36
Albania,2011,sp,3544,6,18,24
Albania,2011,sp,4554,2,30,32
Albania,2011,sp,5564,1,9,10
Albania,2011,sp,65,12,22,34
Albania,2012,ep,014,1,0,1
Albania,2012,ep,1524,5,15,20
Albania,2012,ep,2534,8,12,20
Albania,2012,ep,3544,2,5,7
Albania,2012,ep,4554,7,13,20
Albania,2012,ep,5564,5,11,16
Albania,2012,ep,65,9,13,22
Albania,2012,sn,014,1,1,2
Albania,2012,sn,1524,4,6,10
Albania,2012,sn,2534,8,9,17
Albania,2012,sn,3544,2,7,9
Albania,2012,sn,4554,3,10,13
Albania,2012,sn,5564,7,12,19
Albania,2012,sn,65,11,19,30
Albania,2012,sp,014,0,0,0
Albania,2012,sp,1524,17,33,50
Albania,2012,sp,2534,9,34,43
Albania,2012,sp,3544,6,16,22
Albania,2012,sp,4554,3,15,18
Albania,2012,sp,5564,6,11,17
Albania,2012,sp,65,12,23,35
Albania,2013,rel,014,5,14,19
Albania,2013,rel,1524,28,60,88
Albania,2013,rel,2534,34,61,95
Albania,2013,rel,3544,13,32,45
Albania,2013,rel,4554,18,44,62
Albania,2013,rel,5564,14,50,64
Albania,2013,rel,65,34,67,101
Algeria,1997,sp,014,92,659,751
Algeria,1997,sp,1524,1102,1422,2524
Algeria,1997,sp,2534,702,1982,2684
Algeria,1997,sp,3544,405,639,1044
Algeria,1997,sp,4554,242,357,599
Algeria,1997,sp,5564,236,312,548
Algeria,1997,sp,65,356,396,752
Algeria,1999,sp,014,92,40,132
Algeria,1999,sp,1524,884,1193,2077
Algeria,1999,sp,2534,621,1344,1965
Algeria,1999,sp,3544,281,556,837
Algeria,1999,sp,4554,221,706,927
Algeria,1999,sp,5564,243,263,506
Algeria,1999,sp,65,329,315,644
Algeria,2000,sp,014,36,59,95
Algeria,2000,sp,1524,1005,927,1932
Algeria,2000,sp,2534,1293,1516,2809
Algeria,2000,sp,3544,746,610,1356
Algeria,2000,sp,4554,314,491,805
Algeria,2000,sp,5564,208,234,442
Algeria,2000,sp,65,312,299,611
Algeria,2001,sp,014,79,41,120
Algeria,2001,sp,1524,1057,1345,2402
Algeria,2001,sp,2534,782,1614,2396
Algeria,2001,sp,3544,352,708,1060
Algeria,2001,sp,4554,287,401,688
Algeria,2001,sp,5564,280,283,563
Algeria,2001,sp,65,334,390,724
Algeria,2002,sp,014,71,39,110
Algeria,2002,sp,1524,1840,1364,3204
Algeria,2002,sp,2534,730,1580,2310
Algeria,2002,sp,3544,334,630,964
Algeria,2002,sp,4554,224,406,630
Algeria,2002,sp,5564,217,273,490
Algeria,2002,sp,65,258,280,538
Algeria,2003,sp,014,74,40,114
Algeria,2003,sp,1524,1017,1316,2333
Algeria,2003,sp,2534,702,1633,2335
Algeria,2003,sp,3544,326,706,1032
Algeria,2003,sp,4554,242,429,671
Algeria,2003,sp,5564,241,231,472
Algeria,2003,sp,65,356,328,684
Algeria,2004,sp,014,92,63,155
Algeria,2004,sp,1524,1011,1326,2337
Algeria,2004,sp,2534,798,1694,2492
Algeria,2004,sp,3544,320,758,1078
Algeria,2004,sp,4554,253,434,687
Algeria,2004,sp,5564,227,271,498
Algeria,2004,sp,65,359,373,732
Algeria,2005,sp,014,102,53,155
Algeria,2005,sp,1524,1044,1309,2353
Algeria,2005,sp,2534,820,1841,2661
Algeria,2005,sp,3544,389,919,1308
Algeria,2005,sp,4554,270,473,743
Algeria,2005,sp,5564,229,314,543
Algeria,2005,sp,65,465,426,891
Algeria,2006,sp,014,80,41,121
Algeria,2006,sp,1524,971,1173,2144
Algeria,2006,sp,2534,679,1573,2252
Algeria,2006,sp,3544,339,692,1031
Algeria,2006,sp,4554,223,409,632
Algeria,2006,sp,5564,197,251,448
Algeria,2006,sp,65,408,360,768
Algeria,2007,sp,014,109,95,204
Algeria,2007,sp,1524,1031,1388,2419
Algeria,2007,sp,2534,811,1749,2560
Algeria,2007,sp,3544,335,813,1148
Algeria,2007,sp,4554,273,494,767
Algeria,2007,sp,5564,247,296,543
Algeria,2007,sp,65,391,407,798
Algeria,2008,sp,014,150,99,249
Algeria,2008,sp,1524,1263,1505,2768
Algeria,2008,sp,2534,827,1786,2613
Algeria,2008,sp,3544,346,794,1140
Algeria,2008,sp,4554,256,447,703
Algeria,2008,sp,5564,226,198,424
Algeria,2008,sp,65,286,463,749
Algeria,2009,sp,014,90,43,133
Algeria,2009,sp,1524,1021,1225,2246
Algeria,2009,sp,2534,860,1827,2687
Algeria,2009,sp,3544,363,898,1261
Algeria,2009,sp,4554,270,541,811
Algeria,2009,sp,5564,241,319,560
Algeria,2009,sp,65,340,364,704
Algeria,2010,sp,014,79,52,131
Algeria,2010,sp,1524,1086,1203,2289
Algeria,2010,sp,2534,826,1669,2495
Algeria,2010,sp,3544,417,825,1242
Algeria,2010,sp,4554,251,513,764
Algeria,2010,sp,5564,222,392,614
Algeria,2010,sp,65,367,397,764
Algeria,2011,sp,014,58,42,100
Algeria,2011,sp,1524,1050,1147,2197
Algeria,2011,sp,2534,787,1513,2300
Algeria,2011,sp,3544,383,881,1264
Algeria,2011,sp,4554,211,483,694
Algeria,2011,sp,5564,202,345,547
Algeria,2011,sp,65,341,347,688
Algeria,2012,sp,014,60,29,89
Algeria,2012,sp,1524,917,1102,2019
Algeria,2012,sp,2534,773,1467,2240
Algeria,2012,sp,3544,382,857,1239
Algeria,2012,sp,4554,198,464,662
Algeria,2012,sp,5564,229,354,583
Algeria,2012,sp,65,329,349,678
Algeria,2013,rel,014,50,25,75
Algeria,2013,rel,1524,861,1021,1882
Algeria,2013,rel,2534,707,1288,1995
Algeria,2013,rel,3544,377,763,1140
Algeria,2013,rel,4554,267,475,742
Algeria,2013,rel,5564,205,324,529
Algeria,2013,rel,65,352,409,761
American Samoa,1997,sp,014,0,1,1
American Samoa,1997,sp,1524,0,0,0
American Samoa,1997,sp,2534,0,0,0
American Samoa,1997,sp,3544,0,1,1
American Samoa,1997,sp,4554,1,1,2
American Samoa,1997,sp,5564,0,1,1
American Samoa,1997,sp,65,0,1,1
American Samoa,2000,sp,4554,1,1,2
American Samoa,2000,sp,5564,NA,1,NA
American Samoa,2001,sp,3544,1,NA,NA
American Samoa,2001,sp,5564,1,NA,NA
American Samoa,2002,sp,5564,NA,1,NA
American Samoa,2003,sp,4554,1,NA,NA
American Samoa,2003,sp,5564,NA,1,NA
American Samoa,2004,sp,4554,1,NA,NA
American Samoa,2004,sp,5564,NA,2,NA
American Samoa,2005,sp,2534,1,NA,NA
American Samoa,2005,sp,4554,2,NA,NA
American Samoa,2006,ep,2534,1,NA,NA
American Samoa,2006,sp,2534,1,NA,NA
American Samoa,2006,sp,4554,2,NA,NA
American Samoa,2007,sn,014,0,0,0
American Samoa,2007,sn,1524,0,1,1
American Samoa,2007,sn,2534,0,0,0
American Samoa,2007,sn,3544,0,0,0
American Samoa,2007,sn,4554,1,1,2
American Samoa,2007,sn,5564,0,0,0
American Samoa,2007,sn,65,0,0,0
American Samoa,2008,ep,014,0,0,0
American Samoa,2008,ep,1524,0,0,0
American Samoa,2008,ep,2534,0,0,0
American Samoa,2008,ep,3544,0,0,0
American Samoa,2008,ep,4554,0,0,0
American Samoa,2008,ep,5564,0,0,0
American Samoa,2008,ep,65,0,0,0
American Samoa,2008,sn,014,0,0,0
American Samoa,2008,sn,1524,1,0,1
American Samoa,2008,sn,2534,0,0,0
American Samoa,2008,sn,3544,0,0,0
American Samoa,2008,sn,4554,1,1,2
American Samoa,2008,sn,5564,0,0,0
American Samoa,2008,sn,65,0,0,0
American Samoa,2008,sp,014,0,0,0
American Samoa,2008,sp,1524,0,0,0
American Samoa,2008,sp,2534,0,0,0
American Samoa,2008,sp,3544,0,0,0
American Samoa,2008,sp,4554,0,0,0
American Samoa,2008,sp,5564,0,0,0
American Samoa,2008,sp,65,0,0,0
American Samoa,2009,ep,014,0,0,0
American Samoa,2009,ep,1524,0,0,0
American Samoa,2009,ep,2534,1,0,1
American Samoa,2009,ep,3544,0,0,0
American Samoa,2009,ep,4554,0,1,1
American Samoa,2009,ep,5564,0,0,0
American Samoa,2009,ep,65,0,0,0
American Samoa,2009,sn,014,0,0,0
American Samoa,2009,sn,1524,0,0,0
American Samoa,2009,sn,2534,0,0,0
American Samoa,2009,sn,3544,0,0,0
American Samoa,2009,sn,4554,2,0,2
American Samoa,2009,sn,5564,0,0,0
American Samoa,2009,sn,65,0,0,0
American Samoa,2009,sp,014,0,0,0
American Samoa,2009,sp,1524,0,0,0
American Samoa,2009,sp,2534,0,0,0
American Samoa,2009,sp,3544,0,0,0
American Samoa,2009,sp,4554,0,0,0
American Samoa,2009,sp,5564,0,0,0
American Samoa,2009,sp,65,0,0,0
American Samoa,2010,ep,014,0,0,0
American Samoa,2010,ep,1524,0,0,0
American Samoa,2010,ep,2534,0,0,0
American Samoa,2010,ep,3544,0,0,0
American Samoa,2010,ep,4554,0,1,1
American Samoa,2010,ep,5564,0,0,0
American Samoa,2010,ep,65,0,0,0
American Samoa,2010,sn,014,0,0,0
American Samoa,2010,sn,1524,0,0,0
American Samoa,2010,sn,2534,1,1,2
American Samoa,2010,sn,3544,0,0,0
American Samoa,2010,sn,4554,0,0,0
American Samoa,2010,sn,5564,0,0,0
American Samoa,2010,sn,65,0,1,1
American Samoa,2010,sp,014,0,0,0
American Samoa,2010,sp,1524,0,0,0
American Samoa,2010,sp,2534,0,0,0
American Samoa,2010,sp,3544,0,0,0
American Samoa,2010,sp,4554,0,0,0
American Samoa,2010,sp,5564,0,0,0
American Samoa,2010,sp,65,0,0,0
American Samoa,2011,sn,3544,1,NA,NA
American Samoa,2011,sn,4554,NA,1,NA
American Samoa,2011,sn,5564,NA,1,NA
Andorra,1996,sp,014,0,0,0
Andorra,1996,sp,1524,1,0,1
Andorra,1996,sp,2534,1,0,1
Andorra,1996,sp,3544,0,4,4
Andorra,1996,sp,4554,0,1,1
Andorra,1996,sp,5564,1,0,1
Andorra,1996,sp,65,0,0,0
Andorra,1997,sp,014,0,0,0
Andorra,1997,sp,1524,1,0,1
Andorra,1997,sp,2534,2,1,3
Andorra,1997,sp,3544,3,2,5
Andorra,1997,sp,4554,0,2,2
Andorra,1997,sp,5564,0,1,1
Andorra,1997,sp,65,1,6,7
Andorra,1998,sp,014,NA,0,NA
Andorra,1998,sp,1524,NA,0,NA
Andorra,1998,sp,2534,NA,0,NA
Andorra,1998,sp,3544,NA,1,NA
Andorra,1998,sp,4554,NA,0,NA
Andorra,1998,sp,5564,NA,0,NA
Andorra,1998,sp,65,NA,0,NA
Andorra,1999,sp,014,0,0,0
Andorra,1999,sp,1524,0,0,0
Andorra,1999,sp,2534,0,0,0
Andorra,1999,sp,3544,1,1,2
Andorra,1999,sp,4554,0,1,1
Andorra,1999,sp,5564,0,0,0
Andorra,1999,sp,65,0,0,0
Andorra,2000,sp,014,NA,0,NA
Andorra,2000,sp,1524,NA,0,NA
Andorra,2000,sp,2534,NA,1,NA
Andorra,2000,sp,3544,NA,0,NA
Andorra,2000,sp,4554,NA,0,NA
Andorra,2000,sp,5564,NA,0,NA
Andorra,2000,sp,65,NA,0,NA
Andorra,2001,sp,014,NA,0,NA
Andorra,2001,sp,3544,NA,2,NA
Andorra,2001,sp,4554,NA,1,NA
Andorra,2002,sp,014,0,0,0
Andorra,2002,sp,1524,1,0,1
Andorra,2002,sp,2534,0,0,0
Andorra,2002,sp,3544,0,1,1
Andorra,2002,sp,4554,0,0,0
Andorra,2002,sp,5564,0,0,0
Andorra,2002,sp,65,0,0,0
Andorra,2003,sp,014,0,0,0
Andorra,2003,sp,1524,1,0,1
Andorra,2003,sp,2534,1,0,1
Andorra,2003,sp,3544,1,1,2
Andorra,2003,sp,4554,0,2,2
Andorra,2003,sp,5564,0,0,0
Andorra,2003,sp,65,0,0,0
Andorra,2004,sp,014,0,0,0
Andorra,2004,sp,1524,0,0,0
Andorra,2004,sp,2534,1,0,1
Andorra,2004,sp,3544,0,1,1
Andorra,2004,sp,4554,0,1,1
Andorra,2004,sp,5564,0,0,0
Andorra,2004,sp,65,0,0,0
Andorra,2005,sp,014,0,0,0
Andorra,2005,sp,1524,1,0,1
Andorra,2005,sp,2534,1,1,2
Andorra,2005,sp,3544,1,1,2
Andorra,2005,sp,4554,0,0,0
Andorra,2005,sp,5564,0,0,0
Andorra,2005,sp,65,0,0,0
Andorra,2006,ep,014,0,0,0
Andorra,2006,ep,1524,0,0,0
Andorra,2006,ep,2534,0,0,0
Andorra,2006,ep,3544,0,0,0
Andorra,2006,ep,4554,0,0,0
Andorra,2006,ep,5564,1,0,1
Andorra,2006,ep,65,0,1,1
Andorra,2006,sn,014,0,0,0
Andorra,2006,sn,1524,0,0,0
Andorra,2006,sn,2534,0,0,0
Andorra,2006,sn,3544,0,0,0
Andorra,2006,sn,4554,0,0,0
Andorra,2006,sn,5564,0,1,1
Andorra,2006,sn,65,1,0,1
Andorra,2006,sp,014,0,0,0
Andorra,2006,sp,1524,0,1,1
Andorra,2006,sp,2534,1,1,2
Andorra,2006,sp,3544,0,2,2
Andorra,2006,sp,4554,1,0,1
Andorra,2006,sp,5564,0,1,1
Andorra,2006,sp,65,0,1,1
Andorra,2007,ep,3544,NA,1,NA
Andorra,2007,ep,4554,1,NA,NA
Andorra,2007,ep,5564,1,NA,NA
Andorra,2007,sn,65,NA,1,NA
Andorra,2007,sp,2534,1,NA,NA
Andorra,2007,sp,4554,1,NA,NA
Andorra,2008,ep,014,0,0,0
Andorra,2008,ep,1524,0,0,0
Andorra,2008,ep,2534,0,0,0
Andorra,2008,ep,3544,0,0,0
Andorra,2008,ep,4554,0,0,0
Andorra,2008,ep,5564,0,0,0
Andorra,2008,ep,65,0,0,0
Andorra,2008,sn,014,0,0,0
Andorra,2008,sn,1524,0,0,0
Andorra,2008,sn,2534,0,0,0
Andorra,2008,sn,3544,0,0,0
Andorra,2008,sn,4554,0,0,0
Andorra,2008,sn,5564,0,0,0
Andorra,2008,sn,65,0,1,1
Andorra,2008,sp,014,0,0,0
Andorra,2008,sp,1524,0,0,0
Andorra,2008,sp,2534,0,0,0
Andorra,2008,sp,3544,1,0,1
Andorra,2008,sp,4554,1,1,2
Andorra,2008,sp,5564,0,0,0
Andorra,2008,sp,65,0,0,0
Andorra,2009,ep,014,0,0,0
Andorra,2009,ep,1524,0,0,0
Andorra,2009,ep,2534,0,1,1
Andorra,2009,ep,3544,0,0,0
Andorra,2009,ep,4554,0,0,0
Andorra,2009,ep,5564,0,0,0
Andorra,2009,ep,65,0,0,0
Andorra,2009,sn,014,0,0,0
Andorra,2009,sn,1524,0,0,0
Andorra,2009,sn,2534,0,0,0
Andorra,2009,sn,3544,0,1,1
Andorra,2009,sn,4554,0,0,0
Andorra,2009,sn,5564,2,0,2
Andorra,2009,sn,65,1,0,1
Andorra,2009,sp,014,0,0,0
Andorra,2009,sp,1524,0,0,0
Andorra,2009,sp,2534,0,0,0
Andorra,2009,sp,3544,1,0,1
Andorra,2009,sp,4554,0,1,1
Andorra,2009,sp,5564,0,0,0
Andorra,2009,sp,65,0,0,0
Andorra,2010,ep,014,0,0,0
Andorra,2010,ep,1524,0,0,0
Andorra,2010,ep,2534,0,0,0
Andorra,2010,ep,3544,1,0,1
Andorra,2010,ep,4554,0,2,2
Andorra,2010,ep,5564,0,0,0
Andorra,2010,ep,65,0,0,0
Andorra,2010,sn,014,0,0,0
Andorra,2010,sn,1524,1,0,1
Andorra,2010,sn,2534,0,0,0
Andorra,2010,sn,3544,1,0,1
Andorra,2010,sn,4554,0,1,1
Andorra,2010,sn,5564,0,0,0
Andorra,2010,sn,65,0,1,1
Andorra,2010,sp,014,0,0,0
Andorra,2010,sp,1524,0,0,0
Andorra,2010,sp,2534,0,0,0
Andorra,2010,sp,3544,0,0,0
Andorra,2010,sp,4554,0,0,0
Andorra,2010,sp,5564,0,0,0
Andorra,2010,sp,65,0,0,0
Andorra,2011,ep,014,0,0,0
Andorra,2011,ep,1524,0,0,0
Andorra,2011,ep,2534,0,0,0
Andorra,2011,ep,3544,0,0,0
Andorra,2011,ep,4554,0,0,0
Andorra,2011,ep,5564,0,0,0
Andorra,2011,ep,65,0,0,0
Andorra,2011,sn,014,0,0,0
Andorra,2011,sn,1524,0,0,0
Andorra,2011,sn,2534,1,0,1
Andorra,2011,sn,3544,1,0,1
Andorra,2011,sn,4554,0,0,0
Andorra,2011,sn,5564,0,0,0
Andorra,2011,sn,65,0,0,0
Andorra,2011,sp,014,0,0,0
Andorra,2011,sp,1524,0,0,0
Andorra,2011,sp,2534,0,0,0
Andorra,2011,sp,3544,0,0,0
Andorra,2011,sp,4554,0,1,1
Andorra,2011,sp,5564,0,0,0
Andorra,2011,sp,65,0,0,0
Andorra,2012,ep,014,0,0,0
Andorra,2012,ep,1524,0,0,0
Andorra,2012,ep,2534,0,1,1
Andorra,2012,ep,3544,1,0,1
Andorra,2012,ep,4554,0,0,0
Andorra,2012,ep,5564,0,0,0
Andorra,2012,ep,65,0,1,1
Andorra,2012,sn,014,0,0,0
Andorra,2012,sn,1524,0,0,0
Andorra,2012,sn,2534,0,0,0
Andorra,2012,sn,3544,0,1,1
Andorra,2012,sn,4554,1,0,1
Andorra,2012,sn,5564,0,0,0
Andorra,2012,sn,65,0,1,1
Andorra,2012,sp,014,0,0,0
Andorra,2012,sp,1524,0,0,0
Andorra,2012,sp,2534,0,0,0
Andorra,2012,sp,3544,0,0,0
Andorra,2012,sp,4554,0,0,0
Andorra,2012,sp,5564,0,1,1
Andorra,2012,sp,65,0,1,1
Andorra,2013,rel,014,0,0,0
Andorra,2013,rel,1524,0,0,0
Andorra,2013,rel,2534,0,0,0
Andorra,2013,rel,3544,1,1,2
Andorra,2013,rel,4554,0,2,2
Andorra,2013,rel,5564,0,1,1
Andorra,2013,rel,65,0,0,0
Angola,1995,sp,014,371,386,757
Angola,1995,sp,1524,707,724,1431
Angola,1995,sp,2534,443,562,1005
Angola,1995,sp,3544,264,346,610
Angola,1995,sp,4554,248,224,472
Angola,1995,sp,5564,130,155,285
Angola,1995,sp,65,18,14,32
Angola,1996,sp,014,388,360,748
Angola,1996,sp,1524,1066,1036,2102
Angola,1996,sp,2534,963,926,1889
Angola,1996,sp,3544,615,1027,1642
Angola,1996,sp,4554,370,469,839
Angola,1996,sp,5564,242,272,514
Angola,1996,sp,65,113,169,282
Angola,1997,sp,014,431,419,850
Angola,1997,sp,1524,1165,913,2078
Angola,1997,sp,2534,1007,1026,2033
Angola,1997,sp,3544,627,819,1446
Angola,1997,sp,4554,411,507,918
Angola,1997,sp,5564,234,304,538
Angola,1997,sp,65,145,193,338
Angola,1998,sp,014,297,240,537
Angola,1998,sp,1524,1084,915,1999
Angola,1998,sp,2534,970,950,1920
Angola,1998,sp,3544,623,839,1462
Angola,1998,sp,4554,319,470,789
Angola,1998,sp,5564,169,219,388
Angola,1998,sp,65,92,135,227
Angola,1999,sp,014,459,391,850
Angola,1999,sp,1524,1197,1134,2331
Angola,1999,sp,2534,1157,1237,2394
Angola,1999,sp,3544,743,973,1716
Angola,1999,sp,4554,474,518,992
Angola,1999,sp,5564,217,314,531
Angola,1999,sp,65,194,234,428
Angola,2000,sp,014,247,186,433
Angola,2000,sp,1524,1142,999,2141
Angola,2000,sp,2534,1091,1003,2094
Angola,2000,sp,3544,844,912,1756
Angola,2000,sp,4554,417,482,899
Angola,2000,sp,5564,200,312,512
Angola,2000,sp,65,120,194,314
Angola,2001,sp,014,279,230,509
Angola,2001,sp,1524,993,892,1885
Angola,2001,sp,2534,869,752,1621
Angola,2001,sp,3544,647,648,1295
Angola,2001,sp,4554,323,420,743
Angola,2001,sp,5564,200,197,397
Angola,2001,sp,65,182,173,355
Angola,2002,sp,014,640,435,1075
Angola,2002,sp,1524,2610,2223,4833
Angola,2002,sp,2534,2208,2292,4500
Angola,2002,sp,3544,1600,1915,3515
Angola,2002,sp,4554,972,1187,2159
Angola,2002,sp,5564,533,624,1157
Angola,2002,sp,65,305,444,749
Angola,2003,sp,014,591,409,1000
Angola,2003,sp,1524,3078,2355,5433
Angola,2003,sp,2534,2641,2598,5239
Angola,2003,sp,3544,1747,1908,3655
Angola,2003,sp,4554,1157,1090,2247
Angola,2003,sp,5564,395,512,907
Angola,2003,sp,65,129,361,490
Angola,2004,sp,014,733,554,1287
Angola,2004,sp,1524,3198,2684,5882
Angola,2004,sp,2534,2772,2659,5431
Angola,2004,sp,3544,1854,1998,3852
Angola,2004,sp,4554,1029,1196,2225
Angola,2004,sp,5564,505,561,1066
Angola,2004,sp,65,269,321,590
Angola,2005,sp,014,704,520,1224
Angola,2005,sp,1524,2926,2549,5475
Angola,2005,sp,2534,2682,2797,5479
Angola,2005,sp,3544,1797,1918,3715
Angola,2005,sp,4554,1138,1255,2393
Angola,2005,sp,5564,581,665,1246
Angola,2005,sp,65,417,461,878
Angola,2006,sp,014,689,540,1229
Angola,2006,sp,1524,2851,2632,5483
Angola,2006,sp,2534,2892,3049,5941
Angola,2006,sp,3544,1990,2182,4172
Angola,2006,sp,4554,1223,1397,2620
Angola,2006,sp,5564,583,729,1312
Angola,2006,sp,65,314,428,742
Angola,2007,sp,014,703,484,1187
Angola,2007,sp,1524,2943,2824,5767
Angola,2007,sp,2534,2721,3197,5918
Angola,2007,sp,3544,1812,2255,4067
Angola,2007,sp,4554,1041,1357,2398
Angola,2007,sp,5564,554,699,1253
Angola,2007,sp,65,367,465,832
Angola,2008,sp,014,512,367,879
Angola,2008,sp,1524,3199,2970,6169
Angola,2008,sp,2534,2786,3493,6279
Angola,2008,sp,3544,2082,2418,4500
Angola,2008,sp,4554,1209,1480,2689
Angola,2008,sp,5564,556,733,1289
Angola,2008,sp,65,337,420,757
Angola,2009,sp,014,568,392,960
Angola,2009,sp,1524,3152,3054,6206
Angola,2009,sp,2534,2798,3600,6398
Angola,2009,sp,3544,1790,2420,4210
Angola,2009,sp,4554,1069,1590,2659
Angola,2009,sp,5564,572,748,1320
Angola,2009,sp,65,272,463,735
Angola,2010,sp,014,558,448,1006
Angola,2010,sp,1524,2763,2900,5663
Angola,2010,sp,2534,2594,3584,6178
Angola,2010,sp,3544,1688,2415,4103
Angola,2010,sp,4554,958,1424,2382
Angola,2010,sp,5564,482,691,1173
Angola,2010,sp,65,286,355,641
Angola,2011,ep,014,64,36,100
Angola,2011,sn,014,2165,2466,4631
Angola,2011,sp,014,708,501,1209
Angola,2011,sp,1524,2731,3000,5731
Angola,2011,sp,2534,2563,3792,6355
Angola,2011,sp,3544,1683,2386,4069
Angola,2011,sp,4554,1006,1395,2401
Angola,2011,sp,5564,457,680,1137
Angola,2011,sp,65,346,455,801
Angola,2012,sp,014,592,390,982
Angola,2012,sp,1524,2501,2804,5305
Angola,2012,sp,2534,2540,3627,6167
Angola,2012,sp,3544,1617,2529,4146
Angola,2012,sp,4554,1028,1427,2455
Angola,2012,sp,5564,529,732,1261
Angola,2012,sp,65,384,424,808
Angola,2013,rel,014,626,486,1112
Angola,2013,rel,1524,2644,2992,5636
Angola,2013,rel,2534,2480,3790,6270
Angola,2013,rel,3544,1671,2632,4303
Angola,2013,rel,4554,991,1433,2424
Angola,2013,rel,5564,481,735,1216
Angola,2013,rel,65,314,386,700
Anguilla,2003,sp,3544,1,NA,NA
Anguilla,2004,sp,014,0,0,0
Anguilla,2004,sp,1524,0,0,0
Anguilla,2004,sp,2534,0,0,0
Anguilla,2004,sp,3544,0,0,0
Anguilla,2004,sp,4554,0,0,0
Anguilla,2004,sp,5564,0,0,0
Anguilla,2004,sp,65,0,0,0
Anguilla,2010,ep,014,0,0,0
Anguilla,2010,ep,1524,0,0,0
Anguilla,2010,ep,2534,0,0,0
Anguilla,2010,ep,3544,0,0,0
Anguilla,2010,ep,4554,0,0,0
Anguilla,2010,ep,5564,0,0,0
Anguilla,2010,ep,65,0,0,0
Anguilla,2010,sn,014,0,0,0
Anguilla,2010,sn,1524,0,0,0
Anguilla,2010,sn,2534,0,0,0
Anguilla,2010,sn,3544,0,0,0
Anguilla,2010,sn,4554,0,0,0
Anguilla,2010,sn,5564,0,0,0
Anguilla,2010,sn,65,0,0,0
Anguilla,2010,sp,014,0,0,0
Anguilla,2010,sp,1524,0,0,0
Anguilla,2010,sp,2534,0,0,0
Anguilla,2010,sp,3544,0,0,0
Anguilla,2010,sp,4554,0,0,0
Anguilla,2010,sp,5564,0,0,0
Anguilla,2010,sp,65,0,1,1
Anguilla,2011,ep,014,0,0,0
Anguilla,2011,ep,1524,0,0,0
Anguilla,2011,ep,2534,0,0,0
Anguilla,2011,ep,3544,0,0,0
Anguilla,2011,ep,4554,0,0,0
Anguilla,2011,ep,5564,0,0,0
Anguilla,2011,ep,65,0,0,0
Anguilla,2011,sn,014,0,0,0
Anguilla,2011,sn,1524,0,0,0
Anguilla,2011,sn,2534,0,0,0
Anguilla,2011,sn,3544,0,0,0
Anguilla,2011,sn,4554,0,0,0
Anguilla,2011,sn,5564,0,0,0
Anguilla,2011,sn,65,0,0,0
Anguilla,2011,sp,014,0,0,0
Anguilla,2011,sp,1524,0,0,0
Anguilla,2011,sp,2534,0,0,0
Anguilla,2011,sp,3544,0,0,0
Anguilla,2011,sp,4554,0,0,0
Anguilla,2011,sp,5564,0,0,0
Anguilla,2011,sp,65,0,0,0
Anguilla,2012,ep,014,0,0,0
Anguilla,2012,ep,1524,0,0,0
Anguilla,2012,ep,2534,0,0,0
Anguilla,2012,ep,3544,0,0,0
Anguilla,2012,ep,4554,0,0,0
Anguilla,2012,ep,5564,0,0,0
Anguilla,2012,ep,65,0,0,0
Anguilla,2012,sn,014,0,0,0
Anguilla,2012,sn,1524,0,0,0
Anguilla,2012,sn,2534,0,0,0
Anguilla,2012,sn,3544,0,0,0
Anguilla,2012,sn,4554,0,0,0
Anguilla,2012,sn,5564,0,0,0
Anguilla,2012,sn,65,0,0,0
Anguilla,2012,sp,014,0,0,0
Anguilla,2012,sp,1524,0,0,0
Anguilla,2012,sp,2534,0,0,0
Anguilla,2012,sp,3544,0,0,0
Anguilla,2012,sp,4554,0,0,0
Anguilla,2012,sp,5564,0,0,0
Anguilla,2012,sp,65,0,0,0
Anguilla,2013,rel,014,0,0,0
Anguilla,2013,rel,1524,0,0,0
Anguilla,2013,rel,2534,0,0,0
Anguilla,2013,rel,3544,0,0,0
Anguilla,2013,rel,4554,0,0,0
Anguilla,2013,rel,5564,0,0,0
Anguilla,2013,rel,65,0,0,0
Antigua and Barbuda,1996,sp,014,0,0,0
Antigua and Barbuda,1996,sp,1524,0,0,0
Antigua and Barbuda,1996,sp,2534,0,0,0
Antigua and Barbuda,1996,sp,3544,1,0,1
Antigua and Barbuda,1996,sp,4554,0,1,1
Antigua and Barbuda,1996,sp,5564,0,0,0
Antigua and Barbuda,1996,sp,65,0,0,0
Antigua and Barbuda,2000,sp,014,1,0,1
Antigua and Barbuda,2000,sp,1524,1,0,1
Antigua and Barbuda,2000,sp,2534,1,0,1
Antigua and Barbuda,2000,sp,3544,0,0,0
Antigua and Barbuda,2000,sp,4554,0,0,0
Antigua and Barbuda,2000,sp,5564,0,0,0
Antigua and Barbuda,2000,sp,65,0,1,1
Antigua and Barbuda,2001,sp,014,0,NA,NA
Antigua and Barbuda,2001,sp,1524,1,NA,NA
Antigua and Barbuda,2001,sp,2534,0,NA,NA
Antigua and Barbuda,2001,sp,3544,0,NA,NA
Antigua and Barbuda,2001,sp,4554,0,NA,NA
Antigua and Barbuda,2001,sp,5564,0,NA,NA
Antigua and Barbuda,2001,sp,65,0,NA,NA
Antigua and Barbuda,2002,sp,014,2,0,2
Antigua and Barbuda,2002,sp,1524,0,0,0
Antigua and Barbuda,2002,sp,2534,1,1,2
Antigua and Barbuda,2002,sp,3544,0,0,0
Antigua and Barbuda,2002,sp,4554,0,0,0
Antigua and Barbuda,2002,sp,5564,0,0,0
Antigua and Barbuda,2002,sp,65,0,0,0
Antigua and Barbuda,2003,sp,014,0,0,0
Antigua and Barbuda,2003,sp,1524,0,0,0
Antigua and Barbuda,2003,sp,2534,0,1,1
Antigua and Barbuda,2003,sp,3544,0,0,0
Antigua and Barbuda,2003,sp,4554,0,0,0
Antigua and Barbuda,2003,sp,5564,0,0,0
Antigua and Barbuda,2003,sp,65,0,0,0
Antigua and Barbuda,2005,sp,1524,2,NA,NA
Antigua and Barbuda,2005,sp,2534,2,NA,NA
Antigua and Barbuda,2005,sp,3544,NA,1,NA
Antigua and Barbuda,2005,sp,4554,NA,1,NA
Antigua and Barbuda,2006,sn,014,0,0,0
Antigua and Barbuda,2006,sn,1524,0,0,0
Antigua and Barbuda,2006,sn,2534,0,1,1
Antigua and Barbuda,2006,sn,3544,0,1,1
Antigua and Barbuda,2006,sn,4554,0,0,0
Antigua and Barbuda,2006,sn,5564,0,2,2
Antigua and Barbuda,2006,sn,65,0,0,0
Antigua and Barbuda,2007,ep,014,0,0,0
Antigua and Barbuda,2007,ep,1524,0,0,0
Antigua and Barbuda,2007,ep,2534,0,0,0
Antigua and Barbuda,2007,ep,3544,0,0,0
Antigua and Barbuda,2007,ep,4554,0,0,0
Antigua and Barbuda,2007,ep,5564,0,0,0
Antigua and Barbuda,2007,ep,65,0,0,0
Antigua and Barbuda,2007,sn,014,0,0,0
Antigua and Barbuda,2007,sn,1524,0,NA,NA
Antigua and Barbuda,2007,sn,2534,0,0,0
Antigua and Barbuda,2007,sn,3544,0,0,0
Antigua and Barbuda,2007,sn,4554,0,0,0
Antigua and Barbuda,2007,sn,5564,0,0,0
Antigua and Barbuda,2007,sn,65,0,0,0
Antigua and Barbuda,2007,sp,014,0,0,0
Antigua and Barbuda,2007,sp,1524,0,0,0
Antigua and Barbuda,2007,sp,2534,0,0,0
Antigua and Barbuda,2007,sp,3544,0,0,0
Antigua and Barbuda,2007,sp,4554,0,1,1
Antigua and Barbuda,2007,sp,5564,0,1,1
Antigua and Barbuda,2007,sp,65,0,0,0
Antigua and Barbuda,2008,ep,014,0,0,0
Antigua and Barbuda,2008,ep,1524,0,0,0
Antigua and Barbuda,2008,ep,2534,0,0,0
Antigua and Barbuda,2008,ep,3544,0,0,0
Antigua and Barbuda,2008,ep,4554,0,0,0
Antigua and Barbuda,2008,ep,5564,0,0,0
Antigua and Barbuda,2008,ep,65,0,0,0
Antigua and Barbuda,2008,sn,014,0,0,0
Antigua and Barbuda,2008,sn,1524,0,0,0
Antigua and Barbuda,2008,sn,2534,0,0,0
Antigua and Barbuda,2008,sn,3544,0,0,0
Antigua and Barbuda,2008,sn,4554,0,0,0
Antigua and Barbuda,2008,sn,5564,0,0,0
Antigua and Barbuda,2008,sn,65,0,0,0
Antigua and Barbuda,2008,sp,014,0,0,0
Antigua and Barbuda,2008,sp,1524,0,0,0
Antigua and Barbuda,2008,sp,2534,0,0,0
Antigua and Barbuda,2008,sp,3544,0,0,0
Antigua and Barbuda,2008,sp,4554,0,1,1
Antigua and Barbuda,2008,sp,5564,0,0,0
Antigua and Barbuda,2008,sp,65,0,0,0
Antigua and Barbuda,2009,ep,014,0,0,0
Antigua and Barbuda,2009,ep,1524,0,0,0
Antigua and Barbuda,2009,ep,2534,0,0,0
Antigua and Barbuda,2009,ep,3544,0,0,0
Antigua and Barbuda,2009,ep,4554,0,0,0
Antigua and Barbuda,2009,ep,5564,0,0,0
Antigua and Barbuda,2009,ep,65,0,0,0
Antigua and Barbuda,2009,sn,014,0,0,0
Antigua and Barbuda,2009,sn,1524,0,0,0
Antigua and Barbuda,2009,sn,2534,0,0,0
Antigua and Barbuda,2009,sn,3544,0,0,0
Antigua and Barbuda,2009,sn,4554,0,0,0
Antigua and Barbuda,2009,sn,5564,0,0,0
Antigua and Barbuda,2009,sn,65,0,1,1
Antigua and Barbuda,2009,sp,014,0,0,0
Antigua and Barbuda,2009,sp,1524,0,0,0
Antigua and Barbuda,2009,sp,2534,0,1,1
Antigua and Barbuda,2009,sp,3544,0,1,1
Antigua and Barbuda,2009,sp,4554,0,0,0
Antigua and Barbuda,2009,sp,5564,0,0,0
Antigua and Barbuda,2009,sp,65,0,0,0
Antigua and Barbuda,2010,ep,014,0,0,0
Antigua and Barbuda,2010,ep,1524,0,0,0
Antigua and Barbuda,2010,ep,2534,0,0,0
Antigua and Barbuda,2010,ep,3544,0,0,0
Antigua and Barbuda,2010,ep,4554,0,0,0
Antigua and Barbuda,2010,ep,5564,0,0,0
Antigua and Barbuda,2010,ep,65,0,0,0
Antigua and Barbuda,2010,sn,014,0,0,0
Antigua and Barbuda,2010,sn,1524,0,0,0
Antigua and Barbuda,2010,sn,2534,0,0,0
Antigua and Barbuda,2010,sn,3544,0,0,0
Antigua and Barbuda,2010,sn,4554,0,0,0
Antigua and Barbuda,2010,sn,5564,0,0,0
Antigua and Barbuda,2010,sn,65,0,0,0
Antigua and Barbuda,2010,sp,014,0,0,0
Antigua and Barbuda,2010,sp,1524,0,0,0
Antigua and Barbuda,2010,sp,2534,1,2,3
Antigua and Barbuda,2010,sp,3544,0,0,0
Antigua and Barbuda,2010,sp,4554,0,2,2
Antigua and Barbuda,2010,sp,5564,0,1,1
Antigua and Barbuda,2010,sp,65,0,0,0
Antigua and Barbuda,2011,ep,014,0,0,0
Antigua and Barbuda,2011,ep,1524,0,0,0
Antigua and Barbuda,2011,ep,2534,0,0,0
Antigua and Barbuda,2011,ep,3544,0,0,0
Antigua and Barbuda,2011,ep,4554,0,0,0
Antigua and Barbuda,2011,ep,5564,0,0,0
Antigua and Barbuda,2011,ep,65,0,0,0
Antigua and Barbuda,2011,sn,014,0,0,0
Antigua and Barbuda,2011,sn,1524,0,0,0
Antigua and Barbuda,2011,sn,2534,0,0,0
Antigua and Barbuda,2011,sn,3544,0,0,0
Antigua and Barbuda,2011,sn,4554,0,0,0
Antigua and Barbuda,2011,sn,5564,0,0,0
Antigua and Barbuda,2011,sn,65,0,0,0
Antigua and Barbuda,2011,sp,014,0,0,0
Antigua and Barbuda,2011,sp,1524,1,0,1
Antigua and Barbuda,2011,sp,2534,0,1,1
Antigua and Barbuda,2011,sp,3544,0,1,1
Antigua and Barbuda,2011,sp,4554,0,3,3
Antigua and Barbuda,2011,sp,5564,0,1,1
Antigua and Barbuda,2011,sp,65,0,1,1
Antigua and Barbuda,2012,ep,014,0,0,0
Antigua and Barbuda,2012,ep,1524,0,0,0
Antigua and Barbuda,2012,ep,2534,0,0,0
Antigua and Barbuda,2012,ep,3544,0,0,0
Antigua and Barbuda,2012,ep,4554,0,1,1
Antigua and Barbuda,2012,ep,5564,0,0,0
Antigua and Barbuda,2012,ep,65,0,0,0
Antigua and Barbuda,2012,sn,014,0,0,0
Antigua and Barbuda,2012,sn,1524,0,0,0
Antigua and Barbuda,2012,sn,2534,0,0,0
Antigua and Barbuda,2012,sn,3544,0,1,1
Antigua and Barbuda,2012,sn,4554,0,0,0
Antigua and Barbuda,2012,sn,5564,0,0,0
Antigua and Barbuda,2012,sn,65,0,0,0
Antigua and Barbuda,2012,sp,014,0,0,0
Antigua and Barbuda,2012,sp,1524,0,0,0
Antigua and Barbuda,2012,sp,2534,0,0,0
Antigua and Barbuda,2012,sp,3544,0,0,0
Antigua and Barbuda,2012,sp,4554,0,1,1
Antigua and Barbuda,2012,sp,5564,0,0,0
Antigua and Barbuda,2012,sp,65,0,0,0
Antigua and Barbuda,2013,rel,014,0,1,1
Antigua and Barbuda,2013,rel,1524,0,1,1
Antigua and Barbuda,2013,rel,2534,0,1,1
Antigua and Barbuda,2013,rel,3544,0,2,2
Antigua and Barbuda,2013,rel,4554,0,2,2
Antigua and Barbuda,2013,rel,5564,0,1,1
Antigua and Barbuda,2013,rel,65,1,1,2
Argentina,1996,sp,014,107,113,220
Argentina,1996,sp,1524,643,611,1254
Argentina,1996,sp,2534,591,535,1126
Argentina,1996,sp,3544,528,338,866
Argentina,1996,sp,4554,546,276,822
Argentina,1996,sp,5564,520,230,750
Argentina,1996,sp,65,463,286,749
Argentina,1997,sp,014,133,96,229
Argentina,1997,sp,1524,566,580,1146
Argentina,1997,sp,2534,511,600,1111
Argentina,1997,sp,3544,336,523,859
Argentina,1997,sp,4554,240,489,729
Argentina,1997,sp,5564,199,417,616
Argentina,1997,sp,65,234,393,627
Argentina,1998,sp,014,94,84,178
Argentina,1998,sp,1524,558,578,1136
Argentina,1998,sp,2534,498,571,1069
Argentina,1998,sp,3544,271,463,734
Argentina,1998,sp,4554,229,476,705
Argentina,1998,sp,5564,207,387,594
Argentina,1998,sp,65,276,370,646
Argentina,1999,sp,014,108,90,198
Argentina,1999,sp,1524,502,490,992
Argentina,1999,sp,2534,442,546,988
Argentina,1999,sp,3544,292,435,727
Argentina,1999,sp,4554,210,464,674
Argentina,1999,sp,5564,177,384,561
Argentina,1999,sp,65,249,380,629
Argentina,2000,sp,014,121,97,218
Argentina,2000,sp,1524,544,278,822
Argentina,2000,sp,2534,479,594,1073
Argentina,2000,sp,3544,262,402,664
Argentina,2000,sp,4554,230,419,649
Argentina,2000,sp,5564,179,368,547
Argentina,2000,sp,65,216,330,546
Argentina,2001,sp,014,85,78,163
Argentina,2001,sp,1524,674,682,1356
Argentina,2001,sp,2534,561,611,1172
Argentina,2001,sp,3544,303,495,798
Argentina,2001,sp,4554,242,471,713
Argentina,2001,sp,5564,215,404,619
Argentina,2001,sp,65,249,436,685
Argentina,2002,sp,014,117,70,187
Argentina,2002,sp,1524,622,612,1234
Argentina,2002,sp,2534,580,658,1238
Argentina,2002,sp,3544,301,463,764
Argentina,2002,sp,4554,237,477,714
Argentina,2002,sp,5564,203,389,592
Argentina,2002,sp,65,255,399,654
Argentina,2003,sp,014,99,89,188
Argentina,2003,sp,1524,516,574,1090
Argentina,2003,sp,2534,513,565,1078
Argentina,2003,sp,3544,294,413,707
Argentina,2003,sp,4554,241,461,702
Argentina,2003,sp,5564,192,366,558
Argentina,2003,sp,65,231,405,636
Argentina,2004,sp,014,98,64,162
Argentina,2004,sp,1524,519,588,1107
Argentina,2004,sp,2534,477,543,1020
Argentina,2004,sp,3544,271,399,670
Argentina,2004,sp,4554,237,387,624
Argentina,2004,sp,5564,169,332,501
Argentina,2004,sp,65,237,345,582
Argentina,2005,sp,014,90,64,154
Argentina,2005,sp,1524,530,621,1151
Argentina,2005,sp,2534,474,530,1004
Argentina,2005,sp,3544,290,358,648
Argentina,2005,sp,4554,198,384,582
Argentina,2005,sp,5564,169,340,509
Argentina,2005,sp,65,240,348,588
Argentina,2006,ep,014,36,32,68
Argentina,2006,ep,1524,87,111,198
Argentina,2006,ep,2534,91,122,213
Argentina,2006,ep,3544,69,94,163
Argentina,2006,ep,4554,59,92,151
Argentina,2006,ep,5564,46,76,122
Argentina,2006,ep,65,75,91,166
Argentina,2006,sn,014,345,394,739
Argentina,2006,sn,1524,187,196,383
Argentina,2006,sn,2534,185,235,420
Argentina,2006,sn,3544,119,143,262
Argentina,2006,sn,4554,75,153,228
Argentina,2006,sn,5564,90,176,266
Argentina,2006,sn,65,127,187,314
Argentina,2006,sp,014,74,67,141
Argentina,2006,sp,1524,438,519,957
Argentina,2006,sp,2534,437,484,921
Argentina,2006,sp,3544,235,360,595
Argentina,2006,sp,4554,197,351,548
Argentina,2006,sp,5564,173,346,519
Argentina,2006,sp,65,213,321,534
Argentina,2007,ep,014,39,64,103
Argentina,2007,ep,1524,144,157,301
Argentina,2007,ep,2534,140,192,332
Argentina,2007,ep,3544,89,122,211
Argentina,2007,ep,4554,73,96,169
Argentina,2007,ep,5564,46,86,132
Argentina,2007,ep,65,90,95,185
Argentina,2007,sn,014,476,539,1015
Argentina,2007,sn,1524,234,278,512
Argentina,2007,sn,2534,199,214,413
Argentina,2007,sn,3544,135,189,324
Argentina,2007,sn,4554,111,147,258
Argentina,2007,sn,5564,67,159,226
Argentina,2007,sn,65,149,152,301
Argentina,2007,sp,014,70,77,147
Argentina,2007,sp,1524,558,656,1214
Argentina,2007,sp,2534,500,623,1123
Argentina,2007,sp,3544,246,401,647
Argentina,2007,sp,4554,217,415,632
Argentina,2007,sp,5564,172,389,561
Argentina,2007,sp,65,246,324,570
Argentina,2008,ep,014,37,51,88
Argentina,2008,ep,1524,125,163,288
Argentina,2008,ep,2534,158,191,349
Argentina,2008,ep,3544,88,155,243
Argentina,2008,ep,4554,66,104,170
Argentina,2008,ep,5564,58,96,154
Argentina,2008,ep,65,78,109,187
Argentina,2008,sn,014,409,417,826
Argentina,2008,sn,1524,207,287,494
Argentina,2008,sn,2534,199,238,437
Argentina,2008,sn,3544,128,175,303
Argentina,2008,sn,4554,81,162,243
Argentina,2008,sn,5564,79,125,204
Argentina,2008,sn,65,111,142,253
Argentina,2008,sp,014,66,69,135
Argentina,2008,sp,1524,536,633,1169
Argentina,2008,sp,2534,506,611,1117
Argentina,2008,sp,3544,252,390,642
Argentina,2008,sp,4554,221,416,637
Argentina,2008,sp,5564,157,364,521
Argentina,2008,sp,65,204,295,499
Argentina,2009,ep,014,24,25,49
Argentina,2009,ep,1524,74,86,160
Argentina,2009,ep,2534,90,113,203
Argentina,2009,ep,3544,61,93,154
Argentina,2009,ep,4554,53,79,132
Argentina,2009,ep,5564,32,77,109
Argentina,2009,ep,65,55,70,125
Argentina,2009,sn,014,217,269,486
Argentina,2009,sn,1524,189,193,382
Argentina,2009,sn,2534,156,226,382
Argentina,2009,sn,3544,99,154,253
Argentina,2009,sn,4554,99,129,228
Argentina,2009,sn,5564,62,136,198
Argentina,2009,sn,65,87,144,231
Argentina,2009,sp,014,63,44,107
Argentina,2009,sp,1524,434,546,980
Argentina,2009,sp,2534,406,483,889
Argentina,2009,sp,3544,257,348,605
Argentina,2009,sp,4554,185,327,512
Argentina,2009,sp,5564,137,303,440
Argentina,2009,sp,65,199,297,496
Argentina,2010,ep,014,17,23,40
Argentina,2010,ep,1524,72,91,163
Argentina,2010,ep,2534,68,104,172
Argentina,2010,ep,3544,56,86,142
Argentina,2010,ep,4554,59,60,119
Argentina,2010,ep,5564,44,61,105
Argentina,2010,ep,65,45,66,111
Argentina,2010,sn,014,186,190,376
Argentina,2010,sn,1524,171,214,385
Argentina,2010,sn,2534,132,196,328
Argentina,2010,sn,3544,98,155,253
Argentina,2010,sn,4554,82,148,230
Argentina,2010,sn,5564,67,126,193
Argentina,2010,sn,65,108,134,242
Argentina,2010,sp,014,59,56,115
Argentina,2010,sp,1524,421,536,957
Argentina,2010,sp,2534,426,491,917
Argentina,2010,sp,3544,233,309,542
Argentina,2010,sp,4554,184,302,486
Argentina,2010,sp,5564,153,340,493
Argentina,2010,sp,65,176,282,458
Argentina,2011,ep,014,75,72,147
Argentina,2011,ep,1524,162,217,379
Argentina,2011,ep,2534,158,240,398
Argentina,2011,ep,3544,107,134,241
Argentina,2011,ep,4554,65,95,160
Argentina,2011,ep,5564,62,89,151
Argentina,2011,ep,65,60,72,132
Argentina,2011,sn,014,257,325,582
Argentina,2011,sn,1524,250,304,554
Argentina,2011,sn,2534,221,270,491
Argentina,2011,sn,3544,153,179,332
Argentina,2011,sn,4554,98,158,256
Argentina,2011,sn,5564,73,119,192
Argentina,2011,sn,65,92,118,210
Argentina,2011,sp,014,142,143,285
Argentina,2011,sp,1524,587,664,1251
Argentina,2011,sp,2534,470,657,1127
Argentina,2011,sp,3544,279,434,713
Argentina,2011,sp,4554,192,397,589
Argentina,2011,sp,5564,169,358,527
Argentina,2011,sp,65,213,289,502
Argentina,2012,ep,014,46,40,86
Argentina,2012,ep,1524,154,128,282
Argentina,2012,ep,2534,153,102,255
Argentina,2012,ep,3544,147,107,254
Argentina,2012,ep,4554,72,75,147
Argentina,2012,ep,5564,63,49,112
Argentina,2012,ep,65,84,63,147
Argentina,2012,sn,014,297,322,619
Argentina,2012,sn,1524,258,222,480
Argentina,2012,sn,2534,195,173,368
Argentina,2012,sn,3544,152,126,278
Argentina,2012,sn,4554,115,83,198
Argentina,2012,sn,5564,125,69,194
Argentina,2012,sn,65,114,83,197
Argentina,2012,sp,014,67,59,126
Argentina,2012,sp,1524,652,533,1185
Argentina,2012,sp,2534,614,484,1098
Argentina,2012,sp,3544,375,299,674
Argentina,2012,sp,4554,364,180,544
Argentina,2012,sp,5564,321,182,503
Argentina,2012,sp,65,322,181,503
Argentina,2013,rel,014,431,462,893
Argentina,2013,rel,1524,927,1124,2051
Argentina,2013,rel,2534,808,1094,1902
Argentina,2013,rel,3544,537,768,1305
Argentina,2013,rel,4554,395,593,988
Argentina,2013,rel,5564,307,581,888
Argentina,2013,rel,65,374,491,865
Armenia,1995,sp,014,1,1,2
Armenia,1995,sp,1524,1,18,19
Armenia,1995,sp,2534,7,16,23
Armenia,1995,sp,3544,2,11,13
Armenia,1995,sp,4554,1,10,11
Armenia,1995,sp,5564,1,8,9
Armenia,1995,sp,65,NA,1,NA
Armenia,1996,sp,014,0,2,2
Armenia,1996,sp,1524,9,53,62
Armenia,1996,sp,2534,11,100,111
Armenia,1996,sp,3544,9,51,60
Armenia,1996,sp,4554,8,43,51
Armenia,1996,sp,5564,4,30,34
Armenia,1996,sp,65,0,7,7
Armenia,1997,sp,014,3,2,5
Armenia,1997,sp,1524,16,85,101
Armenia,1997,sp,2534,22,59,81
Armenia,1997,sp,3544,17,77,94
Armenia,1997,sp,4554,7,51,58
Armenia,1997,sp,5564,14,34,48
Armenia,1997,sp,65,1,12,13
Armenia,1998,sp,014,1,2,3
Armenia,1998,sp,1524,21,159,180
Armenia,1998,sp,2534,20,90,110
Armenia,1998,sp,3544,11,79,90
Armenia,1998,sp,4554,10,39,49
Armenia,1998,sp,5564,5,17,22
Armenia,1998,sp,65,6,15,21
Armenia,1999,sp,014,6,4,10
Armenia,1999,sp,1524,22,151,173
Armenia,1999,sp,2534,15,88,103
Armenia,1999,sp,3544,20,115,135
Armenia,1999,sp,4554,6,76,82
Armenia,1999,sp,5564,9,37,46
Armenia,1999,sp,65,7,20,27
Armenia,2000,sp,014,1,2,3
Armenia,2000,sp,1524,24,152,176
Armenia,2000,sp,2534,27,130,157
Armenia,2000,sp,3544,24,131,155
Armenia,2000,sp,4554,8,63,71
Armenia,2000,sp,5564,8,26,34
Armenia,2000,sp,65,4,21,25
Armenia,2001,sp,014,1,2,3
Armenia,2001,sp,1524,40,154,194
Armenia,2001,sp,2534,31,120,151
Armenia,2001,sp,3544,22,93,115
Armenia,2001,sp,4554,10,54,64
Armenia,2001,sp,5564,7,24,31
Armenia,2001,sp,65,5,9,14
Armenia,2002,sp,014,2,1,3
Armenia,2002,sp,1524,16,95,111
Armenia,2002,sp,2534,24,63,87
Armenia,2002,sp,3544,32,109,141
Armenia,2002,sp,4554,36,93,129
Armenia,2002,sp,5564,4,21,25
Armenia,2002,sp,65,1,14,15
Armenia,2003,sp,014,2,12,14
Armenia,2003,sp,1524,29,120,149
Armenia,2003,sp,2534,31,98,129
Armenia,2003,sp,3544,13,75,88
Armenia,2003,sp,4554,12,104,116
Armenia,2003,sp,5564,9,49,58
Armenia,2003,sp,65,3,18,21
Armenia,2004,sp,014,1,2,3
Armenia,2004,sp,1524,24,130,154
Armenia,2004,sp,2534,17,72,89
Armenia,2004,sp,3544,12,76,88
Armenia,2004,sp,4554,10,62,72
Armenia,2004,sp,5564,3,25,28
Armenia,2004,sp,65,3,24,27
Armenia,2005,sp,014,3,3,6
Armenia,2005,sp,1524,27,170,197
Armenia,2005,sp,2534,21,104,125
Armenia,2005,sp,3544,10,83,93
Armenia,2005,sp,4554,11,84,95
Armenia,2005,sp,5564,4,30,34
Armenia,2005,sp,65,7,24,31
Armenia,2006,ep,014,12,25,37
Armenia,2006,ep,1524,19,103,122
Armenia,2006,ep,2534,25,29,54
Armenia,2006,ep,3544,12,24,36
Armenia,2006,ep,4554,18,14,32
Armenia,2006,ep,5564,8,8,16
Armenia,2006,ep,65,10,17,27
Armenia,2006,sn,014,25,27,52
Armenia,2006,sn,1524,36,172,208
Armenia,2006,sn,2534,31,64,95
Armenia,2006,sn,3544,15,68,83
Armenia,2006,sn,4554,16,97,113
Armenia,2006,sn,5564,9,44,53
Armenia,2006,sn,65,11,79,90
Armenia,2006,sp,014,3,0,3
Armenia,2006,sp,1524,28,113,141
Armenia,2006,sp,2534,29,116,145
Armenia,2006,sp,3544,16,96,112
Armenia,2006,sp,4554,15,98,113
Armenia,2006,sp,5564,7,38,45
Armenia,2006,sp,65,4,17,21
Armenia,2007,ep,014,0,0,0
Armenia,2007,ep,1524,0,0,0
Armenia,2007,ep,2534,0,0,0
Armenia,2007,ep,3544,0,0,0
Armenia,2007,ep,4554,0,0,0
Armenia,2007,ep,5564,0,0,0
Armenia,2007,ep,65,0,0,0
Armenia,2007,sn,014,12,26,38
Armenia,2007,sn,1524,36,122,158
Armenia,2007,sn,2534,33,78,111
Armenia,2007,sn,3544,23,62,85
Armenia,2007,sn,4554,22,106,128
Armenia,2007,sn,5564,15,59,74
Armenia,2007,sn,65,21,84,105
Armenia,2007,sp,014,2,1,3
Armenia,2007,sp,1524,31,81,112
Armenia,2007,sp,2534,22,87,109
Armenia,2007,sp,3544,11,100,111
Armenia,2007,sp,4554,7,92,99
Armenia,2007,sp,5564,7,29,36
Armenia,2007,sp,65,7,20,27
Armenia,2008,ep,014,19,29,48
Armenia,2008,ep,1524,23,51,74
Armenia,2008,ep,2534,18,30,48
Armenia,2008,ep,3544,14,21,35
Armenia,2008,ep,4554,14,33,47
Armenia,2008,ep,5564,15,13,28
Armenia,2008,ep,65,5,11,16
Armenia,2008,sn,014,15,18,33
Armenia,2008,sn,1524,38,107,145
Armenia,2008,sn,2534,45,88,133
Armenia,2008,sn,3544,27,76,103
Armenia,2008,sn,4554,30,112,142
Armenia,2008,sn,5564,12,64,76
Armenia,2008,sn,65,13,79,92
Armenia,2008,sp,014,4,0,4
Armenia,2008,sp,1524,44,53,97
Armenia,2008,sp,2534,25,103,128
Armenia,2008,sp,3544,10,74,84
Armenia,2008,sp,4554,14,87,101
Armenia,2008,sp,5564,10,37,47
Armenia,2008,sp,65,11,15,26
Armenia,2009,ep,014,18,32,50
Armenia,2009,ep,1524,31,61,92
Armenia,2009,ep,2534,10,28,38
Armenia,2009,ep,3544,12,22,34
Armenia,2009,ep,4554,18,21,39
Armenia,2009,ep,5564,9,15,24
Armenia,2009,ep,65,7,15,22
Armenia,2009,sn,014,6,6,12
Armenia,2009,sn,1524,38,102,140
Armenia,2009,sn,2534,42,100,142
Armenia,2009,sn,3544,23,85,108
Armenia,2009,sn,4554,26,106,132
Armenia,2009,sn,5564,16,84,100
Armenia,2009,sn,65,22,69,91
Armenia,2009,sp,014,2,1,3
Armenia,2009,sp,1524,33,52,85
Armenia,2009,sp,2534,29,76,105
Armenia,2009,sp,3544,7,59,66
Armenia,2009,sp,4554,9,102,111
Armenia,2009,sp,5564,9,36,45
Armenia,2009,sp,65,9,16,25
Armenia,2010,ep,014,14,31,45
Armenia,2010,ep,1524,35,53,88
Armenia,2010,ep,2534,33,44,77
Armenia,2010,ep,3544,14,18,32
Armenia,2010,ep,4554,28,23,51
Armenia,2010,ep,5564,16,17,33
Armenia,2010,ep,65,8,17,25
Armenia,2010,sn,014,7,6,13
Armenia,2010,sn,1524,28,77,105
Armenia,2010,sn,2534,52,93,145
Armenia,2010,sn,3544,17,72,89
Armenia,2010,sn,4554,24,101,125
Armenia,2010,sn,5564,23,75,98
Armenia,2010,sn,65,15,49,64
Armenia,2010,sp,014,1,0,1
Armenia,2010,sp,1524,24,36,60
Armenia,2010,sp,2534,17,75,92
Armenia,2010,sp,3544,4,49,53
Armenia,2010,sp,4554,7,68,75
Armenia,2010,sp,5564,8,27,35
Armenia,2010,sp,65,8,15,23
Armenia,2011,ep,014,12,19,31
Armenia,2011,ep,1524,30,43,73
Armenia,2011,ep,2534,23,33,56
Armenia,2011,ep,3544,15,18,33
Armenia,2011,ep,4554,21,19,40
Armenia,2011,ep,5564,12,22,34
Armenia,2011,ep,65,9,13,22
Armenia,2011,sn,014,11,5,16
Armenia,2011,sn,1524,20,66,86
Armenia,2011,sn,2534,27,76,103
Armenia,2011,sn,3544,18,64,82
Armenia,2011,sn,4554,29,93,122
Armenia,2011,sn,5564,18,72,90
Armenia,2011,sn,65,14,69,83
Armenia,2011,sp,014,0,0,0
Armenia,2011,sp,1524,19,28,47
Armenia,2011,sp,2534,16,65,81
Armenia,2011,sp,3544,9,52,61
Armenia,2011,sp,4554,7,71,78
Armenia,2011,sp,5564,7,42,49
Armenia,2011,sp,65,5,8,13
Armenia,2012,ep,014,6,20,26
Armenia,2012,ep,1524,12,34,46
Armenia,2012,ep,2534,34,14,48
Armenia,2012,ep,3544,15,27,42
Armenia,2012,ep,4554,11,29,40
Armenia,2012,ep,5564,13,18,31
Armenia,2012,ep,65,9,13,22
Armenia,2012,sn,014,2,8,10
Armenia,2012,sn,1524,18,53,71
Armenia,2012,sn,2534,32,73,105
Armenia,2012,sn,3544,13,64,77
Armenia,2012,sn,4554,21,84,105
Armenia,2012,sn,5564,22,89,111
Armenia,2012,sn,65,16,58,74
Armenia,2012,sp,014,0,1,1
Armenia,2012,sp,1524,13,23,36
Armenia,2012,sp,2534,19,67,86
Armenia,2012,sp,3544,12,60,72
Armenia,2012,sp,4554,2,56,58
Armenia,2012,sp,5564,5,34,39
Armenia,2012,sp,65,5,18,23
Armenia,2013,rel,014,17,25,42
Armenia,2013,rel,1524,50,116,166
Armenia,2013,rel,2534,81,169,250
Armenia,2013,rel,3544,48,165,213
Armenia,2013,rel,4554,52,254,306
Armenia,2013,rel,5564,48,217,265
Armenia,2013,rel,65,33,122,155
Aruba,2011,ep,4554,NA,1,NA
Aruba,2011,sp,2534,1,NA,NA
Aruba,2011,sp,4554,NA,4,NA
Aruba,2011,sp,65,1,1,2
Aruba,2012,ep,014,1,NA,NA
Aruba,2012,ep,1524,4,NA,NA
Aruba,2012,ep,3544,1,2,3
Aruba,2012,ep,4554,NA,3,NA
Aruba,2012,ep,5564,1,NA,NA
Aruba,2012,ep,65,1,NA,NA
Aruba,2012,sn,014,1,1,2
Aruba,2012,sn,1524,5,1,6
Aruba,2012,sn,3544,3,2,5
Aruba,2012,sn,4554,2,4,6
Aruba,2012,sn,5564,1,2,3
Aruba,2012,sn,65,1,NA,NA
Aruba,2012,sp,014,1,NA,NA
Aruba,2012,sp,1524,4,NA,NA
Aruba,2012,sp,3544,2,2,4
Aruba,2012,sp,4554,1,3,4
Aruba,2012,sp,65,1,NA,NA
Aruba,2013,rel,1524,1,NA,NA
Aruba,2013,rel,3544,NA,2,NA
Aruba,2013,rel,4554,1,1,2
Aruba,2013,rel,5564,2,2,4
Aruba,2013,rel,65,2,NA,NA
Australia,1997,sp,014,0,1,1
Australia,1997,sp,1524,10,8,18
Australia,1997,sp,2534,15,24,39
Australia,1997,sp,3544,9,18,27
Australia,1997,sp,4554,5,13,18
Australia,1997,sp,5564,10,17,27
Australia,1997,sp,65,12,28,40
Australia,1998,sp,014,2,0,2
Australia,1998,sp,1524,19,11,30
Australia,1998,sp,2534,24,22,46
Australia,1998,sp,3544,15,18,33
Australia,1998,sp,4554,8,13,21
Australia,1998,sp,5564,2,15,17
Australia,1998,sp,65,24,31,55
Australia,1999,sp,014,0,0,0
Australia,1999,sp,1524,10,13,23
Australia,1999,sp,2534,16,40,56
Australia,1999,sp,3544,18,54,72
Australia,1999,sp,4554,6,52,58
Australia,1999,sp,5564,2,37,39
Australia,1999,sp,65,26,49,75
Australia,2000,sp,014,0,3,3
Australia,2000,sp,1524,15,16,31
Australia,2000,sp,2534,19,35,54
Australia,2000,sp,3544,12,25,37
Australia,2000,sp,4554,15,24,39
Australia,2000,sp,5564,5,19,24
Australia,2000,sp,65,14,49,63
Australia,2001,sp,014,1,1,2
Australia,2001,sp,1524,21,23,44
Australia,2001,sp,2534,27,20,47
Australia,2001,sp,3544,16,18,34
Australia,2001,sp,4554,7,18,25
Australia,2001,sp,5564,8,13,21
Australia,2001,sp,65,20,35,55
Australia,2002,sp,014,0,1,1
Australia,2002,sp,1524,15,15,30
Australia,2002,sp,2534,21,20,41
Australia,2002,sp,3544,15,26,41
Australia,2002,sp,4554,6,19,25
Australia,2002,sp,5564,4,13,17
Australia,2002,sp,65,23,34,57
Australia,2003,sp,014,0,0,0
Australia,2003,sp,1524,9,14,23
Australia,2003,sp,2534,13,10,23
Australia,2003,sp,3544,3,2,5
Australia,2003,sp,4554,5,11,16
Australia,2003,sp,5564,4,5,9
Australia,2003,sp,65,7,30,37
Australia,2004,sp,014,0,0,0
Australia,2004,sp,1524,6,18,24
Australia,2004,sp,2534,17,16,33
Australia,2004,sp,3544,5,17,22
Australia,2004,sp,4554,7,15,22
Australia,2004,sp,5564,3,11,14
Australia,2004,sp,65,19,32,51
Australia,2005,sp,014,2,0,2
Australia,2005,sp,1524,18,32,50
Australia,2005,sp,2534,26,27,53
Australia,2005,sp,3544,11,23,34
Australia,2005,sp,4554,10,11,21
Australia,2005,sp,5564,6,12,18
Australia,2005,sp,65,14,30,44
Australia,2006,ep,014,9,11,20
Australia,2006,ep,1524,30,30,60
Australia,2006,ep,2534,61,48,109
Australia,2006,ep,3544,47,33,80
Australia,2006,ep,4554,40,22,62
Australia,2006,ep,5564,17,21,38
Australia,2006,ep,65,43,45,88
Australia,2006,sn,014,22,15,37
Australia,2006,sn,1524,20,37,57
Australia,2006,sn,2534,48,50,98
Australia,2006,sn,3544,30,31,61
Australia,2006,sn,4554,18,36,54
Australia,2006,sn,5564,15,20,35
Australia,2006,sn,65,42,53,95
Australia,2006,sp,014,2,1,3
Australia,2006,sp,1524,18,33,51
Australia,2006,sp,2534,27,35,62
Australia,2006,sp,3544,14,23,37
Australia,2006,sp,4554,7,21,28
Australia,2006,sp,5564,9,16,25
Australia,2006,sp,65,21,43,64
Australia,2007,ep,014,8,9,17
Australia,2007,ep,1524,17,32,49
Australia,2007,ep,2534,74,68,142
Australia,2007,ep,3544,29,35,64
Australia,2007,ep,4554,36,25,61
Australia,2007,ep,5564,23,22,45
Australia,2007,ep,65,26,24,50
Australia,2007,sn,014,16,17,33
Australia,2007,sn,1524,23,30,53
Australia,2007,sn,2534,41,53,94
Australia,2007,sn,3544,21,23,44
Australia,2007,sn,4554,11,33,44
Australia,2007,sn,5564,12,17,29
Australia,2007,sn,65,30,45,75
Australia,2007,sp,014,4,3,7
Australia,2007,sp,1524,26,30,56
Australia,2007,sp,2534,37,33,70
Australia,2007,sp,3544,20,20,40
Australia,2007,sp,4554,12,15,27
Australia,2007,sp,5564,7,14,21
Australia,2007,sp,65,23,37,60
Australia,2008,ep,014,7,11,18
Australia,2008,ep,1524,39,30,69
Australia,2008,ep,2534,67,70,137
Australia,2008,ep,3544,47,38,85
Australia,2008,ep,4554,33,25,58
Australia,2008,ep,5564,26,13,39
Australia,2008,ep,65,29,28,57
Australia,2008,sn,014,17,12,29
Australia,2008,sn,1524,29,65,94
Australia,2008,sn,2534,42,58,100
Australia,2008,sn,3544,17,34,51
Australia,2008,sn,4554,13,19,32
Australia,2008,sn,5564,12,26,38
Australia,2008,sn,65,18,37,55
Australia,2008,sp,014,3,2,5
Australia,2008,sp,1524,27,46,73
Australia,2008,sp,2534,32,33,65
Australia,2008,sp,3544,14,20,34
Australia,2008,sp,4554,6,27,33
Australia,2008,sp,5564,11,23,34
Australia,2008,sp,65,10,42,52
Australia,2009,ep,014,8,15,23
Australia,2009,ep,1524,32,50,82
Australia,2009,ep,2534,86,95,181
Australia,2009,ep,3544,42,49,91
Australia,2009,ep,4554,28,19,47
Australia,2009,ep,5564,21,14,35
Australia,2009,ep,65,25,26,51
Australia,2009,sn,014,10,14,24
Australia,2009,sn,1524,41,46,87
Australia,2009,sn,2534,51,51,102
Australia,2009,sn,3544,24,24,48
Australia,2009,sn,4554,19,23,42
Australia,2009,sn,5564,13,18,31
Australia,2009,sn,65,13,44,57
Australia,2009,sp,014,4,3,7
Australia,2009,sp,1524,31,30,61
Australia,2009,sp,2534,27,37,64
Australia,2009,sp,3544,14,16,30
Australia,2009,sp,4554,12,24,36
Australia,2009,sp,5564,11,12,23
Australia,2009,sp,65,12,34,46
Australia,2010,ep,014,5,8,13
Australia,2010,ep,1524,40,33,73
Australia,2010,ep,2534,84,97,181
Australia,2010,ep,3544,28,40,68
Australia,2010,ep,4554,30,23,53
Australia,2010,ep,5564,13,10,23
Australia,2010,ep,65,25,21,46
Australia,2010,sn,014,9,13,22
Australia,2010,sn,1524,38,54,92
Australia,2010,sn,2534,52,68,120
Australia,2010,sn,3544,23,28,51
Australia,2010,sn,4554,18,25,43
Australia,2010,sn,5564,9,19,28
Australia,2010,sn,65,16,36,52
Australia,2010,sp,014,4,2,6
Australia,2010,sp,1524,36,42,78
Australia,2010,sp,2534,43,33,76
Australia,2010,sp,3544,12,22,34
Australia,2010,sp,4554,2,25,27
Australia,2010,sp,5564,5,9,14
Australia,2010,sp,65,12,27,39
Australia,2011,ep,014,7,8,15
Australia,2011,ep,1524,34,42,76
Australia,2011,ep,2534,88,84,172
Australia,2011,ep,3544,36,43,79
Australia,2011,ep,4554,23,31,54
Australia,2011,ep,5564,18,13,31
Australia,2011,ep,65,14,22,36
Australia,2011,sn,014,16,11,27
Australia,2011,sn,1524,37,40,77
Australia,2011,sn,2534,60,82,142
Australia,2011,sn,3544,30,29,59
Australia,2011,sn,4554,13,15,28
Australia,2011,sn,5564,9,26,35
Australia,2011,sn,65,26,42,68
Australia,2011,sp,014,3,2,5
Australia,2011,sp,1524,26,38,64
Australia,2011,sp,2534,40,44,84
Australia,2011,sp,3544,23,26,49
Australia,2011,sp,4554,7,19,26
Australia,2011,sp,5564,7,12,19
Australia,2011,sp,65,17,37,54
Australia,2012,ep,014,8,8,16
Australia,2012,ep,1524,32,31,63
Australia,2012,ep,2534,76,119,195
Australia,2012,ep,3544,42,38,80
Australia,2012,ep,4554,32,19,51
Australia,2012,ep,5564,20,17,37
Australia,2012,ep,65,26,30,56
Australia,2012,sn,014,14,14,28
Australia,2012,sn,1524,28,43,71
Australia,2012,sn,2534,65,46,111
Australia,2012,sn,3544,27,28,55
Australia,2012,sn,4554,12,29,41
Australia,2012,sn,5564,14,22,36
Australia,2012,sn,65,12,53,65
Australia,2012,sp,014,1,3,4
Australia,2012,sp,1524,27,26,53
Australia,2012,sp,2534,48,40,88
Australia,2012,sp,3544,15,17,32
Australia,2012,sp,4554,11,25,36
Australia,2012,sp,5564,9,16,25
Australia,2012,sp,65,15,37,52
Australia,2013,rel,014,20,28,48
Australia,2013,rel,1524,95,105,200
Australia,2013,rel,2534,165,206,371
Australia,2013,rel,3544,97,108,205
Australia,2013,rel,4554,62,67,129
Australia,2013,rel,5564,46,68,114
Australia,2013,rel,65,63,120,183
Austria,1995,sp,014,6,4,10
Austria,1995,sp,1524,22,37,59
Austria,1995,sp,2534,52,95,147
Austria,1995,sp,3544,32,82,114
Austria,1995,sp,4554,21,89,110
Austria,1995,sp,5564,18,71,89
Austria,1995,sp,65,59,73,132
Austria,1997,sp,014,33,24,57
Austria,1997,sp,1524,41,59,100
Austria,1997,sp,2534,93,117,210
Austria,1997,sp,3544,62,170,232
Austria,1997,sp,4554,52,168,220
Austria,1997,sp,5564,52,122,174
Austria,1997,sp,65,172,185,357
Austria,1999,sp,014,0,0,0
Austria,1999,sp,1524,10,13,23
Austria,1999,sp,2534,16,40,56
Austria,1999,sp,3544,18,54,72
Austria,1999,sp,4554,6,52,58
Austria,1999,sp,5564,2,37,39
Austria,1999,sp,65,26,49,75
Austria,2000,sp,014,1,1,2
Austria,2000,sp,1524,11,17,28
Austria,2000,sp,2534,22,30,52
Austria,2000,sp,3544,12,59,71
Austria,2000,sp,4554,11,42,53
Austria,2000,sp,5564,6,23,29
Austria,2000,sp,65,22,41,63
Austria,2001,sp,014,1,1,2
Austria,2001,sp,1524,8,15,23
Austria,2001,sp,2534,13,27,40
Austria,2001,sp,3544,15,39,54
Austria,2001,sp,4554,4,37,41
Austria,2001,sp,5564,6,37,43
Austria,2001,sp,65,18,27,45
Austria,2002,sp,014,0,1,1
Austria,2002,sp,1524,8,8,16
Austria,2002,sp,2534,13,14,27
Austria,2002,sp,3544,7,32,39
Austria,2002,sp,4554,5,43,48
Austria,2002,sp,5564,7,20,27
Austria,2002,sp,65,21,25,46
Austria,2003,sp,014,2,0,2
Austria,2003,sp,1524,10,19,29
Austria,2003,sp,2534,25,31,56
Austria,2003,sp,3544,12,37,49
Austria,2003,sp,4554,7,43,50
Austria,2003,sp,5564,4,19,23
Austria,2003,sp,65,12,28,40
Austria,2004,sp,014,0,1,1
Austria,2004,sp,1524,12,19,31
Austria,2004,sp,2534,15,19,34
Austria,2004,sp,3544,9,38,47
Austria,2004,sp,4554,3,27,30
Austria,2004,sp,5564,3,24,27
Austria,2004,sp,65,16,21,37
Austria,2005,sp,014,0,1,1
Austria,2005,sp,1524,13,32,45
Austria,2005,sp,2534,11,23,34
Austria,2005,sp,3544,8,22,30
Austria,2005,sp,4554,3,41,44
Austria,2005,sp,5564,5,24,29
Austria,2005,sp,65,10,30,40
Austria,2006,ep,014,2,3,5
Austria,2006,ep,1524,7,11,18
Austria,2006,ep,2534,10,9,19
Austria,2006,ep,3544,7,12,19
Austria,2006,ep,4554,10,15,25
Austria,2006,ep,5564,6,5,11
Austria,2006,ep,65,25,13,38
Austria,2006,sn,014,26,22,48
Austria,2006,sn,1524,16,27,43
Austria,2006,sn,2534,19,46,65
Austria,2006,sn,3544,25,53,78
Austria,2006,sn,4554,21,60,81
Austria,2006,sn,5564,18,51,69
Austria,2006,sn,65,49,74,123
Austria,2006,sp,014,2,1,3
Austria,2006,sp,1524,12,9,21
Austria,2006,sp,2534,12,25,37
Austria,2006,sp,3544,16,36,52
Austria,2006,sp,4554,5,39,44
Austria,2006,sp,5564,3,19,22
Austria,2006,sp,65,15,19,34
Austria,2007,ep,014,4,0,4
Austria,2007,ep,1524,4,8,12
Austria,2007,ep,2534,6,6,12
Austria,2007,ep,3544,5,15,20
Austria,2007,ep,4554,4,15,19
Austria,2007,ep,5564,9,12,21
Austria,2007,ep,65,18,29,47
Austria,2007,sn,014,5,13,18
Austria,2007,sn,1524,24,28,52
Austria,2007,sn,2534,31,54,85
Austria,2007,sn,3544,13,51,64
Austria,2007,sn,4554,23,57,80
Austria,2007,sn,5564,19,59,78
Austria,2007,sn,65,39,70,109
Austria,2007,sp,014,2,1,3
Austria,2007,sp,1524,10,12,22
Austria,2007,sp,2534,14,15,29
Austria,2007,sp,3544,7,27,34
Austria,2007,sp,4554,11,26,37
Austria,2007,sp,5564,2,18,20
Austria,2007,sp,65,19,25,44
Austria,2009,ep,014,2,0,2
Austria,2009,ep,1524,4,2,6
Austria,2009,ep,2534,1,8,9
Austria,2009,ep,3544,12,5,17
Austria,2009,ep,4554,3,11,14
Austria,2009,ep,5564,2,2,4
Austria,2009,ep,65,13,13,26
Austria,2009,sn,014,8,6,14
Austria,2009,sn,1524,13,14,27
Austria,2009,sn,2534,14,23,37
Austria,2009,sn,3544,16,14,30
Austria,2009,sn,4554,17,28,45
Austria,2009,sn,5564,7,32,39
Austria,2009,sn,65,27,47,74
Austria,2009,sp,014,0,0,0
Austria,2009,sp,1524,7,4,11
Austria,2009,sp,2534,8,10,18
Austria,2009,sp,3544,4,13,17
Austria,2009,sp,4554,5,12,17
Austria,2009,sp,5564,1,7,8
Austria,2009,sp,65,5,13,18
Austria,2010,ep,014,2,1,3
Austria,2010,ep,1524,4,3,7
Austria,2010,ep,2534,6,2,8
Austria,2010,ep,3544,6,10,16
Austria,2010,ep,4554,9,2,11
Austria,2010,ep,5564,5,5,10
Austria,2010,ep,65,7,7,14
Austria,2010,sn,014,6,6,12
Austria,2010,sn,1524,7,15,22
Austria,2010,sn,2534,13,11,24
Austria,2010,sn,3544,14,19,33
Austria,2010,sn,4554,12,29,41
Austria,2010,sn,5564,7,17,24
Austria,2010,sn,65,26,33,59
Austria,2010,sp,014,1,0,1
Austria,2010,sp,1524,5,4,9
Austria,2010,sp,2534,4,4,8
Austria,2010,sp,3544,2,12,14
Austria,2010,sp,4554,2,13,15
Austria,2010,sp,5564,5,8,13
Austria,2010,sp,65,6,10,16
Austria,2011,ep,014,2,0,2
Austria,2011,ep,1524,5,4,9
Austria,2011,ep,2534,8,10,18
Austria,2011,ep,3544,7,9,16
Austria,2011,ep,4554,3,6,9
Austria,2011,ep,5564,4,4,8
Austria,2011,ep,65,15,10,25
Austria,2011,sn,014,8,9,17
Austria,2011,sn,1524,12,14,26
Austria,2011,sn,2534,10,21,31
Austria,2011,sn,3544,16,21,37
Austria,2011,sn,4554,12,20,32
Austria,2011,sn,5564,5,25,30
Austria,2011,sn,65,18,24,42
Austria,2011,sp,014,0,0,0
Austria,2011,sp,1524,11,8,19
Austria,2011,sp,2534,6,11,17
Austria,2011,sp,3544,4,9,13
Austria,2011,sp,4554,1,13,14
Austria,2011,sp,5564,3,11,14
Austria,2011,sp,65,4,13,17
Austria,2012,ep,014,0,3,3
Austria,2012,ep,1524,1,10,11
Austria,2012,ep,2534,7,14,21
Austria,2012,ep,3544,7,8,15
Austria,2012,ep,4554,3,5,8
Austria,2012,ep,5564,9,6,15
Austria,2012,ep,65,14,10,24
Austria,2012,sn,014,9,9,18
Austria,2012,sn,1524,14,18,32
Austria,2012,sn,2534,19,26,45
Austria,2012,sn,3544,11,13,24
Austria,2012,sn,4554,20,26,46
Austria,2012,sn,5564,5,7,12
Austria,2012,sn,65,13,28,41
Austria,2012,sp,014,1,1,2
Austria,2012,sp,1524,10,5,15
Austria,2012,sp,2534,8,8,16
Austria,2012,sp,3544,4,7,11
Austria,2012,sp,4554,4,19,23
Austria,2012,sp,5564,1,9,10
Austria,2012,sp,65,5,13,18
Austria,2013,rel,014,8,15,23
Austria,2013,rel,1524,45,44,89
Austria,2013,rel,2534,37,66,103
Austria,2013,rel,3544,36,46,82
Austria,2013,rel,4554,34,68,102
Austria,2013,rel,5564,28,53,81
Austria,2013,rel,65,58,86,144
Azerbaijan,1995,sp,014,0,0,0
Azerbaijan,1995,sp,1524,5,13,18
Azerbaijan,1995,sp,2534,18,29,47
Azerbaijan,1995,sp,3544,0,14,14
Azerbaijan,1995,sp,4554,0,6,6
Azerbaijan,1995,sp,5564,0,4,4
Azerbaijan,1995,sp,65,0,1,1
Azerbaijan,1996,sp,014,5,0,5
Azerbaijan,1996,sp,1524,20,57,77
Azerbaijan,1996,sp,2534,154,302,456
Azerbaijan,1996,sp,3544,86,231,317
Azerbaijan,1996,sp,4554,16,47,63
Azerbaijan,1996,sp,5564,13,101,114
Azerbaijan,1996,sp,65,10,16,26
Azerbaijan,1997,sp,014,0,0,0
Azerbaijan,1997,sp,1524,42,120,162
Azerbaijan,1997,sp,2534,70,244,314
Azerbaijan,1997,sp,3544,178,194,372
Azerbaijan,1997,sp,4554,23,89,112
Azerbaijan,1997,sp,5564,0,12,12
Azerbaijan,1997,sp,65,0,3,3
Azerbaijan,1998,sp,014,0,0,0
Azerbaijan,1998,sp,1524,7,44,51
Azerbaijan,1998,sp,2534,10,47,57
Azerbaijan,1998,sp,3544,7,24,31
Azerbaijan,1998,sp,4554,6,9,15
Azerbaijan,1998,sp,5564,1,4,5
Azerbaijan,1998,sp,65,0,2,2
Azerbaijan,1999,sp,014,0,0,0
Azerbaijan,1999,sp,1524,4,96,100
Azerbaijan,1999,sp,2534,17,46,63
Azerbaijan,1999,sp,3544,73,217,290
Azerbaijan,1999,sp,4554,58,184,242
Azerbaijan,1999,sp,5564,19,49,68
Azerbaijan,1999,sp,65,0,0,0
Azerbaijan,2000,sp,014,0,0,0
Azerbaijan,2000,sp,1524,3,9,12
Azerbaijan,2000,sp,2534,3,24,27
Azerbaijan,2000,sp,3544,6,33,39
Azerbaijan,2000,sp,4554,3,42,45
Azerbaijan,2000,sp,5564,0,30,30
Azerbaijan,2000,sp,65,0,0,0
Azerbaijan,2001,sp,014,2,3,5
Azerbaijan,2001,sp,1524,NA,1,NA
Azerbaijan,2001,sp,2534,1,3,4
Azerbaijan,2002,sp,014,5,6,11
Azerbaijan,2002,sp,1524,48,290,338
Azerbaijan,2002,sp,2534,88,433,521
Azerbaijan,2002,sp,3544,80,359,439
Azerbaijan,2002,sp,4554,34,190,224
Azerbaijan,2002,sp,5564,19,72,91
Azerbaijan,2002,sp,65,21,16,37
Azerbaijan,2003,sp,014,1,3,4
Azerbaijan,2003,sp,1524,72,212,284
Azerbaijan,2003,sp,2534,60,258,318
Azerbaijan,2003,sp,3544,62,215,277
Azerbaijan,2003,sp,4554,48,113,161
Azerbaijan,2003,sp,5564,26,66,92
Azerbaijan,2003,sp,65,5,20,25
Azerbaijan,2004,sp,014,8,8,16
Azerbaijan,2004,sp,1524,120,248,368
Azerbaijan,2004,sp,2534,65,311,376
Azerbaijan,2004,sp,3544,57,222,279
Azerbaijan,2004,sp,4554,34,167,201
Azerbaijan,2004,sp,5564,33,92,125
Azerbaijan,2004,sp,65,24,83,107
Azerbaijan,2005,sp,014,90,77,167
Azerbaijan,2005,sp,1524,64,109,173
Azerbaijan,2005,sp,2534,98,297,395
Azerbaijan,2005,sp,3544,47,215,262
Azerbaijan,2005,sp,4554,32,209,241
Azerbaijan,2005,sp,5564,24,187,211
Azerbaijan,2005,sp,65,24,88,112
Azerbaijan,2006,ep,014,39,107,146
Azerbaijan,2006,ep,1524,35,186,221
Azerbaijan,2006,ep,2534,41,129,170
Azerbaijan,2006,ep,3544,29,60,89
Azerbaijan,2006,ep,4554,10,39,49
Azerbaijan,2006,ep,5564,3,9,12
Azerbaijan,2006,ep,65,6,4,10
Azerbaijan,2006,sn,014,23,40,63
Azerbaijan,2006,sn,1524,114,351,465
Azerbaijan,2006,sn,2534,117,448,565
Azerbaijan,2006,sn,3544,85,469,554
Azerbaijan,2006,sn,4554,52,387,439
Azerbaijan,2006,sn,5564,18,96,114
Azerbaijan,2006,sn,65,17,61,78
Azerbaijan,2006,sp,014,2,6,8
Azerbaijan,2006,sp,1524,51,241,292
Azerbaijan,2006,sp,2534,66,362,428
Azerbaijan,2006,sp,3544,66,365,431
Azerbaijan,2006,sp,4554,44,120,164
Azerbaijan,2006,sp,5564,15,78,93
Azerbaijan,2006,sp,65,8,30,38
Azerbaijan,2009,ep,014,60,105,165
Azerbaijan,2009,sn,014,42,48,90
Azerbaijan,2009,sp,014,11,5,16
Azerbaijan,2009,sp,1524,108,229,337
Azerbaijan,2009,sp,2534,92,190,282
Azerbaijan,2009,sp,3544,37,165,202
Azerbaijan,2009,sp,4554,41,151,192
Azerbaijan,2009,sp,5564,14,63,77
Azerbaijan,2009,sp,65,19,30,49
Azerbaijan,2010,ep,014,55,97,152
Azerbaijan,2010,ep,1524,100,265,365
Azerbaijan,2010,ep,2534,64,97,161
Azerbaijan,2010,ep,3544,58,67,125
Azerbaijan,2010,ep,4554,49,67,116
Azerbaijan,2010,ep,5564,8,15,23
Azerbaijan,2010,ep,65,11,12,23
Azerbaijan,2010,sn,014,34,55,89
Azerbaijan,2010,sn,1524,175,598,773
Azerbaijan,2010,sn,2534,120,316,436
Azerbaijan,2010,sn,3544,66,198,264
Azerbaijan,2010,sn,4554,80,306,386
Azerbaijan,2010,sn,5564,10,57,67
Azerbaijan,2010,sn,65,29,79,108
Azerbaijan,2010,sp,014,3,0,3
Azerbaijan,2010,sp,1524,141,328,469
Azerbaijan,2010,sp,2534,100,371,471
Azerbaijan,2010,sp,3544,57,267,324
Azerbaijan,2010,sp,4554,73,280,353
Azerbaijan,2010,sp,5564,9,30,39
Azerbaijan,2010,sp,65,18,27,45
Azerbaijan,2011,ep,014,80,106,186
Azerbaijan,2011,ep,1524,111,277,388
Azerbaijan,2011,ep,2534,107,107,214
Azerbaijan,2011,ep,3544,53,69,122
Azerbaijan,2011,ep,4554,64,74,138
Azerbaijan,2011,ep,5564,30,32,62
Azerbaijan,2011,ep,65,3,17,20
Azerbaijan,2012,ep,014,59,91,150
Azerbaijan,2012,ep,1524,104,264,368
Azerbaijan,2012,ep,2534,74,96,170
Azerbaijan,2012,ep,3544,63,80,143
Azerbaijan,2012,ep,4554,37,56,93
Azerbaijan,2012,ep,5564,29,30,59
Azerbaijan,2012,ep,65,4,15,19
Azerbaijan,2012,sn,014,26,24,50
Azerbaijan,2012,sn,1524,182,459,641
Azerbaijan,2012,sn,2534,135,400,535
Azerbaijan,2012,sn,3544,74,291,365
Azerbaijan,2012,sn,4554,82,294,376
Azerbaijan,2012,sn,5564,63,158,221
Azerbaijan,2012,sn,65,36,89,125
Azerbaijan,2012,sp,014,8,4,12
Azerbaijan,2012,sp,1524,115,230,345
Azerbaijan,2012,sp,2534,89,223,312
Azerbaijan,2012,sp,3544,35,170,205
Azerbaijan,2012,sp,4554,50,176,226
Azerbaijan,2012,sp,5564,35,95,130
Azerbaijan,2012,sp,65,23,48,71
Azerbaijan,2013,rel,014,90,125,215
Azerbaijan,2013,rel,1524,376,958,1334
Azerbaijan,2013,rel,2534,302,663,965
Azerbaijan,2013,rel,3544,145,538,683
Azerbaijan,2013,rel,4554,166,556,722
Azerbaijan,2013,rel,5564,104,306,410
Azerbaijan,2013,rel,65,75,124,199
Bahamas,1995,sp,014,0,3,3
Bahamas,1995,sp,1524,1,3,4
Bahamas,1995,sp,2534,7,5,12
Bahamas,1995,sp,3544,2,7,9
Bahamas,1995,sp,4554,0,4,4
Bahamas,1995,sp,5564,0,2,2
Bahamas,1995,sp,65,1,2,3
Bahamas,1996,sp,014,0,0,0
Bahamas,1996,sp,1524,2,1,3
Bahamas,1996,sp,2534,4,4,8
Bahamas,1996,sp,3544,4,4,8
Bahamas,1996,sp,4554,0,5,5
Bahamas,1996,sp,5564,1,0,1
Bahamas,1996,sp,65,1,0,1
Bahamas,1997,sp,014,0,0,0
Bahamas,1997,sp,1524,2,2,4
Bahamas,1997,sp,2534,5,14,19
Bahamas,1997,sp,3544,7,11,18
Bahamas,1997,sp,4554,4,5,9
Bahamas,1997,sp,5564,0,3,3
Bahamas,1997,sp,65,2,2,4
Bahamas,1998,sp,014,1,0,1
Bahamas,1998,sp,1524,1,3,4
Bahamas,1998,sp,2534,3,2,5
Bahamas,1998,sp,3544,5,7,12
Bahamas,1998,sp,4554,1,5,6
Bahamas,1998,sp,5564,0,3,3
Bahamas,1998,sp,65,0,0,0
Bahamas,1999,sp,014,0,1,1
Bahamas,1999,sp,1524,1,0,1
Bahamas,1999,sp,2534,3,10,13
Bahamas,1999,sp,3544,4,8,12
Bahamas,1999,sp,4554,2,6,8
Bahamas,1999,sp,5564,0,0,0
Bahamas,1999,sp,65,0,0,0
Bahamas,2000,sp,014,2,1,3
Bahamas,2000,sp,1524,5,2,7
Bahamas,2000,sp,2534,7,7,14
Bahamas,2000,sp,3544,8,9,17
Bahamas,2000,sp,4554,2,4,6
Bahamas,2000,sp,5564,3,3,6
Bahamas,2000,sp,65,1,2,3
Bahamas,2002,sp,014,4,2,6
Bahamas,2002,sp,1524,1,2,3
Bahamas,2002,sp,2534,6,2,8
Bahamas,2002,sp,3544,3,7,10
Bahamas,2002,sp,4554,3,7,10
Bahamas,2002,sp,5564,1,3,4
Bahamas,2002,sp,65,1,2,3
Bahamas,2003,sp,014,2,0,2
Bahamas,2003,sp,1524,2,2,4
Bahamas,2003,sp,2534,2,5,7
Bahamas,2003,sp,3544,4,6,10
Bahamas,2003,sp,4554,3,3,6
Bahamas,2003,sp,5564,2,1,3
Bahamas,2003,sp,65,3,3,6
Bahamas,2004,sp,014,0,3,3
Bahamas,2004,sp,1524,3,3,6
Bahamas,2004,sp,2534,4,6,10
Bahamas,2004,sp,3544,1,14,15
Bahamas,2004,sp,4554,0,9,9
Bahamas,2004,sp,5564,3,0,3
Bahamas,2004,sp,65,0,1,1
Bahamas,2007,ep,014,2,1,3
Bahamas,2007,ep,1524,2,0,2
Bahamas,2007,ep,2534,1,1,2
Bahamas,2007,ep,3544,0,0,0
Bahamas,2007,ep,4554,0,0,0
Bahamas,2007,ep,5564,0,0,0
Bahamas,2007,ep,65,0,0,0
Bahamas,2007,sn,014,0,0,0
Bahamas,2007,sn,1524,0,1,1
Bahamas,2007,sn,2534,0,1,1
Bahamas,2007,sn,3544,1,1,2
Bahamas,2007,sn,4554,1,0,1
Bahamas,2007,sn,5564,0,0,0
Bahamas,2007,sn,65,0,1,1
Bahamas,2007,sp,014,0,0,0
Bahamas,2007,sp,1524,3,3,6
Bahamas,2007,sp,2534,4,3,7
Bahamas,2007,sp,3544,3,9,12
Bahamas,2007,sp,4554,1,4,5
Bahamas,2007,sp,5564,1,1,2
Bahamas,2007,sp,65,0,0,0
Bahamas,2008,ep,014,0,0,0
Bahamas,2008,ep,1524,0,1,1
Bahamas,2008,ep,2534,1,0,1
Bahamas,2008,ep,3544,0,0,0
Bahamas,2008,ep,4554,0,1,1
Bahamas,2008,ep,5564,0,0,0
Bahamas,2008,ep,65,2,0,2
Bahamas,2008,sn,014,1,1,2
Bahamas,2008,sn,1524,0,0,0
Bahamas,2008,sn,2534,0,2,2
Bahamas,2008,sn,3544,0,4,4
Bahamas,2008,sn,4554,0,1,1
Bahamas,2008,sn,5564,0,0,0
Bahamas,2008,sn,65,0,1,1
Bahamas,2008,sp,014,0,0,0
Bahamas,2008,sp,1524,1,2,3
Bahamas,2008,sp,2534,4,6,10
Bahamas,2008,sp,3544,4,5,9
Bahamas,2008,sp,4554,0,7,7
Bahamas,2008,sp,5564,0,2,2
Bahamas,2008,sp,65,0,0,0
Bahamas,2009,ep,014,0,0,0
Bahamas,2009,ep,1524,0,1,1
Bahamas,2009,ep,2534,1,0,1
Bahamas,2009,ep,3544,0,0,0
Bahamas,2009,ep,4554,1,0,1
Bahamas,2009,ep,5564,1,1,2
Bahamas,2009,ep,65,0,0,0
Bahamas,2009,sn,014,1,2,3
Bahamas,2009,sn,1524,0,0,0
Bahamas,2009,sn,2534,1,2,3
Bahamas,2009,sn,3544,0,1,1
Bahamas,2009,sn,4554,1,0,1
Bahamas,2009,sn,5564,0,0,0
Bahamas,2009,sn,65,1,1,2
Bahamas,2009,sp,014,1,1,2
Bahamas,2009,sp,1524,2,2,4
Bahamas,2009,sp,2534,1,7,8
Bahamas,2009,sp,3544,1,4,5
Bahamas,2009,sp,4554,0,3,3
Bahamas,2009,sp,5564,1,1,2
Bahamas,2009,sp,65,0,2,2
Bahamas,2010,ep,014,0,0,0
Bahamas,2010,ep,1524,1,1,2
Bahamas,2010,ep,2534,1,1,2
Bahamas,2010,ep,3544,1,1,2
Bahamas,2010,ep,4554,0,1,1
Bahamas,2010,ep,5564,0,0,0
Bahamas,2010,ep,65,0,0,0
Bahamas,2010,sn,014,0,0,0
Bahamas,2010,sn,1524,1,0,1
Bahamas,2010,sn,2534,0,0,0
Bahamas,2010,sn,3544,0,0,0
Bahamas,2010,sn,4554,0,1,1
Bahamas,2010,sn,5564,0,1,1
Bahamas,2010,sn,65,0,0,0
Bahamas,2010,sp,014,0,0,0
Bahamas,2010,sp,1524,5,2,7
Bahamas,2010,sp,2534,1,3,4
Bahamas,2010,sp,3544,1,5,6
Bahamas,2010,sp,4554,0,0,0
Bahamas,2010,sp,5564,0,2,2
Bahamas,2010,sp,65,0,0,0
Bahamas,2011,ep,014,1,0,1
Bahamas,2011,ep,1524,0,0,0
Bahamas,2011,ep,2534,0,2,2
Bahamas,2011,ep,3544,1,1,2
Bahamas,2011,ep,4554,0,0,0
Bahamas,2011,ep,5564,0,0,0
Bahamas,2011,ep,65,0,0,0
Bahamas,2011,sn,014,0,1,1
Bahamas,2011,sn,1524,1,0,1
Bahamas,2011,sn,2534,2,0,2
Bahamas,2011,sn,3544,0,4,4
Bahamas,2011,sn,4554,0,3,3
Bahamas,2011,sn,5564,0,0,0
Bahamas,2011,sn,65,0,1,1
Bahamas,2011,sp,014,0,0,0
Bahamas,2011,sp,1524,1,2,3
Bahamas,2011,sp,2534,3,3,6
Bahamas,2011,sp,3544,3,6,9
Bahamas,2011,sp,4554,0,2,2
Bahamas,2011,sp,5564,0,2,2
Bahamas,2011,sp,65,0,1,1
Bahamas,2012,ep,014,0,0,0
Bahamas,2012,ep,1524,0,0,0
Bahamas,2012,ep,2534,0,0,0
Bahamas,2012,ep,3544,0,0,0
Bahamas,2012,ep,4554,0,0,0
Bahamas,2012,ep,5564,0,0,0
Bahamas,2012,ep,65,0,0,0
Bahamas,2012,sn,014,0,0,0
Bahamas,2012,sn,1524,1,0,1
Bahamas,2012,sn,2534,0,1,1
Bahamas,2012,sn,3544,3,0,3
Bahamas,2012,sn,4554,0,4,4
Bahamas,2012,sn,5564,1,1,2
Bahamas,2012,sn,65,0,0,0
Bahamas,2012,sp,014,0,0,0
Bahamas,2012,sp,1524,2,1,3
Bahamas,2012,sp,2534,5,1,6
Bahamas,2012,sp,3544,1,6,7
Bahamas,2012,sp,4554,1,2,3
Bahamas,2012,sp,5564,0,0,0
Bahamas,2012,sp,65,0,2,2
Bahamas,2013,rel,014,0,3,3
Bahamas,2013,rel,1524,2,2,4
Bahamas,2013,rel,2534,1,2,3
Bahamas,2013,rel,3544,5,6,11
Bahamas,2013,rel,4554,2,5,7
Bahamas,2013,rel,5564,0,2,2
Bahamas,2013,rel,65,1,2,3
Bahrain,1995,sp,014,0,0,0
Bahrain,1995,sp,1524,1,0,1
Bahrain,1995,sp,2534,1,1,2
Bahrain,1995,sp,3544,2,2,4
Bahrain,1995,sp,4554,0,3,3
Bahrain,1995,sp,5564,1,1,2
Bahrain,1995,sp,65,1,3,4
Bahrain,1996,sp,014,1,0,1
Bahrain,1996,sp,1524,10,8,18
Bahrain,1996,sp,2534,11,25,36
Bahrain,1996,sp,3544,7,24,31
Bahrain,1996,sp,4554,0,16,16
Bahrain,1996,sp,5564,3,7,10
Bahrain,1996,sp,65,3,6,9
Bahrain,1997,sp,014,0,1,1
Bahrain,1997,sp,1524,4,11,15
Bahrain,1997,sp,2534,11,32,43
Bahrain,1997,sp,3544,4,19,23
Bahrain,1997,sp,4554,2,10,12
Bahrain,1997,sp,5564,1,4,5
Bahrain,1997,sp,65,1,10,11
Bahrain,1998,sp,014,3,0,3
Bahrain,1998,sp,1524,4,3,7
Bahrain,1998,sp,2534,9,40,49
Bahrain,1998,sp,3544,7,36,43
Bahrain,1998,sp,4554,5,20,25
Bahrain,1998,sp,5564,2,13,15
Bahrain,1998,sp,65,6,22,28
Bahrain,1999,sp,014,0,0,0
Bahrain,1999,sp,1524,6,12,18
Bahrain,1999,sp,2534,11,19,30
Bahrain,1999,sp,3544,6,14,20
Bahrain,1999,sp,4554,0,13,13
Bahrain,1999,sp,5564,1,5,6
Bahrain,1999,sp,65,3,3,6
Bahrain,2000,sp,014,0,0,0
Bahrain,2000,sp,1524,1,0,1
Bahrain,2000,sp,2534,2,3,5
Bahrain,2000,sp,3544,0,2,2
Bahrain,2000,sp,4554,1,5,6
Bahrain,2000,sp,5564,1,3,4
Bahrain,2000,sp,65,1,4,5
Bahrain,2001,sp,014,0,0,0
Bahrain,2001,sp,1524,1,1,2
Bahrain,2001,sp,2534,2,2,4
Bahrain,2001,sp,3544,0,2,2
Bahrain,2001,sp,4554,2,6,8
Bahrain,2001,sp,5564,0,1,1
Bahrain,2001,sp,65,0,6,6
Bahrain,2002,sp,014,0,0,0
Bahrain,2002,sp,1524,1,1,2
Bahrain,2002,sp,2534,1,1,2
Bahrain,2002,sp,3544,1,2,3
Bahrain,2002,sp,4554,1,2,3
Bahrain,2002,sp,5564,0,1,1
Bahrain,2002,sp,65,1,5,6
Bahrain,2003,sp,014,0,0,0
Bahrain,2003,sp,1524,1,2,3
Bahrain,2003,sp,2534,0,2,2
Bahrain,2003,sp,3544,0,1,1
Bahrain,2003,sp,4554,1,1,2
Bahrain,2003,sp,5564,1,3,4
Bahrain,2003,sp,65,0,4,4
Bahrain,2004,sp,014,0,0,0
Bahrain,2004,sp,1524,1,0,1
Bahrain,2004,sp,2534,1,0,1
Bahrain,2004,sp,3544,1,2,3
Bahrain,2004,sp,4554,0,2,2
Bahrain,2004,sp,5564,1,0,1
Bahrain,2004,sp,65,2,1,3
Bahrain,2005,sp,014,1,0,1
Bahrain,2005,sp,1524,1,0,1
Bahrain,2005,sp,2534,0,0,0
Bahrain,2005,sp,3544,3,2,5
Bahrain,2005,sp,4554,1,3,4
Bahrain,2005,sp,5564,0,0,0
Bahrain,2005,sp,65,0,4,4
Bahrain,2006,ep,014,0,0,0
Bahrain,2006,ep,1524,11,4,15
Bahrain,2006,ep,2534,14,26,40
Bahrain,2006,ep,3544,9,8,17
Bahrain,2006,ep,4554,7,9,16
Bahrain,2006,ep,5564,2,3,5
Bahrain,2006,ep,65,2,7,9
Bahrain,2006,sn,014,0,0,0
Bahrain,2006,sn,1524,4,5,9
Bahrain,2006,sn,2534,15,16,31
Bahrain,2006,sn,3544,4,10,14
Bahrain,2006,sn,4554,2,7,9
Bahrain,2006,sn,5564,1,1,2
Bahrain,2006,sn,65,3,4,7
Bahrain,2006,sp,014,0,0,0
Bahrain,2006,sp,1524,7,10,17
Bahrain,2006,sp,2534,14,25,39
Bahrain,2006,sp,3544,4,11,15
Bahrain,2006,sp,4554,5,18,23
Bahrain,2006,sp,5564,2,1,3
Bahrain,2006,sp,65,0,1,1
Bahrain,2007,ep,014,5,2,7
Bahrain,2007,ep,1524,8,10,18
Bahrain,2007,ep,2534,19,18,37
Bahrain,2007,ep,3544,7,11,18
Bahrain,2007,ep,4554,3,8,11
Bahrain,2007,ep,5564,6,5,11
Bahrain,2007,ep,65,3,3,6
Bahrain,2007,sn,014,0,0,0
Bahrain,2007,sn,1524,2,7,9
Bahrain,2007,sn,2534,8,25,33
Bahrain,2007,sn,3544,8,7,15
Bahrain,2007,sn,4554,0,4,4
Bahrain,2007,sn,5564,1,3,4
Bahrain,2007,sn,65,2,4,6
Bahrain,2007,sp,014,1,0,1
Bahrain,2007,sp,1524,10,8,18
Bahrain,2007,sp,2534,15,26,41
Bahrain,2007,sp,3544,5,15,20
Bahrain,2007,sp,4554,3,8,11
Bahrain,2007,sp,5564,0,4,4
Bahrain,2007,sp,65,1,3,4
Bahrain,2008,ep,014,2,3,5
Bahrain,2008,ep,1524,7,11,18
Bahrain,2008,ep,2534,20,25,45
Bahrain,2008,ep,3544,6,15,21
Bahrain,2008,ep,4554,5,8,13
Bahrain,2008,ep,5564,1,1,2
Bahrain,2008,ep,65,0,1,1
Bahrain,2008,sn,014,0,0,0
Bahrain,2008,sn,1524,7,3,10
Bahrain,2008,sn,2534,4,15,19
Bahrain,2008,sn,3544,3,12,15
Bahrain,2008,sn,4554,1,5,6
Bahrain,2008,sn,5564,0,4,4
Bahrain,2008,sn,65,0,5,5
Bahrain,2008,sp,014,0,0,0
Bahrain,2008,sp,1524,12,17,29
Bahrain,2008,sp,2534,16,48,64
Bahrain,2008,sp,3544,8,27,35
Bahrain,2008,sp,4554,1,8,9
Bahrain,2008,sp,5564,0,2,2
Bahrain,2008,sp,65,0,3,3
Bahrain,2009,ep,014,6,2,8
Bahrain,2009,ep,1524,14,11,25
Bahrain,2009,ep,2534,18,27,45
Bahrain,2009,ep,3544,6,18,24
Bahrain,2009,ep,4554,3,7,10
Bahrain,2009,ep,5564,3,4,7
Bahrain,2009,ep,65,1,1,2
Bahrain,2009,sn,014,1,0,1
Bahrain,2009,sn,1524,14,7,21
Bahrain,2009,sn,2534,6,22,28
Bahrain,2009,sn,3544,4,9,13
Bahrain,2009,sn,4554,0,6,6
Bahrain,2009,sn,5564,1,0,1
Bahrain,2009,sn,65,1,3,4
Bahrain,2009,sp,014,0,0,0
Bahrain,2009,sp,1524,14,13,27
Bahrain,2009,sp,2534,18,37,55
Bahrain,2009,sp,3544,3,21,24
Bahrain,2009,sp,4554,2,13,15
Bahrain,2009,sp,5564,0,7,7
Bahrain,2009,sp,65,2,1,3
Bahrain,2010,ep,014,1,2,3
Bahrain,2010,ep,1524,3,4,7
Bahrain,2010,ep,2534,21,27,48
Bahrain,2010,ep,3544,8,15,23
Bahrain,2010,ep,4554,3,6,9
Bahrain,2010,ep,5564,1,4,5
Bahrain,2010,ep,65,1,2,3
Bahrain,2010,sn,014,0,2,2
Bahrain,2010,sn,1524,6,2,8
Bahrain,2010,sn,2534,4,12,16
Bahrain,2010,sn,3544,1,12,13
Bahrain,2010,sn,4554,0,11,11
Bahrain,2010,sn,5564,0,3,3
Bahrain,2010,sn,65,1,4,5
Bahrain,2010,sp,014,0,0,0
Bahrain,2010,sp,1524,8,10,18
Bahrain,2010,sp,2534,15,16,31
Bahrain,2010,sp,3544,7,11,18
Bahrain,2010,sp,4554,1,12,13
Bahrain,2010,sp,5564,1,4,5
Bahrain,2010,sp,65,1,4,5
Bahrain,2011,ep,014,6,5,11
Bahrain,2011,ep,1524,5,6,11
Bahrain,2011,ep,2534,11,24,35
Bahrain,2011,ep,3544,6,10,16
Bahrain,2011,ep,4554,4,3,7
Bahrain,2011,ep,5564,2,2,4
Bahrain,2011,ep,65,2,3,5
Bahrain,2011,sn,014,0,3,3
Bahrain,2011,sn,1524,4,3,7
Bahrain,2011,sn,2534,4,5,9
Bahrain,2011,sn,3544,3,5,8
Bahrain,2011,sn,4554,4,3,7
Bahrain,2011,sn,5564,0,5,5
Bahrain,2011,sn,65,2,6,8
Bahrain,2011,sp,014,0,1,1
Bahrain,2011,sp,1524,9,5,14
Bahrain,2011,sp,2534,5,19,24
Bahrain,2011,sp,3544,6,13,19
Bahrain,2011,sp,4554,6,14,20
Bahrain,2011,sp,5564,0,8,8
Bahrain,2011,sp,65,1,2,3
Bahrain,2012,ep,014,2,0,2
Bahrain,2012,ep,1524,3,7,10
Bahrain,2012,ep,2534,14,21,35
Bahrain,2012,ep,3544,6,9,15
Bahrain,2012,ep,4554,2,4,6
Bahrain,2012,ep,5564,4,4,8
Bahrain,2012,ep,65,0,1,1
Bahrain,2012,sn,014,0,0,0
Bahrain,2012,sn,1524,2,4,6
Bahrain,2012,sn,2534,11,5,16
Bahrain,2012,sn,3544,6,5,11
Bahrain,2012,sn,4554,1,4,5
Bahrain,2012,sn,5564,0,1,1
Bahrain,2012,sn,65,2,6,8
Bahrain,2012,sp,014,1,0,1
Bahrain,2012,sp,1524,2,9,11
Bahrain,2012,sp,2534,11,28,39
Bahrain,2012,sp,3544,8,16,24
Bahrain,2012,sp,4554,4,11,15
Bahrain,2012,sp,5564,1,8,9
Bahrain,2012,sp,65,0,2,2
Bahrain,2013,rel,014,1,4,5
Bahrain,2013,rel,1524,8,13,21
Bahrain,2013,rel,2534,33,25,58
Bahrain,2013,rel,3544,19,60,79
Bahrain,2013,rel,4554,5,20,25
Bahrain,2013,rel,5564,4,10,14
Bahrain,2013,rel,65,3,4,7
Bangladesh,1995,sp,014,64,29,93
Bangladesh,1995,sp,1524,309,505,814
Bangladesh,1995,sp,2534,546,983,1529
Bangladesh,1995,sp,3544,360,1001,1361
Bangladesh,1995,sp,4554,236,748,984
Bangladesh,1995,sp,5564,132,648,780
Bangladesh,1995,sp,65,38,424,462
Bangladesh,1996,sp,014,89,45,134
Bangladesh,1996,sp,1524,434,723,1157
Bangladesh,1996,sp,2534,663,1322,1985
Bangladesh,1996,sp,3544,434,1264,1698
Bangladesh,1996,sp,4554,268,908,1176
Bangladesh,1996,sp,5564,151,737,888
Bangladesh,1996,sp,65,41,472,513
Bangladesh,1997,sp,014,328,201,529
Bangladesh,1997,sp,1524,1883,2639,4522
Bangladesh,1997,sp,2534,2634,5013,7647
Bangladesh,1997,sp,3544,1748,5226,6974
Bangladesh,1997,sp,4554,1029,3926,4955
Bangladesh,1997,sp,5564,527,2901,3428
Bangladesh,1997,sp,65,236,2003,2239
Bangladesh,1998,sp,014,438,254,692
Bangladesh,1998,sp,1524,2663,3516,6179
Bangladesh,1998,sp,2534,3319,5988,9307
Bangladesh,1998,sp,3544,2156,6242,8398
Bangladesh,1998,sp,4554,1212,4771,5983
Bangladesh,1998,sp,5564,649,3522,4171
Bangladesh,1998,sp,65,324,2569,2893
Bangladesh,1999,sp,014,405,259,664
Bangladesh,1999,sp,1524,2753,3504,6257
Bangladesh,1999,sp,2534,3276,5777,9053
Bangladesh,1999,sp,3544,2180,6143,8323
Bangladesh,1999,sp,4554,1315,4748,6063
Bangladesh,1999,sp,5564,712,3568,4280
Bangladesh,1999,sp,65,333,2701,3034
Bangladesh,2000,sp,014,495,256,751
Bangladesh,2000,sp,1524,3029,3640,6669
Bangladesh,2000,sp,2534,3238,5643,8881
Bangladesh,2000,sp,3544,2247,5750,7997
Bangladesh,2000,sp,4554,1315,4718,6033
Bangladesh,2000,sp,5564,778,3667,4445
Bangladesh,2000,sp,65,370,2837,3207
Bangladesh,2001,sp,014,428,283,711
Bangladesh,2001,sp,1524,3392,3976,7368
Bangladesh,2001,sp,2534,3538,5834,9372
Bangladesh,2001,sp,3544,2260,6257,8517
Bangladesh,2001,sp,4554,1492,5172,6664
Bangladesh,2001,sp,5564,763,3682,4445
Bangladesh,2001,sp,65,371,3039,3410
Bangladesh,2002,sp,014,575,449,1024
Bangladesh,2002,sp,1524,3104,4490,7594
Bangladesh,2002,sp,2534,3926,6288,10214
Bangladesh,2002,sp,3544,2791,7038,9829
Bangladesh,2002,sp,4554,2101,5981,8082
Bangladesh,2002,sp,5564,988,4493,5481
Bangladesh,2002,sp,65,865,3682,4547
Bangladesh,2003,sp,014,544,320,864
Bangladesh,2003,sp,1524,4298,5166,9464
Bangladesh,2003,sp,2534,4282,7275,11557
Bangladesh,2003,sp,3544,3258,8058,11316
Bangladesh,2003,sp,4554,2086,6947,9033
Bangladesh,2003,sp,5564,1150,5501,6651
Bangladesh,2003,sp,65,591,4142,4733
Bangladesh,2004,sp,014,589,420,1009
Bangladesh,2004,sp,1524,5081,6171,11252
Bangladesh,2004,sp,2534,4869,8281,13150
Bangladesh,2004,sp,3544,3758,8914,12672
Bangladesh,2004,sp,4554,2518,8327,10845
Bangladesh,2004,sp,5564,1434,6276,7710
Bangladesh,2004,sp,65,718,5144,5862
Bangladesh,2005,sp,014,751,524,1275
Bangladesh,2005,sp,1524,6776,8170,14946
Bangladesh,2005,sp,2534,6785,10443,17228
Bangladesh,2005,sp,3544,5538,11423,16961
Bangladesh,2005,sp,4554,3960,11038,14998
Bangladesh,2005,sp,5564,2281,8476,10757
Bangladesh,2005,sp,65,1230,7453,8683
Bangladesh,2006,sn,014,1366,1356,2722
Bangladesh,2006,sn,1524,4433,3933,8366
Bangladesh,2006,sn,2534,3774,4224,7998
Bangladesh,2006,sn,3544,2650,3842,6492
Bangladesh,2006,sn,4554,1918,3614,5532
Bangladesh,2006,sn,5564,1138,2962,4100
Bangladesh,2006,sn,65,709,3062,3771
Bangladesh,2006,sp,014,850,607,1457
Bangladesh,2006,sp,1524,8164,9937,18101
Bangladesh,2006,sp,2534,8048,12166,20214
Bangladesh,2006,sp,3544,6395,12889,19284
Bangladesh,2006,sp,4554,5020,13378,18398
Bangladesh,2006,sp,5564,2982,10283,13265
Bangladesh,2006,sp,65,1735,9513,11248
Bangladesh,2007,sp,014,829,523,1352
Bangladesh,2007,sp,1524,8562,10210,18772
Bangladesh,2007,sp,2534,8164,12442,20606
Bangladesh,2007,sp,3544,6678,13003,19681
Bangladesh,2007,sp,4554,5220,13307,18527
Bangladesh,2007,sp,5564,3057,10653,13710
Bangladesh,2007,sp,65,1818,9830,11648
Bangladesh,2008,ep,014,1457,1421,2878
Bangladesh,2008,ep,1524,4967,4272,9239
Bangladesh,2008,ep,2534,3931,4554,8485
Bangladesh,2008,ep,3544,2666,3695,6361
Bangladesh,2008,ep,4554,1987,3595,5582
Bangladesh,2008,ep,5564,1186,2995,4181
Bangladesh,2008,ep,65,760,3061,3821
Bangladesh,2008,sn,014,1458,1420,2878
Bangladesh,2008,sn,1524,4966,4274,9240
Bangladesh,2008,sn,2534,3930,4554,8484
Bangladesh,2008,sn,3544,2669,3693,6362
Bangladesh,2008,sn,4554,1989,3594,5583
Bangladesh,2008,sn,5564,1187,2995,4182
Bangladesh,2008,sn,65,759,3063,3822
Bangladesh,2008,sp,014,764,422,1186
Bangladesh,2008,sp,1524,9189,10618,19807
Bangladesh,2008,sp,2534,8389,12926,21315
Bangladesh,2008,sp,3544,6465,12761,19226
Bangladesh,2008,sp,4554,5206,13355,18561
Bangladesh,2008,sp,5564,3173,10772,13945
Bangladesh,2008,sp,65,1947,10386,12333
Bangladesh,2009,sn,014,1719,1747,3466
Bangladesh,2010,ep,014,1097,1078,2175
Bangladesh,2010,ep,1524,3546,2427,5973
Bangladesh,2010,ep,2534,3183,2854,6037
Bangladesh,2010,ep,3544,1795,1696,3491
Bangladesh,2010,ep,4554,1313,1386,2699
Bangladesh,2010,ep,5564,702,1026,1728
Bangladesh,2010,ep,65,421,983,1404
Bangladesh,2010,sn,014,494,548,1042
Bangladesh,2010,sn,1524,1982,1942,3924
Bangladesh,2010,sn,2534,1524,2301,3825
Bangladesh,2010,sn,3544,1110,1917,3027
Bangladesh,2010,sn,4554,1021,2364,3385
Bangladesh,2010,sn,5564,775,2329,3104
Bangladesh,2010,sn,65,559,2714,3273
Bangladesh,2010,sp,014,653,365,1018
Bangladesh,2010,sp,1524,9221,10460,19681
Bangladesh,2010,sp,2534,8279,12535,20814
Bangladesh,2010,sp,3544,6185,11409,17594
Bangladesh,2010,sp,4554,5458,12758,18216
Bangladesh,2010,sp,5564,3484,11176,14660
Bangladesh,2010,sp,65,2250,11536,13786
Bangladesh,2011,ep,014,1283,1300,2583
Bangladesh,2011,ep,1524,3963,2882,6845
Bangladesh,2011,ep,2534,3674,3198,6872
Bangladesh,2011,ep,3544,2139,2027,4166
Bangladesh,2011,ep,4554,1513,1632,3145
Bangladesh,2011,ep,5564,849,1249,2098
Bangladesh,2011,ep,65,495,1125,1620
Bangladesh,2011,sn,014,548,604,1152
Bangladesh,2011,sn,1524,2036,1997,4033
Bangladesh,2011,sn,2534,1549,2395,3944
Bangladesh,2011,sn,3544,1159,1935,3094
Bangladesh,2011,sn,4554,995,2312,3307
Bangladesh,2011,sn,5564,776,2335,3111
Bangladesh,2011,sn,65,574,2706,3280
Bangladesh,2011,sp,014,623,309,932
Bangladesh,2011,sp,1524,8849,9606,18455
Bangladesh,2011,sp,2534,7679,11616,19295
Bangladesh,2011,sp,3544,5683,10152,15835
Bangladesh,2011,sp,4554,4946,11728,16674
Bangladesh,2011,sp,5564,3457,10746,14203
Bangladesh,2011,sp,65,2253,11301,13554
Bangladesh,2012,ep,014,1367,1400,2767
Bangladesh,2012,ep,1524,4545,3108,7653
Bangladesh,2012,ep,2534,4251,3494,7745
Bangladesh,2012,ep,3544,2469,2169,4638
Bangladesh,2012,ep,4554,1786,1831,3617
Bangladesh,2012,ep,5564,969,1378,2347
Bangladesh,2012,ep,65,588,1194,1782
Bangladesh,2012,sn,014,575,534,1109
Bangladesh,2012,sn,1524,2160,2109,4269
Bangladesh,2012,sn,2534,1695,2527,4222
Bangladesh,2012,sn,3544,1266,2154,3420
Bangladesh,2012,sn,4554,1212,2637,3849
Bangladesh,2012,sn,5564,948,2755,3703
Bangladesh,2012,sn,65,721,3158,3879
Bangladesh,2012,sp,014,650,316,966
Bangladesh,2012,sp,1524,9355,9479,18834
Bangladesh,2012,sp,2534,8175,12021,20196
Bangladesh,2012,sp,3544,6342,10837,17179
Bangladesh,2012,sp,4554,6044,12744,18788
Bangladesh,2012,sp,5564,4043,11843,15886
Bangladesh,2012,sp,65,2705,12236,14941
Bangladesh,2013,rel,014,2728,2323,5051
Bangladesh,2013,rel,1524,16356,14705,31061
Bangladesh,2013,rel,2534,15912,18311,34223
Bangladesh,2013,rel,3544,12386,16143,28529
Bangladesh,2013,rel,4554,11145,19529,30674
Bangladesh,2013,rel,5564,7675,19058,26733
Bangladesh,2013,rel,65,5172,20194,25366
Barbados,1996,sp,014,NA,0,NA
Barbados,1996,sp,1524,NA,0,NA
Barbados,1996,sp,2534,NA,1,NA
Barbados,1996,sp,3544,NA,0,NA
Barbados,1996,sp,4554,NA,1,NA
Barbados,1996,sp,5564,NA,1,NA
Barbados,1996,sp,65,NA,0,NA
Barbados,2000,sp,014,0,0,0
Barbados,2000,sp,1524,0,0,0
Barbados,2000,sp,2534,1,0,1
Barbados,2000,sp,3544,0,2,2
Barbados,2000,sp,4554,0,0,0
Barbados,2000,sp,5564,0,0,0
Barbados,2000,sp,65,0,0,0
Barbados,2001,sp,014,0,0,0
Barbados,2001,sp,1524,0,1,1
Barbados,2001,sp,2534,0,1,1
Barbados,2001,sp,3544,1,1,2
Barbados,2001,sp,4554,1,0,1
Barbados,2001,sp,5564,0,0,0
Barbados,2001,sp,65,0,1,1
Barbados,2002,sp,1524,NA,2,NA
Barbados,2002,sp,4554,1,1,2
Barbados,2002,sp,65,NA,1,NA
Barbados,2004,sp,014,1,NA,NA
Barbados,2004,sp,2534,2,2,4
Barbados,2004,sp,3544,1,2,3
Barbados,2004,sp,4554,1,6,7
Barbados,2004,sp,65,1,4,5
Barbados,2006,ep,1524,1,NA,NA
Barbados,2006,sp,1524,1,NA,NA
Barbados,2006,sp,2534,NA,2,NA
Barbados,2006,sp,65,1,NA,NA
Barbados,2007,ep,014,0,0,0
Barbados,2007,ep,1524,0,0,0
Barbados,2007,ep,2534,0,0,0
Barbados,2007,ep,3544,3,0,3
Barbados,2007,ep,4554,0,5,5
Barbados,2007,ep,5564,0,0,0
Barbados,2007,ep,65,0,0,0
Barbados,2007,sn,014,0,0,0
Barbados,2007,sn,1524,0,0,0
Barbados,2007,sn,2534,0,0,0
Barbados,2007,sn,3544,0,0,0
Barbados,2007,sn,4554,0,0,0
Barbados,2007,sn,5564,0,0,0
Barbados,2007,sn,65,0,0,0
Barbados,2007,sp,014,0,0,0
Barbados,2007,sp,1524,0,0,0
Barbados,2007,sp,2534,0,0,0
Barbados,2007,sp,3544,0,0,0
Barbados,2007,sp,4554,3,5,8
Barbados,2007,sp,5564,0,0,0
Barbados,2007,sp,65,0,0,0
Barbados,2008,ep,014,0,0,0
Barbados,2008,ep,1524,0,0,0
Barbados,2008,ep,2534,0,0,0
Barbados,2008,ep,3544,0,0,0
Barbados,2008,ep,4554,0,0,0
Barbados,2008,ep,5564,0,0,0
Barbados,2008,ep,65,0,0,0
Barbados,2008,sn,014,0,0,0
Barbados,2008,sn,1524,0,0,0
Barbados,2008,sn,2534,0,0,0
Barbados,2008,sn,3544,2,0,2
Barbados,2008,sn,4554,0,0,0
Barbados,2008,sn,5564,0,0,0
Barbados,2008,sn,65,0,0,0
Barbados,2008,sp,014,0,0,0
Barbados,2008,sp,1524,0,0,0
Barbados,2008,sp,2534,0,1,1
Barbados,2008,sp,3544,0,0,0
Barbados,2008,sp,4554,0,0,0
Barbados,2008,sp,5564,0,0,0
Barbados,2008,sp,65,0,0,0
Barbados,2009,ep,014,0,0,0
Barbados,2009,ep,1524,0,0,0
Barbados,2009,ep,2534,0,0,0
Barbados,2009,ep,3544,0,0,0
Barbados,2009,ep,4554,0,0,0
Barbados,2009,ep,5564,0,0,0
Barbados,2009,ep,65,0,0,0
Barbados,2009,sn,014,0,0,0
Barbados,2009,sn,1524,0,0,0
Barbados,2009,sn,2534,0,0,0
Barbados,2009,sn,3544,0,0,0
Barbados,2009,sn,4554,0,0,0
Barbados,2009,sn,5564,0,0,0
Barbados,2009,sn,65,0,0,0
Barbados,2009,sp,014,0,0,0
Barbados,2009,sp,1524,0,0,0
Barbados,2009,sp,2534,0,0,0
Barbados,2009,sp,3544,0,1,1
Barbados,2009,sp,4554,0,1,1
Barbados,2009,sp,5564,0,0,0
Barbados,2009,sp,65,0,0,0
Barbados,2010,ep,014,0,0,0
Barbados,2010,ep,1524,0,0,0
Barbados,2010,ep,2534,0,0,0
Barbados,2010,ep,3544,0,0,0
Barbados,2010,ep,4554,0,0,0
Barbados,2010,ep,5564,0,0,0
Barbados,2010,ep,65,0,0,0
Barbados,2010,sn,014,0,0,0
Barbados,2010,sn,1524,0,0,0
Barbados,2010,sn,2534,0,0,0
Barbados,2010,sn,3544,0,0,0
Barbados,2010,sn,4554,0,0,0
Barbados,2010,sn,5564,0,0,0
Barbados,2010,sn,65,0,0,0
Barbados,2010,sp,014,0,0,0
Barbados,2010,sp,1524,1,0,1
Barbados,2010,sp,2534,0,0,0
Barbados,2010,sp,3544,0,1,1
Barbados,2010,sp,4554,2,2,4
Barbados,2010,sp,5564,0,0,0
Barbados,2010,sp,65,0,0,0
Barbados,2011,ep,014,0,0,0
Barbados,2011,ep,1524,0,0,0
Barbados,2011,ep,2534,0,0,0
Barbados,2011,ep,3544,0,0,0
Barbados,2011,ep,4554,0,0,0
Barbados,2011,ep,5564,0,0,0
Barbados,2011,ep,65,0,0,0
Barbados,2011,sn,014,0,0,0
Barbados,2011,sn,1524,0,0,0
Barbados,2011,sn,2534,0,0,0
Barbados,2011,sn,3544,0,0,0
Barbados,2011,sn,4554,0,0,0
Barbados,2011,sn,5564,0,0,0
Barbados,2011,sn,65,0,0,0
Barbados,2011,sp,014,0,0,0
Barbados,2011,sp,1524,0,0,0
Barbados,2011,sp,2534,0,0,0
Barbados,2011,sp,3544,0,0,0
Barbados,2011,sp,4554,0,0,0
Barbados,2011,sp,5564,0,0,0
Barbados,2011,sp,65,0,0,0
Barbados,2012,ep,014,0,0,0
Barbados,2012,ep,1524,0,0,0
Barbados,2012,ep,2534,0,0,0
Barbados,2012,ep,3544,0,0,0
Barbados,2012,ep,4554,0,0,0
Barbados,2012,ep,5564,0,0,0
Barbados,2012,ep,65,0,0,0
Barbados,2012,sn,014,0,0,0
Barbados,2012,sn,1524,0,0,0
Barbados,2012,sn,2534,0,0,0
Barbados,2012,sn,3544,0,0,0
Barbados,2012,sn,4554,0,0,0
Barbados,2012,sn,5564,0,0,0
Barbados,2012,sn,65,0,0,0
Barbados,2012,sp,014,0,0,0
Barbados,2012,sp,1524,0,0,0
Barbados,2012,sp,2534,0,0,0
Barbados,2012,sp,3544,0,0,0
Barbados,2012,sp,4554,0,0,0
Barbados,2012,sp,5564,0,0,0
Barbados,2012,sp,65,0,0,0
Barbados,2013,rel,014,0,0,0
Barbados,2013,rel,1524,0,0,0
Barbados,2013,rel,2534,0,1,1
Barbados,2013,rel,3544,0,1,1
Barbados,2013,rel,4554,1,1,2
Barbados,2013,rel,5564,0,0,0
Barbados,2013,rel,65,0,0,0
Belarus,2001,sp,014,4,2,6
Belarus,2002,sp,014,0,0,0
Belarus,2002,sp,1524,12,66,78
Belarus,2002,sp,2534,22,133,155
Belarus,2002,sp,3544,28,217,245
Belarus,2002,sp,4554,17,159,176
Belarus,2002,sp,5564,17,75,92
Belarus,2002,sp,65,41,51,92
Belarus,2003,sp,014,0,0,0
Belarus,2003,sp,1524,18,67,85
Belarus,2003,sp,2534,39,134,173
Belarus,2003,sp,3544,43,243,286
Belarus,2003,sp,4554,26,226,252
Belarus,2003,sp,5564,21,96,117
Belarus,2003,sp,65,45,60,105
Belarus,2004,sp,014,1,NA,NA
Belarus,2004,sp,1524,31,84,115
Belarus,2004,sp,2534,38,170,208
Belarus,2004,sp,3544,38,260,298
Belarus,2004,sp,4554,35,235,270
Belarus,2004,sp,5564,11,83,94
Belarus,2004,sp,65,67,56,123
Belarus,2005,sp,1524,25,71,96
Belarus,2005,sp,2534,53,180,233
Belarus,2005,sp,3544,50,273,323
Belarus,2005,sp,4554,43,287,330
Belarus,2005,sp,5564,11,118,129
Belarus,2005,sp,65,62,62,124
Belarus,2006,ep,014,12,18,30
Belarus,2006,ep,1524,18,15,33
Belarus,2006,ep,2534,32,14,46
Belarus,2006,ep,3544,30,26,56
Belarus,2006,ep,4554,34,33,67
Belarus,2006,ep,5564,28,28,56
Belarus,2006,ep,65,54,19,73
Belarus,2006,sn,014,15,15,30
Belarus,2006,sn,1524,213,237,450
Belarus,2006,sn,2534,238,560,798
Belarus,2006,sn,3544,190,642,832
Belarus,2006,sn,4554,176,695,871
Belarus,2006,sn,5564,75,328,403
Belarus,2006,sn,65,135,190,325
Belarus,2006,sp,014,1,NA,NA
Belarus,2006,sp,1524,32,61,93
Belarus,2006,sp,2534,38,134,172
Belarus,2006,sp,3544,43,217,260
Belarus,2006,sp,4554,43,260,303
Belarus,2006,sp,5564,18,96,114
Belarus,2006,sp,65,58,71,129
Belarus,2007,ep,014,6,5,11
Belarus,2007,ep,1524,11,17,28
Belarus,2007,ep,2534,35,14,49
Belarus,2007,ep,3544,20,19,39
Belarus,2007,ep,4554,35,31,66
Belarus,2007,ep,5564,36,30,66
Belarus,2007,ep,65,54,22,76
Belarus,2007,sn,014,9,11,20
Belarus,2007,sn,1524,180,241,421
Belarus,2007,sn,2534,256,518,774
Belarus,2007,sn,3544,210,544,754
Belarus,2007,sn,4554,140,640,780
Belarus,2007,sn,5564,75,307,382
Belarus,2007,sn,65,162,193,355
Belarus,2007,sp,1524,28,57,85
Belarus,2007,sp,2534,58,142,200
Belarus,2007,sp,3544,41,205,246
Belarus,2007,sp,4554,35,244,279
Belarus,2007,sp,5564,17,110,127
Belarus,2007,sp,65,58,56,114
Belarus,2008,ep,014,15,14,29
Belarus,2008,ep,1524,27,26,53
Belarus,2008,ep,2534,66,35,101
Belarus,2008,ep,3544,29,41,70
Belarus,2008,ep,4554,40,39,79
Belarus,2008,ep,5564,29,49,78
Belarus,2008,ep,65,43,47,90
Belarus,2008,sn,014,6,3,9
Belarus,2008,sn,1524,148,194,342
Belarus,2008,sn,2534,214,460,674
Belarus,2008,sn,3544,172,474,646
Belarus,2008,sn,4554,148,637,785
Belarus,2008,sn,5564,58,274,332
Belarus,2008,sn,65,132,154,286
Belarus,2008,sp,1524,26,44,70
Belarus,2008,sp,2534,43,149,192
Belarus,2008,sp,3544,36,207,243
Belarus,2008,sp,4554,34,261,295
Belarus,2008,sp,5564,20,106,126
Belarus,2008,sp,65,65,69,134
Belarus,2009,ep,014,5,6,11
Belarus,2009,ep,1524,15,20,35
Belarus,2009,ep,2534,46,33,79
Belarus,2009,ep,3544,29,36,65
Belarus,2009,ep,4554,39,47,86
Belarus,2009,ep,5564,31,39,70
Belarus,2009,ep,65,55,29,84
Belarus,2009,sp,014,0,0,0
Belarus,2009,sp,1524,41,66,107
Belarus,2009,sp,2534,52,173,225
Belarus,2009,sp,3544,52,208,260
Belarus,2009,sp,4554,41,287,328
Belarus,2009,sp,5564,25,134,159
Belarus,2009,sp,65,68,54,122
Belarus,2010,ep,014,8,7,15
Belarus,2010,ep,1524,11,15,26
Belarus,2010,ep,2534,35,28,63
Belarus,2010,ep,3544,36,43,79
Belarus,2010,ep,4554,34,49,83
Belarus,2010,ep,5564,44,38,82
Belarus,2010,ep,65,58,23,81
Belarus,2010,sn,014,10,5,15
Belarus,2010,sn,1524,128,153,281
Belarus,2010,sn,2534,217,432,649
Belarus,2010,sn,3544,159,410,569
Belarus,2010,sn,4554,112,501,613
Belarus,2010,sn,5564,54,261,315
Belarus,2010,sn,65,106,99,205
Belarus,2010,sp,014,1,0,1
Belarus,2010,sp,1524,28,65,93
Belarus,2010,sp,2534,52,173,225
Belarus,2010,sp,3544,56,224,280
Belarus,2010,sp,4554,37,293,330
Belarus,2010,sp,5564,28,163,191
Belarus,2010,sp,65,91,58,149
Belarus,2011,ep,014,6,8,14
Belarus,2011,ep,1524,5,7,12
Belarus,2011,ep,2534,34,28,62
Belarus,2011,ep,3544,31,45,76
Belarus,2011,ep,4554,20,52,72
Belarus,2011,ep,5564,40,39,79
Belarus,2011,ep,65,47,25,72
Belarus,2011,sn,014,6,2,8
Belarus,2011,sn,1524,107,164,271
Belarus,2011,sn,2534,182,374,556
Belarus,2011,sn,3544,152,411,563
Belarus,2011,sn,4554,97,458,555
Belarus,2011,sn,5564,51,255,306
Belarus,2011,sn,65,85,95,180
Belarus,2011,sp,014,3,1,4
Belarus,2011,sp,1524,37,53,90
Belarus,2011,sp,2534,67,156,223
Belarus,2011,sp,3544,47,228,275
Belarus,2011,sp,4554,39,290,329
Belarus,2011,sp,5564,27,138,165
Belarus,2011,sp,65,83,48,131
Belarus,2012,ep,014,8,4,12
Belarus,2012,ep,1524,11,14,25
Belarus,2012,ep,2534,33,23,56
Belarus,2012,ep,3544,19,42,61
Belarus,2012,ep,4554,29,60,89
Belarus,2012,ep,5564,34,32,66
Belarus,2012,ep,65,46,26,72
Belarus,2012,sn,014,7,1,8
Belarus,2012,sn,1524,90,98,188
Belarus,2012,sn,2534,168,350,518
Belarus,2012,sn,3544,131,372,503
Belarus,2012,sn,4554,102,413,515
Belarus,2012,sn,5564,75,216,291
Belarus,2012,sn,65,87,74,161
Belarus,2012,sp,014,1,0,1
Belarus,2012,sp,1524,34,44,78
Belarus,2012,sp,2534,64,174,238
Belarus,2012,sp,3544,47,250,297
Belarus,2012,sp,4554,45,266,311
Belarus,2012,sp,5564,28,158,186
Belarus,2012,sp,65,93,73,166
Belarus,2013,rel,014,10,4,14
Belarus,2013,rel,1524,131,162,293
Belarus,2013,rel,2534,280,565,845
Belarus,2013,rel,3544,248,803,1051
Belarus,2013,rel,4554,168,876,1044
Belarus,2013,rel,5564,141,600,741
Belarus,2013,rel,65,256,226,482
Belgium,1995,sp,014,3,3,6
Belgium,1995,sp,1524,12,23,35
Belgium,1995,sp,2534,24,49,73
Belgium,1995,sp,3544,32,63,95
Belgium,1995,sp,4554,17,52,69
Belgium,1995,sp,5564,10,54,64
Belgium,1995,sp,65,34,102,136
Belgium,1996,sp,014,4,1,5
Belgium,1996,sp,1524,9,20,29
Belgium,1996,sp,2534,30,43,73
Belgium,1996,sp,3544,25,49,74
Belgium,1996,sp,4554,11,45,56
Belgium,1996,sp,5564,10,32,42
Belgium,1996,sp,65,26,59,85
Belgium,1997,sp,014,2,3,5
Belgium,1997,sp,1524,11,18,29
Belgium,1997,sp,2534,26,45,71
Belgium,1997,sp,3544,22,56,78
Belgium,1997,sp,4554,13,43,56
Belgium,1997,sp,5564,11,41,52
Belgium,1997,sp,65,28,115,143
Belgium,1998,sp,014,2,3,5
Belgium,1998,sp,1524,6,22,28
Belgium,1998,sp,2534,30,50,80
Belgium,1998,sp,3544,20,58,78
Belgium,1998,sp,4554,17,48,65
Belgium,1998,sp,5564,13,36,49
Belgium,1998,sp,65,35,78,113
Belgium,1999,sp,014,4,2,6
Belgium,1999,sp,1524,20,18,38
Belgium,1999,sp,2534,38,40,78
Belgium,1999,sp,3544,19,49,68
Belgium,1999,sp,4554,22,46,68
Belgium,1999,sp,5564,8,38,46
Belgium,1999,sp,65,16,83,99
Belgium,2000,sp,014,6,3,9
Belgium,2000,sp,1524,15,20,35
Belgium,2000,sp,2534,15,57,72
Belgium,2000,sp,3544,19,39,58
Belgium,2000,sp,4554,4,55,59
Belgium,2000,sp,5564,13,32,45
Belgium,2000,sp,65,27,56,83
Belgium,2001,sp,014,6,8,14
Belgium,2001,sp,1524,14,31,45
Belgium,2001,sp,2534,21,40,61
Belgium,2001,sp,3544,24,47,71
Belgium,2001,sp,4554,15,44,59
Belgium,2001,sp,5564,7,23,30
Belgium,2001,sp,65,18,54,72
Belgium,2002,sp,014,6,1,7
Belgium,2002,sp,1524,21,19,40
Belgium,2002,sp,2534,19,56,75
Belgium,2002,sp,3544,16,52,68
Belgium,2002,sp,4554,9,33,42
Belgium,2002,sp,5564,16,19,35
Belgium,2002,sp,65,16,58,74
Belgium,2003,sp,014,5,6,11
Belgium,2003,sp,1524,20,27,47
Belgium,2003,sp,2534,17,33,50
Belgium,2003,sp,3544,15,30,45
Belgium,2003,sp,4554,11,40,51
Belgium,2003,sp,5564,2,17,19
Belgium,2003,sp,65,7,35,42
Belgium,2004,sp,014,6,1,7
Belgium,2004,sp,1524,18,26,44
Belgium,2004,sp,2534,16,55,71
Belgium,2004,sp,3544,20,30,50
Belgium,2004,sp,4554,3,37,40
Belgium,2004,sp,5564,8,24,32
Belgium,2004,sp,65,14,48,62
Belgium,2005,sp,014,2,1,3
Belgium,2005,sp,1524,27,26,53
Belgium,2005,sp,2534,31,50,81
Belgium,2005,sp,3544,15,32,47
Belgium,2005,sp,4554,12,27,39
Belgium,2005,sp,5564,4,15,19
Belgium,2005,sp,65,23,47,70
Belgium,2006,ep,014,9,8,17
Belgium,2006,ep,1524,24,22,46
Belgium,2006,ep,2534,37,43,80
Belgium,2006,ep,3544,19,38,57
Belgium,2006,ep,4554,23,25,48
Belgium,2006,ep,5564,7,23,30
Belgium,2006,ep,65,21,31,52
Belgium,2006,sn,014,16,20,36
Belgium,2006,sn,1524,33,25,58
Belgium,2006,sn,2534,29,43,72
Belgium,2006,sn,3544,18,33,51
Belgium,2006,sn,4554,20,29,49
Belgium,2006,sn,5564,12,31,43
Belgium,2006,sn,65,13,48,61
Belgium,2006,sp,014,6,4,10
Belgium,2006,sp,1524,25,26,51
Belgium,2006,sp,2534,25,52,77
Belgium,2006,sp,3544,18,38,56
Belgium,2006,sp,4554,6,45,51
Belgium,2006,sp,5564,7,27,34
Belgium,2006,sp,65,22,42,64
Belgium,2007,ep,014,11,7,18
Belgium,2007,ep,1524,19,17,36
Belgium,2007,ep,2534,25,44,69
Belgium,2007,ep,3544,28,20,48
Belgium,2007,ep,4554,19,11,30
Belgium,2007,ep,5564,9,17,26
Belgium,2007,ep,65,17,22,39
Belgium,2007,sn,014,17,25,42
Belgium,2007,sn,1524,17,26,43
Belgium,2007,sn,2534,27,47,74
Belgium,2007,sn,3544,24,45,69
Belgium,2007,sn,4554,11,30,41
Belgium,2007,sn,5564,10,18,28
Belgium,2007,sn,65,17,53,70
Belgium,2007,sp,014,4,2,6
Belgium,2007,sp,1524,13,23,36
Belgium,2007,sp,2534,31,55,86
Belgium,2007,sp,3544,23,35,58
Belgium,2007,sp,4554,7,38,45
Belgium,2007,sp,5564,8,18,26
Belgium,2007,sp,65,22,43,65
Belgium,2008,ep,014,7,6,13
Belgium,2008,ep,1524,11,20,31
Belgium,2008,ep,2534,20,27,47
Belgium,2008,ep,3544,15,37,52
Belgium,2008,ep,4554,10,18,28
Belgium,2008,ep,5564,7,6,13
Belgium,2008,ep,65,12,17,29
Belgium,2008,sn,014,14,18,32
Belgium,2008,sn,1524,11,15,26
Belgium,2008,sn,2534,24,31,55
Belgium,2008,sn,3544,18,29,47
Belgium,2008,sn,4554,12,20,32
Belgium,2008,sn,5564,10,25,35
Belgium,2008,sn,65,17,43,60
Belgium,2008,sp,014,3,3,6
Belgium,2008,sp,1524,17,23,40
Belgium,2008,sp,2534,40,40,80
Belgium,2008,sp,3544,22,43,65
Belgium,2008,sp,4554,8,32,40
Belgium,2008,sp,5564,3,24,27
Belgium,2008,sp,65,12,41,53
Belgium,2009,ep,014,11,5,16
Belgium,2009,ep,1524,20,12,32
Belgium,2009,ep,2534,29,29,58
Belgium,2009,ep,3544,18,17,35
Belgium,2009,ep,4554,11,15,26
Belgium,2009,ep,5564,9,12,21
Belgium,2009,ep,65,19,21,40
Belgium,2009,sn,014,20,22,42
Belgium,2009,sn,1524,17,16,33
Belgium,2009,sn,2534,22,32,54
Belgium,2009,sn,3544,15,17,32
Belgium,2009,sn,4554,11,31,42
Belgium,2009,sn,5564,8,15,23
Belgium,2009,sn,65,19,34,53
Belgium,2009,sp,014,0,1,1
Belgium,2009,sp,1524,21,29,50
Belgium,2009,sp,2534,34,33,67
Belgium,2009,sp,3544,10,27,37
Belgium,2009,sp,4554,7,32,39
Belgium,2009,sp,5564,7,24,31
Belgium,2009,sp,65,19,36,55
Belgium,2010,ep,014,5,8,13
Belgium,2010,ep,1524,14,16,30
Belgium,2010,ep,2534,32,37,69
Belgium,2010,ep,3544,14,22,36
Belgium,2010,ep,4554,11,19,30
Belgium,2010,ep,5564,8,8,16
Belgium,2010,ep,65,12,20,32
Belgium,2010,sn,014,15,23,38
Belgium,2010,sn,1524,14,16,30
Belgium,2010,sn,2534,25,49,74
Belgium,2010,sn,3544,14,37,51
Belgium,2010,sn,4554,16,28,44
Belgium,2010,sn,5564,6,19,25
Belgium,2010,sn,65,20,43,63
Belgium,2010,sp,014,6,4,10
Belgium,2010,sp,1524,13,20,33
Belgium,2010,sp,2534,17,39,56
Belgium,2010,sp,3544,18,30,48
Belgium,2010,sp,4554,11,28,39
Belgium,2010,sp,5564,5,20,25
Belgium,2010,sp,65,9,19,28
Belgium,2011,ep,014,6,11,17
Belgium,2011,ep,1524,21,20,41
Belgium,2011,ep,2534,22,30,52
Belgium,2011,ep,3544,6,16,22
Belgium,2011,ep,4554,6,5,11
Belgium,2011,ep,5564,5,3,8
Belgium,2011,ep,65,17,18,35
Belgium,2011,sn,014,19,17,36
Belgium,2011,sn,1524,18,21,39
Belgium,2011,sn,2534,25,31,56
Belgium,2011,sn,3544,9,20,29
Belgium,2011,sn,4554,11,19,30
Belgium,2011,sn,5564,12,7,19
Belgium,2011,sn,65,16,40,56
Belgium,2011,sp,014,3,8,11
Belgium,2011,sp,1524,13,25,38
Belgium,2011,sp,2534,14,50,64
Belgium,2011,sp,3544,9,33,42
Belgium,2011,sp,4554,3,25,28
Belgium,2011,sp,5564,5,16,21
Belgium,2011,sp,65,7,27,34
Belgium,2012,ep,014,9,7,16
Belgium,2012,ep,1524,7,22,29
Belgium,2012,ep,2534,18,26,44
Belgium,2012,ep,3544,17,14,31
Belgium,2012,ep,4554,8,14,22
Belgium,2012,ep,5564,4,9,13
Belgium,2012,ep,65,10,14,24
Belgium,2012,sn,014,15,18,33
Belgium,2012,sn,1524,14,23,37
Belgium,2012,sn,2534,10,23,33
Belgium,2012,sn,3544,13,24,37
Belgium,2012,sn,4554,10,19,29
Belgium,2012,sn,5564,8,18,26
Belgium,2012,sn,65,16,26,42
Belgium,2012,sp,014,5,3,8
Belgium,2012,sp,1524,23,25,48
Belgium,2012,sp,2534,23,33,56
Belgium,2012,sp,3544,17,18,35
Belgium,2012,sp,4554,9,27,36
Belgium,2012,sp,5564,7,22,29
Belgium,2012,sp,65,5,18,23
Belgium,2013,rel,014,19,40,59
Belgium,2013,rel,1524,58,63,121
Belgium,2013,rel,2534,96,135,231
Belgium,2013,rel,3544,50,105,155
Belgium,2013,rel,4554,31,86,117
Belgium,2013,rel,5564,23,57,80
Belgium,2013,rel,65,50,93,143
Belize,1995,sp,014,0,1,1
Belize,1995,sp,1524,6,1,7
Belize,1995,sp,2534,2,2,4
Belize,1995,sp,3544,0,4,4
Belize,1995,sp,4554,1,0,1
Belize,1995,sp,5564,1,1,2
Belize,1995,sp,65,2,1,3
Belize,1996,sp,014,0,1,1
Belize,1996,sp,1524,1,3,4
Belize,1996,sp,2534,4,2,6
Belize,1996,sp,3544,0,2,2
Belize,1996,sp,4554,0,2,2
Belize,1996,sp,5564,0,3,3
Belize,1996,sp,65,0,2,2
Belize,1997,sp,014,2,2,4
Belize,1997,sp,1524,3,2,5
Belize,1997,sp,2534,2,6,8
Belize,1997,sp,3544,2,3,5
Belize,1997,sp,4554,0,10,10
Belize,1997,sp,5564,4,3,7
Belize,1997,sp,65,3,6,9
Belize,2000,sp,014,0,2,2
Belize,2000,sp,1524,2,5,7
Belize,2000,sp,2534,1,7,8
Belize,2000,sp,3544,2,2,4
Belize,2000,sp,4554,4,6,10
Belize,2000,sp,5564,1,3,4
Belize,2000,sp,65,4,5,9
Belize,2001,sp,014,0,0,0
Belize,2001,sp,1524,0,0,0
Belize,2001,sp,2534,3,5,8
Belize,2001,sp,3544,4,9,13
Belize,2001,sp,4554,1,7,8
Belize,2001,sp,5564,2,9,11
Belize,2001,sp,65,2,11,13
Belize,2002,sp,014,3,4,7
Belize,2002,sp,1524,5,7,12
Belize,2002,sp,2534,6,5,11
Belize,2002,sp,3544,3,7,10
Belize,2002,sp,4554,4,11,15
Belize,2002,sp,5564,4,4,8
Belize,2002,sp,65,4,4,8
Belize,2003,sp,014,2,1,3
Belize,2003,sp,1524,6,4,10
Belize,2003,sp,2534,3,8,11
Belize,2003,sp,3544,3,10,13
Belize,2003,sp,4554,2,3,5
Belize,2003,sp,5564,5,2,7
Belize,2003,sp,65,5,8,13
Belize,2004,sp,014,1,0,1
Belize,2004,sp,1524,0,4,4
Belize,2004,sp,2534,1,6,7
Belize,2004,sp,3544,1,8,9
Belize,2004,sp,4554,2,6,8
Belize,2004,sp,5564,0,3,3
Belize,2004,sp,65,0,2,2
Belize,2005,sp,014,0,0,0
Belize,2005,sp,1524,4,8,12
Belize,2005,sp,2534,4,8,12
Belize,2005,sp,3544,4,6,10
Belize,2005,sp,4554,3,8,11
Belize,2005,sp,5564,2,5,7
Belize,2005,sp,65,4,3,7
Belize,2006,ep,014,0,0,0
Belize,2006,ep,1524,0,0,0
Belize,2006,ep,2534,0,0,0
Belize,2006,ep,3544,0,0,0
Belize,2006,ep,4554,0,0,0
Belize,2006,ep,5564,0,0,0
Belize,2006,ep,65,0,0,0
Belize,2006,sn,014,0,0,0
Belize,2006,sn,1524,0,0,0
Belize,2006,sn,2534,2,0,2
Belize,2006,sn,3544,1,4,5
Belize,2006,sn,4554,5,1,6
Belize,2006,sn,5564,2,0,2
Belize,2006,sn,65,1,2,3
Belize,2006,sp,014,2,3,5
Belize,2006,sp,1524,6,4,10
Belize,2006,sp,2534,5,4,9
Belize,2006,sp,3544,3,7,10
Belize,2006,sp,4554,5,5,10
Belize,2006,sp,5564,6,1,7
Belize,2006,sp,65,6,3,9
Belize,2007,ep,1524,NA,1,NA
Belize,2007,ep,2534,1,NA,NA
Belize,2007,sp,014,0,1,1
Belize,2007,sp,1524,8,6,14
Belize,2007,sp,2534,2,8,10
Belize,2007,sp,3544,5,8,13
Belize,2007,sp,4554,2,7,9
Belize,2007,sp,5564,2,6,8
Belize,2007,sp,65,3,3,6
Belize,2008,ep,014,0,0,0
Belize,2008,ep,1524,0,0,0
Belize,2008,ep,2534,0,1,1
Belize,2008,ep,3544,0,0,0
Belize,2008,ep,4554,1,2,3
Belize,2008,ep,5564,0,0,0
Belize,2008,ep,65,0,0,0
Belize,2008,sp,014,0,1,1
Belize,2008,sp,1524,5,8,13
Belize,2008,sp,2534,0,12,12
Belize,2008,sp,3544,6,15,21
Belize,2008,sp,4554,4,9,13
Belize,2008,sp,5564,3,5,8
Belize,2008,sp,65,8,8,16
Belize,2009,ep,014,0,0,0
Belize,2009,ep,1524,0,0,0
Belize,2009,ep,2534,0,0,0
Belize,2009,ep,3544,0,0,0
Belize,2009,ep,4554,0,0,0
Belize,2009,ep,5564,0,0,0
Belize,2009,ep,65,0,0,0
Belize,2009,sn,014,0,0,0
Belize,2009,sn,1524,0,0,0
Belize,2009,sn,2534,0,0,0
Belize,2009,sn,3544,0,0,0
Belize,2009,sn,4554,0,0,0
Belize,2009,sn,5564,0,0,0
Belize,2009,sn,65,0,0,0
Belize,2009,sp,014,3,2,5
Belize,2009,sp,1524,2,7,9
Belize,2009,sp,2534,7,9,16
Belize,2009,sp,3544,6,12,18
Belize,2009,sp,4554,3,10,13
Belize,2009,sp,5564,2,6,8
Belize,2009,sp,65,5,8,13
Belize,2010,sn,014,2,2,4
Belize,2010,sn,1524,2,2,4
Belize,2010,sn,2534,3,3,6
Belize,2010,sn,3544,5,6,11
Belize,2010,sn,4554,2,5,7
Belize,2010,sn,5564,4,3,7
Belize,2010,sn,65,2,6,8
Belize,2010,sp,014,4,2,6
Belize,2010,sp,1524,5,9,14
Belize,2010,sp,2534,7,16,23
Belize,2010,sp,3544,7,22,29
Belize,2010,sp,4554,9,24,33
Belize,2010,sp,5564,4,11,15
Belize,2010,sp,65,5,18,23
Belize,2011,ep,014,0,0,0
Belize,2011,ep,1524,0,0,0
Belize,2011,ep,2534,0,0,0
Belize,2011,ep,3544,0,0,0
Belize,2011,ep,4554,0,0,0
Belize,2011,ep,5564,0,0,0
Belize,2011,ep,65,0,0,0
Belize,2011,sn,014,0,0,0
Belize,2011,sn,1524,0,0,0
Belize,2011,sn,2534,0,0,0
Belize,2011,sn,3544,NA,0,NA
Belize,2011,sn,4554,0,0,0
Belize,2011,sn,5564,0,0,0
Belize,2011,sn,65,0,0,0
Belize,2011,sp,014,0,0,0
Belize,2011,sp,1524,2,8,10
Belize,2011,sp,2534,0,14,14
Belize,2011,sp,3544,8,9,17
Belize,2011,sp,4554,4,16,20
Belize,2011,sp,5564,1,2,3
Belize,2011,sp,65,0,0,0
Belize,2012,ep,014,0,0,0
Belize,2012,ep,1524,0,0,0
Belize,2012,ep,2534,1,0,1
Belize,2012,ep,3544,0,3,3
Belize,2012,ep,4554,1,0,1
Belize,2012,ep,5564,0,0,0
Belize,2012,ep,65,0,0,0
Belize,2012,sn,014,0,1,1
Belize,2012,sn,1524,0,1,1
Belize,2012,sn,2534,4,4,8
Belize,2012,sn,3544,4,5,9
Belize,2012,sn,4554,2,8,10
Belize,2012,sn,5564,1,3,4
Belize,2012,sn,65,2,9,11
Belize,2012,sp,014,0,1,1
Belize,2012,sp,1524,4,2,6
Belize,2012,sp,2534,3,7,10
Belize,2012,sp,3544,4,5,9
Belize,2012,sp,4554,4,4,8
Belize,2012,sp,5564,1,3,4
Belize,2012,sp,65,0,2,2
Belize,2013,rel,014,3,1,4
Belize,2013,rel,1524,9,8,17
Belize,2013,rel,2534,7,14,21
Belize,2013,rel,3544,6,13,19
Belize,2013,rel,4554,7,18,25
Belize,2013,rel,5564,6,9,15
Belize,2013,rel,65,8,12,20
Benin,1995,sp,014,26,14,40
Benin,1995,sp,1524,148,186,334
Benin,1995,sp,2534,197,352,549
Benin,1995,sp,3544,118,306,424
Benin,1995,sp,4554,69,176,245
Benin,1995,sp,5564,32,101,133
Benin,1995,sp,65,22,92,114
Benin,1996,sp,014,34,17,51
Benin,1996,sp,1524,169,215,384
Benin,1996,sp,2534,218,348,566
Benin,1996,sp,3544,136,277,413
Benin,1996,sp,4554,46,166,212
Benin,1996,sp,5564,42,102,144
Benin,1996,sp,65,21,77,98
Benin,1997,sp,014,26,20,46
Benin,1997,sp,1524,169,215,384
Benin,1997,sp,2534,226,376,602
Benin,1997,sp,3544,124,306,430
Benin,1997,sp,4554,64,180,244
Benin,1997,sp,5564,21,76,97
Benin,1997,sp,65,26,107,133
Benin,1998,sp,014,15,20,35
Benin,1998,sp,1524,189,233,422
Benin,1998,sp,2534,242,367,609
Benin,1998,sp,3544,159,251,410
Benin,1998,sp,4554,65,205,270
Benin,1998,sp,5564,39,113,152
Benin,1998,sp,65,19,71,90
Benin,1999,sp,014,28,14,42
Benin,1999,sp,1524,207,250,457
Benin,1999,sp,2534,254,444,698
Benin,1999,sp,3544,153,293,446
Benin,1999,sp,4554,74,207,281
Benin,1999,sp,5564,39,124,163
Benin,1999,sp,65,30,85,115
Benin,2000,sp,014,36,19,55
Benin,2000,sp,1524,239,277,516
Benin,2000,sp,2534,275,428,703
Benin,2000,sp,3544,149,327,476
Benin,2000,sp,4554,76,213,289
Benin,2000,sp,5564,45,103,148
Benin,2000,sp,65,25,74,99
Benin,2001,sp,014,22,18,40
Benin,2001,sp,1524,230,262,492
Benin,2001,sp,2534,279,429,708
Benin,2001,sp,3544,158,323,481
Benin,2001,sp,4554,94,229,323
Benin,2001,sp,5564,42,107,149
Benin,2001,sp,65,15,85,100
Benin,2002,sp,014,35,16,51
Benin,2002,sp,1524,255,248,503
Benin,2002,sp,2534,298,489,787
Benin,2002,sp,3544,159,304,463
Benin,2002,sp,4554,86,231,317
Benin,2002,sp,5564,47,125,172
Benin,2002,sp,65,24,94,118
Benin,2003,sp,014,32,20,52
Benin,2003,sp,1524,226,266,492
Benin,2003,sp,2534,304,504,808
Benin,2003,sp,3544,150,370,520
Benin,2003,sp,4554,93,188,281
Benin,2003,sp,5564,47,117,164
Benin,2003,sp,65,25,92,117
Benin,2004,sp,014,43,16,59
Benin,2004,sp,1524,263,308,571
Benin,2004,sp,2534,354,529,883
Benin,2004,sp,3544,147,344,491
Benin,2004,sp,4554,73,229,302
Benin,2004,sp,5564,45,125,170
Benin,2004,sp,65,24,82,106
Benin,2005,sp,014,25,21,46
Benin,2005,sp,1524,249,306,555
Benin,2005,sp,2534,331,595,926
Benin,2005,sp,3544,145,396,541
Benin,2005,sp,4554,89,270,359
Benin,2005,sp,5564,51,135,186
Benin,2005,sp,65,39,87,126
Benin,2006,sp,014,32,18,50
Benin,2006,sp,1524,310,298,608
Benin,2006,sp,2534,371,624,995
Benin,2006,sp,3544,158,465,623
Benin,2006,sp,4554,111,247,358
Benin,2006,sp,5564,38,124,162
Benin,2006,sp,65,41,106,147
Benin,2007,sp,014,25,22,47
Benin,2007,sp,1524,253,302,555
Benin,2007,sp,2534,331,580,911
Benin,2007,sp,3544,172,422,594
Benin,2007,sp,4554,81,254,335
Benin,2007,sp,5564,43,156,199
Benin,2007,sp,65,40,89,129
Benin,2008,sp,014,38,20,58
Benin,2008,sp,1524,245,333,578
Benin,2008,sp,2534,386,604,990
Benin,2008,sp,3544,173,439,612
Benin,2008,sp,4554,99,284,383
Benin,2008,sp,5564,52,163,215
Benin,2008,sp,65,30,100,130
Benin,2009,sp,014,39,32,71
Benin,2009,sp,1524,265,284,549
Benin,2009,sp,2534,392,575,967
Benin,2009,sp,3544,178,452,630
Benin,2009,sp,4554,85,323,408
Benin,2009,sp,5564,42,157,199
Benin,2009,sp,65,37,99,136
Benin,2010,sp,014,29,18,47
Benin,2010,sp,1524,265,314,579
Benin,2010,sp,2534,382,631,1013
Benin,2010,sp,3544,200,443,643
Benin,2010,sp,4554,98,267,365
Benin,2010,sp,5564,42,164,206
Benin,2010,sp,65,35,85,120
Benin,2011,sp,014,41,21,62
Benin,2011,sp,1524,288,320,608
Benin,2011,sp,2534,385,650,1035
Benin,2011,sp,3544,246,497,743
Benin,2011,sp,4554,119,353,472
Benin,2011,sp,5564,42,210,252
Benin,2011,sp,65,52,107,159
Benin,2012,sp,014,39,23,62
Benin,2012,sp,1524,264,314,578
Benin,2012,sp,2534,346,595,941
Benin,2012,sp,3544,221,524,745
Benin,2012,sp,4554,105,329,434
Benin,2012,sp,5564,65,179,244
Benin,2012,sp,65,46,121,167
Benin,2013,rel,014,23,25,48
Benin,2013,rel,1524,251,301,552
Benin,2013,rel,2534,360,591,951
Benin,2013,rel,3544,215,539,754
Benin,2013,rel,4554,120,331,451
Benin,2013,rel,5564,69,156,225
Benin,2013,rel,65,28,120,148
Bermuda,2004,sp,014,0,0,0
Bermuda,2004,sp,1524,0,0,0
Bermuda,2004,sp,2534,0,0,0
Bermuda,2004,sp,3544,0,0,0
Bermuda,2004,sp,4554,0,0,0
Bermuda,2004,sp,5564,0,0,0
Bermuda,2004,sp,65,0,0,0
Bermuda,2006,ep,3544,1,NA,NA
Bermuda,2006,sp,3544,NA,1,NA
Bermuda,2006,sp,4554,1,NA,NA
Bermuda,2010,ep,014,0,0,0
Bermuda,2010,ep,1524,0,0,0
Bermuda,2010,ep,2534,0,0,0
Bermuda,2010,ep,3544,0,0,0
Bermuda,2010,ep,4554,0,0,0
Bermuda,2010,ep,5564,0,0,0
Bermuda,2010,ep,65,0,0,0
Bermuda,2010,sn,014,0,0,0
Bermuda,2010,sn,1524,0,0,0
Bermuda,2010,sn,2534,0,0,0
Bermuda,2010,sn,3544,0,0,0
Bermuda,2010,sn,4554,0,0,0
Bermuda,2010,sn,5564,0,0,0
Bermuda,2010,sn,65,0,0,0
Bermuda,2010,sp,014,0,0,0
Bermuda,2010,sp,1524,0,0,0
Bermuda,2010,sp,2534,0,0,0
Bermuda,2010,sp,3544,0,1,1
Bermuda,2010,sp,4554,0,0,0
Bermuda,2010,sp,5564,0,0,0
Bermuda,2010,sp,65,0,0,0
Bermuda,2011,ep,014,0,0,0
Bermuda,2011,ep,1524,0,0,0
Bermuda,2011,ep,2534,0,0,0
Bermuda,2011,ep,3544,0,0,0
Bermuda,2011,ep,4554,0,0,0
Bermuda,2011,ep,5564,0,0,0
Bermuda,2011,ep,65,0,0,0
Bermuda,2011,sn,014,0,0,0
Bermuda,2011,sn,1524,0,0,0
Bermuda,2011,sn,2534,0,0,0
Bermuda,2011,sn,3544,0,0,0
Bermuda,2011,sn,4554,0,0,0
Bermuda,2011,sn,5564,0,0,0
Bermuda,2011,sn,65,0,1,1
Bermuda,2011,sp,014,0,0,0
Bermuda,2011,sp,1524,0,0,0
Bermuda,2011,sp,2534,0,0,0
Bermuda,2011,sp,3544,0,0,0
Bermuda,2011,sp,4554,0,0,0
Bermuda,2011,sp,5564,0,0,0
Bermuda,2011,sp,65,0,0,0
Bermuda,2012,ep,014,0,0,0
Bermuda,2012,ep,1524,0,0,0
Bermuda,2012,ep,2534,0,1,1
Bermuda,2012,ep,3544,0,0,0
Bermuda,2012,ep,4554,0,0,0
Bermuda,2012,ep,5564,0,0,0
Bermuda,2012,ep,65,0,0,0
Bermuda,2012,sn,014,0,1,1
Bermuda,2012,sn,1524,0,0,0
Bermuda,2012,sn,2534,0,0,0
Bermuda,2012,sn,3544,0,0,0
Bermuda,2012,sn,4554,0,0,0
Bermuda,2012,sn,5564,0,0,0
Bermuda,2012,sn,65,0,0,0
Bermuda,2012,sp,014,0,0,0
Bermuda,2012,sp,1524,0,0,0
Bermuda,2012,sp,2534,1,0,1
Bermuda,2012,sp,3544,0,0,0
Bermuda,2012,sp,4554,0,0,0
Bermuda,2012,sp,5564,0,0,0
Bermuda,2012,sp,65,0,0,0
Bermuda,2013,rel,014,0,0,0
Bermuda,2013,rel,1524,0,0,0
Bermuda,2013,rel,2534,0,0,0
Bermuda,2013,rel,3544,0,0,0
Bermuda,2013,rel,4554,0,0,0
Bermuda,2013,rel,5564,0,0,0
Bermuda,2013,rel,65,0,0,0
Bhutan,1995,sp,014,12,2,14
Bhutan,1995,sp,1524,43,42,85
Bhutan,1995,sp,2534,44,65,109
Bhutan,1995,sp,3544,25,36,61
Bhutan,1995,sp,4554,12,35,47
Bhutan,1995,sp,5564,9,24,33
Bhutan,1995,sp,65,8,11,19
Bhutan,1996,sp,014,8,4,12
Bhutan,1996,sp,1524,42,51,93
Bhutan,1996,sp,2534,41,45,86
Bhutan,1996,sp,3544,22,43,65
Bhutan,1996,sp,4554,14,22,36
Bhutan,1996,sp,5564,6,12,18
Bhutan,1996,sp,65,6,8,14
Bhutan,1997,sp,014,4,4,8
Bhutan,1997,sp,1524,43,39,82
Bhutan,1997,sp,2534,34,42,76
Bhutan,1997,sp,3544,16,36,52
Bhutan,1997,sp,4554,7,21,28
Bhutan,1997,sp,5564,6,24,30
Bhutan,1997,sp,65,3,8,11
Bhutan,1998,sp,014,7,3,10
Bhutan,1998,sp,1524,45,45,90
Bhutan,1998,sp,2534,26,39,65
Bhutan,1998,sp,3544,25,24,49
Bhutan,1998,sp,4554,8,24,32
Bhutan,1998,sp,5564,11,22,33
Bhutan,1998,sp,65,6,9,15
Bhutan,1999,sp,014,9,10,19
Bhutan,1999,sp,1524,33,27,60
Bhutan,1999,sp,2534,34,42,76
Bhutan,1999,sp,3544,23,31,54
Bhutan,1999,sp,4554,18,29,47
Bhutan,1999,sp,5564,14,22,36
Bhutan,1999,sp,65,9,14,23
Bhutan,2000,sp,014,7,6,13
Bhutan,2000,sp,1524,57,65,122
Bhutan,2000,sp,2534,34,41,75
Bhutan,2000,sp,3544,31,30,61
Bhutan,2000,sp,4554,23,24,47
Bhutan,2000,sp,5564,3,12,15
Bhutan,2000,sp,65,2,2,4
Bhutan,2001,sp,014,6,3,9
Bhutan,2001,sp,1524,58,51,109
Bhutan,2001,sp,2534,45,50,95
Bhutan,2001,sp,3544,20,37,57
Bhutan,2001,sp,4554,12,32,44
Bhutan,2001,sp,5564,11,10,21
Bhutan,2001,sp,65,8,16,24
Bhutan,2002,sp,014,6,5,11
Bhutan,2002,sp,1524,54,54,108
Bhutan,2002,sp,2534,38,51,89
Bhutan,2002,sp,3544,22,32,54
Bhutan,2002,sp,4554,20,26,46
Bhutan,2002,sp,5564,5,22,27
Bhutan,2002,sp,65,10,19,29
Bhutan,2003,sp,014,14,9,23
Bhutan,2003,sp,1524,57,62,119
Bhutan,2003,sp,2534,39,50,89
Bhutan,2003,sp,3544,17,20,37
Bhutan,2003,sp,4554,13,25,38
Bhutan,2003,sp,5564,15,20,35
Bhutan,2003,sp,65,6,13,19
Bhutan,2004,sp,014,8,1,9
Bhutan,2004,sp,1524,54,54,108
Bhutan,2004,sp,2534,35,52,87
Bhutan,2004,sp,3544,33,28,61
Bhutan,2004,sp,4554,10,27,37
Bhutan,2004,sp,5564,8,18,26
Bhutan,2004,sp,65,5,23,28
Bhutan,2005,sp,014,9,1,10
Bhutan,2005,sp,1524,45,47,92
Bhutan,2005,sp,2534,38,58,96
Bhutan,2005,sp,3544,13,26,39
Bhutan,2005,sp,4554,11,23,34
Bhutan,2005,sp,5564,9,14,23
Bhutan,2005,sp,65,2,12,14
Bhutan,2006,sp,014,5,0,5
Bhutan,2006,sp,1524,61,65,126
Bhutan,2006,sp,2534,27,55,82
Bhutan,2006,sp,3544,10,22,32
Bhutan,2006,sp,4554,9,20,29
Bhutan,2006,sp,5564,6,12,18
Bhutan,2006,sp,65,9,11,20
Bhutan,2007,sp,014,3,2,5
Bhutan,2007,sp,1524,59,60,119
Bhutan,2007,sp,2534,28,44,72
Bhutan,2007,sp,3544,21,29,50
Bhutan,2007,sp,4554,10,26,36
Bhutan,2007,sp,5564,10,17,27
Bhutan,2007,sp,65,6,13,19
Bhutan,2008,sp,014,9,3,12
Bhutan,2008,sp,1524,151,85,236
Bhutan,2008,sp,2534,77,46,123
Bhutan,2008,sp,3544,32,12,44
Bhutan,2008,sp,4554,33,18,51
Bhutan,2008,sp,5564,23,13,36
Bhutan,2008,sp,65,23,14,37
Bhutan,2009,sp,014,22,10,32
Bhutan,2009,sp,1524,92,74,166
Bhutan,2009,sp,2534,44,53,97
Bhutan,2009,sp,3544,27,19,46
Bhutan,2009,sp,4554,12,19,31
Bhutan,2009,sp,5564,9,21,30
Bhutan,2009,sp,65,8,24,32
Bhutan,2010,sp,014,17,NA,NA
Bhutan,2010,sp,1524,104,108,212
Bhutan,2010,sp,2534,45,50,95
Bhutan,2010,sp,3544,18,25,43
Bhutan,2010,sp,4554,18,12,30
Bhutan,2010,sp,5564,10,26,36
Bhutan,2010,sp,65,9,13,22
Bhutan,2011,ep,014,18,24,42
Bhutan,2011,ep,1524,27,32,59
Bhutan,2011,ep,2534,59,67,126
Bhutan,2011,ep,3544,87,95,182
Bhutan,2011,ep,4554,39,43,82
Bhutan,2011,ep,5564,26,28,54
Bhutan,2011,ep,65,16,12,28
Bhutan,2011,sn,014,10,15,25
Bhutan,2011,sn,1524,12,16,28
Bhutan,2011,sn,2534,36,42,78
Bhutan,2011,sn,3544,37,39,76
Bhutan,2011,sn,4554,NA,12,NA
Bhutan,2011,sn,5564,1,2,3
Bhutan,2011,sn,65,2,1,3
Bhutan,2011,sp,014,2,2,4
Bhutan,2011,sp,1524,92,88,180
Bhutan,2011,sp,2534,40,39,79
Bhutan,2011,sp,3544,19,26,45
Bhutan,2011,sp,4554,12,14,26
Bhutan,2011,sp,5564,4,20,24
Bhutan,2011,sp,65,5,19,24
Bhutan,2012,ep,014,12,8,20
Bhutan,2012,ep,1524,18,12,30
Bhutan,2012,ep,2534,62,56,118
Bhutan,2012,ep,3544,59,53,112
Bhutan,2012,ep,4554,58,54,112
Bhutan,2012,ep,5564,46,40,86
Bhutan,2012,ep,65,29,12,41
Bhutan,2012,sn,014,4,6,10
Bhutan,2012,sn,1524,10,12,22
Bhutan,2012,sn,2534,16,18,34
Bhutan,2012,sn,3544,12,12,24
Bhutan,2012,sn,4554,10,8,18
Bhutan,2012,sn,5564,8,6,14
Bhutan,2012,sn,65,2,3,5
Bhutan,2012,sp,014,6,6,12
Bhutan,2012,sp,1524,92,82,174
Bhutan,2012,sp,2534,58,56,114
Bhutan,2012,sp,3544,14,30,44
Bhutan,2012,sp,4554,18,11,29
Bhutan,2012,sp,5564,9,17,26
Bhutan,2012,sp,65,10,11,21
Bhutan,2013,rel,014,38,19,57
Bhutan,2013,rel,1524,199,180,379
Bhutan,2013,rel,2534,134,129,263
Bhutan,2013,rel,3544,53,70,123
Bhutan,2013,rel,4554,45,48,93
Bhutan,2013,rel,5564,41,44,85
Bhutan,2013,rel,65,23,48,71
Bolivia (Plurinational State of),1996,sp,014,172,178,350
Bolivia (Plurinational State of),1996,sp,1524,841,1359,2200
Bolivia (Plurinational State of),1996,sp,2534,676,887,1563
Bolivia (Plurinational State of),1996,sp,3544,422,636,1058
Bolivia (Plurinational State of),1996,sp,4554,244,525,769
Bolivia (Plurinational State of),1996,sp,5564,189,321,510
Bolivia (Plurinational State of),1996,sp,65,175,324,499
Bolivia (Plurinational State of),1997,sp,014,202,150,352
Bolivia (Plurinational State of),1997,sp,1524,792,1214,2006
Bolivia (Plurinational State of),1997,sp,2534,548,792,1340
Bolivia (Plurinational State of),1997,sp,3544,380,579,959
Bolivia (Plurinational State of),1997,sp,4554,285,485,770
Bolivia (Plurinational State of),1997,sp,5564,192,334,526
Bolivia (Plurinational State of),1997,sp,65,187,318,505
Bolivia (Plurinational State of),1998,sp,014,202,167,369
Bolivia (Plurinational State of),1998,sp,1524,777,1254,2031
Bolivia (Plurinational State of),1998,sp,2534,587,885,1472
Bolivia (Plurinational State of),1998,sp,3544,274,579,853
Bolivia (Plurinational State of),1998,sp,4554,264,488,752
Bolivia (Plurinational State of),1998,sp,5564,157,364,521
Bolivia (Plurinational State of),1998,sp,65,230,353,583
Bolivia (Plurinational State of),1999,sp,014,225,222,447
Bolivia (Plurinational State of),1999,sp,1524,798,1182,1980
Bolivia (Plurinational State of),1999,sp,2534,554,862,1416
Bolivia (Plurinational State of),1999,sp,3544,352,527,879
Bolivia (Plurinational State of),1999,sp,4554,263,482,745
Bolivia (Plurinational State of),1999,sp,5564,205,379,584
Bolivia (Plurinational State of),1999,sp,65,222,400,622
Bolivia (Plurinational State of),2000,sp,014,191,166,357
Bolivia (Plurinational State of),2000,sp,1524,831,1182,2013
Bolivia (Plurinational State of),2000,sp,2534,588,797,1385
Bolivia (Plurinational State of),2000,sp,3544,334,518,852
Bolivia (Plurinational State of),2000,sp,4554,254,466,720
Bolivia (Plurinational State of),2000,sp,5564,192,340,532
Bolivia (Plurinational State of),2000,sp,65,233,366,599
Bolivia (Plurinational State of),2001,sp,014,241,165,406
Bolivia (Plurinational State of),2001,sp,1524,915,1235,2150
Bolivia (Plurinational State of),2001,sp,2534,664,761,1425
Bolivia (Plurinational State of),2001,sp,3544,302,483,785
Bolivia (Plurinational State of),2001,sp,4554,226,489,715
Bolivia (Plurinational State of),2001,sp,5564,194,359,553
Bolivia (Plurinational State of),2001,sp,65,283,355,638
Bolivia (Plurinational State of),2002,sp,014,281,231,512
Bolivia (Plurinational State of),2002,sp,1524,938,1235,2173
Bolivia (Plurinational State of),2002,sp,2534,630,787,1417
Bolivia (Plurinational State of),2002,sp,3544,358,492,850
Bolivia (Plurinational State of),2002,sp,4554,238,417,655
Bolivia (Plurinational State of),2002,sp,5564,185,356,541
Bolivia (Plurinational State of),2002,sp,65,295,386,681
Bolivia (Plurinational State of),2003,sp,014,167,156,323
Bolivia (Plurinational State of),2003,sp,1524,811,1164,1975
Bolivia (Plurinational State of),2003,sp,2534,549,742,1291
Bolivia (Plurinational State of),2003,sp,3544,313,501,814
Bolivia (Plurinational State of),2003,sp,4554,224,438,662
Bolivia (Plurinational State of),2003,sp,5564,196,336,532
Bolivia (Plurinational State of),2003,sp,65,305,442,747
Bolivia (Plurinational State of),2004,sp,014,151,161,312
Bolivia (Plurinational State of),2004,sp,1524,793,1205,1998
Bolivia (Plurinational State of),2004,sp,2534,555,750,1305
Bolivia (Plurinational State of),2004,sp,3544,272,505,777
Bolivia (Plurinational State of),2004,sp,4554,205,431,636
Bolivia (Plurinational State of),2004,sp,5564,186,319,505
Bolivia (Plurinational State of),2004,sp,65,281,399,680
Bolivia (Plurinational State of),2005,sp,014,160,157,317
Bolivia (Plurinational State of),2005,sp,1524,846,1320,2166
Bolivia (Plurinational State of),2005,sp,2534,533,725,1258
Bolivia (Plurinational State of),2005,sp,3544,276,439,715
Bolivia (Plurinational State of),2005,sp,4554,226,391,617
Bolivia (Plurinational State of),2005,sp,5564,182,346,528
Bolivia (Plurinational State of),2005,sp,65,262,415,677
Bolivia (Plurinational State of),2006,sp,014,179,127,306
Bolivia (Plurinational State of),2006,sp,1524,764,1147,1911
Bolivia (Plurinational State of),2006,sp,2534,461,699,1160
Bolivia (Plurinational State of),2006,sp,3544,253,471,724
Bolivia (Plurinational State of),2006,sp,4554,177,390,567
Bolivia (Plurinational State of),2006,sp,5564,148,333,481
Bolivia (Plurinational State of),2006,sp,65,241,398,639
Bolivia (Plurinational State of),2007,sp,014,125,116,241
Bolivia (Plurinational State of),2007,sp,1524,736,1100,1836
Bolivia (Plurinational State of),2007,sp,2534,453,604,1057
Bolivia (Plurinational State of),2007,sp,3544,243,379,622
Bolivia (Plurinational State of),2007,sp,4554,193,348,541
Bolivia (Plurinational State of),2007,sp,5564,162,328,490
Bolivia (Plurinational State of),2007,sp,65,259,354,613
Bolivia (Plurinational State of),2008,sp,014,147,128,275
Bolivia (Plurinational State of),2008,sp,1524,850,1253,2103
Bolivia (Plurinational State of),2008,sp,2534,482,734,1216
Bolivia (Plurinational State of),2008,sp,3544,237,412,649
Bolivia (Plurinational State of),2008,sp,4554,193,391,584
Bolivia (Plurinational State of),2008,sp,5564,178,363,541
Bolivia (Plurinational State of),2008,sp,65,251,429,680
Bolivia (Plurinational State of),2009,ep,014,52,72,124
Bolivia (Plurinational State of),2009,ep,1524,178,276,454
Bolivia (Plurinational State of),2009,ep,2534,126,212,338
Bolivia (Plurinational State of),2009,ep,3544,82,109,191
Bolivia (Plurinational State of),2009,ep,4554,62,118,180
Bolivia (Plurinational State of),2009,ep,5564,56,131,187
Bolivia (Plurinational State of),2009,ep,65,103,165,268
Bolivia (Plurinational State of),2009,sp,014,158,106,264
Bolivia (Plurinational State of),2009,sp,1524,795,1225,2020
Bolivia (Plurinational State of),2009,sp,2534,502,703,1205
Bolivia (Plurinational State of),2009,sp,3544,217,393,610
Bolivia (Plurinational State of),2009,sp,4554,225,385,610
Bolivia (Plurinational State of),2009,sp,5564,161,343,504
Bolivia (Plurinational State of),2009,sp,65,295,429,724
Bolivia (Plurinational State of),2010,ep,014,47,63,110
Bolivia (Plurinational State of),2010,ep,1524,175,234,409
Bolivia (Plurinational State of),2010,ep,2534,161,192,353
Bolivia (Plurinational State of),2010,ep,3544,62,121,183
Bolivia (Plurinational State of),2010,ep,4554,68,122,190
Bolivia (Plurinational State of),2010,ep,5564,60,125,185
Bolivia (Plurinational State of),2010,ep,65,93,171,264
Bolivia (Plurinational State of),2010,sn,014,65,92,157
Bolivia (Plurinational State of),2010,sn,1524,38,102,140
Bolivia (Plurinational State of),2010,sn,2534,42,66,108
Bolivia (Plurinational State of),2010,sn,3544,18,43,61
Bolivia (Plurinational State of),2010,sn,4554,9,26,35
Bolivia (Plurinational State of),2010,sn,5564,29,29,58
Bolivia (Plurinational State of),2010,sn,65,29,42,71
Bolivia (Plurinational State of),2010,sp,014,119,95,214
Bolivia (Plurinational State of),2010,sp,1524,744,1150,1894
Bolivia (Plurinational State of),2010,sp,2534,471,622,1093
Bolivia (Plurinational State of),2010,sp,3544,238,415,653
Bolivia (Plurinational State of),2010,sp,4554,191,395,586
Bolivia (Plurinational State of),2010,sp,5564,162,338,500
Bolivia (Plurinational State of),2010,sp,65,264,409,673
Bolivia (Plurinational State of),2011,ep,014,55,60,115
Bolivia (Plurinational State of),2011,ep,1524,164,289,453
Bolivia (Plurinational State of),2011,ep,2534,147,204,351
Bolivia (Plurinational State of),2011,ep,3544,66,132,198
Bolivia (Plurinational State of),2011,ep,4554,66,125,191
Bolivia (Plurinational State of),2011,ep,5564,61,94,155
Bolivia (Plurinational State of),2011,ep,65,98,160,258
Bolivia (Plurinational State of),2011,sn,014,76,75,151
Bolivia (Plurinational State of),2011,sn,1524,47,115,162
Bolivia (Plurinational State of),2011,sn,2534,34,50,84
Bolivia (Plurinational State of),2011,sn,3544,18,46,64
Bolivia (Plurinational State of),2011,sn,4554,15,35,50
Bolivia (Plurinational State of),2011,sn,5564,20,32,52
Bolivia (Plurinational State of),2011,sn,65,24,56,80
Bolivia (Plurinational State of),2011,sp,014,146,100,246
Bolivia (Plurinational State of),2011,sp,1524,778,1231,2009
Bolivia (Plurinational State of),2011,sp,2534,459,685,1144
Bolivia (Plurinational State of),2011,sp,3544,235,372,607
Bolivia (Plurinational State of),2011,sp,4554,183,371,554
Bolivia (Plurinational State of),2011,sp,5564,155,302,457
Bolivia (Plurinational State of),2011,sp,65,272,457,729
Bolivia (Plurinational State of),2012,ep,014,43,41,84
Bolivia (Plurinational State of),2012,ep,1524,173,266,439
Bolivia (Plurinational State of),2012,ep,2534,149,198,347
Bolivia (Plurinational State of),2012,ep,3544,65,105,170
Bolivia (Plurinational State of),2012,ep,4554,60,101,161
Bolivia (Plurinational State of),2012,ep,5564,65,141,206
Bolivia (Plurinational State of),2012,ep,65,84,181,265
Bolivia (Plurinational State of),2012,sn,014,57,68,125
Bolivia (Plurinational State of),2012,sn,1524,37,100,137
Bolivia (Plurinational State of),2012,sn,2534,31,62,93
Bolivia (Plurinational State of),2012,sn,3544,16,43,59
Bolivia (Plurinational State of),2012,sn,4554,23,29,52
Bolivia (Plurinational State of),2012,sn,5564,9,32,41
Bolivia (Plurinational State of),2012,sn,65,17,47,64
Bolivia (Plurinational State of),2012,sp,014,101,99,200
Bolivia (Plurinational State of),2012,sp,1524,792,1096,1888
Bolivia (Plurinational State of),2012,sp,2534,480,672,1152
Bolivia (Plurinational State of),2012,sp,3544,223,368,591
Bolivia (Plurinational State of),2012,sp,4554,204,358,562
Bolivia (Plurinational State of),2012,sp,5564,193,353,546
Bolivia (Plurinational State of),2012,sp,65,249,380,629
Bolivia (Plurinational State of),2013,rel,014,212,223,435
Bolivia (Plurinational State of),2013,rel,1524,945,1470,2415
Bolivia (Plurinational State of),2013,rel,2534,664,978,1642
Bolivia (Plurinational State of),2013,rel,3544,355,625,980
Bolivia (Plurinational State of),2013,rel,4554,277,610,887
Bolivia (Plurinational State of),2013,rel,5564,281,556,837
Bolivia (Plurinational State of),2013,rel,65,403,728,1131
"Bonaire, Saint Eustatius and Saba",2010,ep,014,0,0,0
"Bonaire, Saint Eustatius and Saba",2010,ep,1524,0,0,0
"Bonaire, Saint Eustatius and Saba",2010,ep,2534,0,0,0
"Bonaire, Saint Eustatius and Saba",2010,ep,3544,0,0,0
"Bonaire, Saint Eustatius and Saba",2010,ep,4554,0,0,0
"Bonaire, Saint Eustatius and Saba",2010,ep,5564,0,0,0
"Bonaire, Saint Eustatius and Saba",2010,ep,65,0,0,0
"Bonaire, Saint Eustatius and Saba",2010,sn,014,0,0,0
"Bonaire, Saint Eustatius and Saba",2010,sn,1524,0,0,0
"Bonaire, Saint Eustatius and Saba",2010,sn,2534,0,0,0
"Bonaire, Saint Eustatius and Saba",2010,sn,3544,0,0,0
"Bonaire, Saint Eustatius and Saba",2010,sn,4554,0,0,0
"Bonaire, Saint Eustatius and Saba",2010,sn,5564,0,0,0
"Bonaire, Saint Eustatius and Saba",2010,sn,65,0,0,0
"Bonaire, Saint Eustatius and Saba",2010,sp,014,0,0,0
"Bonaire, Saint Eustatius and Saba",2010,sp,1524,0,0,0
"Bonaire, Saint Eustatius and Saba",2010,sp,2534,0,0,0
"Bonaire, Saint Eustatius and Saba",2010,sp,3544,0,0,0
"Bonaire, Saint Eustatius and Saba",2010,sp,4554,0,0,0
"Bonaire, Saint Eustatius and Saba",2010,sp,5564,0,0,0
"Bonaire, Saint Eustatius and Saba",2010,sp,65,0,0,0
"Bonaire, Saint Eustatius and Saba",2011,ep,014,0,0,0
"Bonaire, Saint Eustatius and Saba",2011,ep,1524,0,0,0
"Bonaire, Saint Eustatius and Saba",2011,ep,2534,0,0,0
"Bonaire, Saint Eustatius and Saba",2011,ep,3544,0,0,0
"Bonaire, Saint Eustatius and Saba",2011,ep,4554,0,0,0
"Bonaire, Saint Eustatius and Saba",2011,ep,5564,0,0,0
"Bonaire, Saint Eustatius and Saba",2011,ep,65,0,0,0
"Bonaire, Saint Eustatius and Saba",2011,sn,014,0,0,0
"Bonaire, Saint Eustatius and Saba",2011,sn,1524,0,0,0
"Bonaire, Saint Eustatius and Saba",2011,sn,2534,0,0,0
"Bonaire, Saint Eustatius and Saba",2011,sn,3544,0,0,0
"Bonaire, Saint Eustatius and Saba",2011,sn,4554,0,0,0
"Bonaire, Saint Eustatius and Saba",2011,sn,5564,0,0,0
"Bonaire, Saint Eustatius and Saba",2011,sn,65,0,0,0
"Bonaire, Saint Eustatius and Saba",2011,sp,014,0,0,0
"Bonaire, Saint Eustatius and Saba",2011,sp,1524,0,0,0
"Bonaire, Saint Eustatius and Saba",2011,sp,2534,0,0,0
"Bonaire, Saint Eustatius and Saba",2011,sp,3544,0,0,0
"Bonaire, Saint Eustatius and Saba",2011,sp,4554,0,0,0
"Bonaire, Saint Eustatius and Saba",2011,sp,5564,0,0,0
"Bonaire, Saint Eustatius and Saba",2011,sp,65,0,0,0
"Bonaire, Saint Eustatius and Saba",2012,ep,014,0,0,0
"Bonaire, Saint Eustatius and Saba",2012,ep,1524,0,0,0
"Bonaire, Saint Eustatius and Saba",2012,ep,2534,0,0,0
"Bonaire, Saint Eustatius and Saba",2012,ep,3544,0,0,0
"Bonaire, Saint Eustatius and Saba",2012,ep,4554,0,0,0
"Bonaire, Saint Eustatius and Saba",2012,ep,5564,0,0,0
"Bonaire, Saint Eustatius and Saba",2012,ep,65,0,0,0
"Bonaire, Saint Eustatius and Saba",2012,sn,014,0,0,0
"Bonaire, Saint Eustatius and Saba",2012,sn,1524,0,0,0
"Bonaire, Saint Eustatius and Saba",2012,sn,2534,0,0,0
"Bonaire, Saint Eustatius and Saba",2012,sn,3544,0,0,0
"Bonaire, Saint Eustatius and Saba",2012,sn,4554,0,0,0
"Bonaire, Saint Eustatius and Saba",2012,sn,5564,0,0,0
"Bonaire, Saint Eustatius and Saba",2012,sn,65,0,0,0
"Bonaire, Saint Eustatius and Saba",2012,sp,014,0,0,0
"Bonaire, Saint Eustatius and Saba",2012,sp,1524,0,0,0
"Bonaire, Saint Eustatius and Saba",2012,sp,2534,0,0,0
"Bonaire, Saint Eustatius and Saba",2012,sp,3544,0,0,0
"Bonaire, Saint Eustatius and Saba",2012,sp,4554,0,0,0
"Bonaire, Saint Eustatius and Saba",2012,sp,5564,0,0,0
"Bonaire, Saint Eustatius and Saba",2012,sp,65,0,0,0
"Bonaire, Saint Eustatius and Saba",2013,rel,014,0,0,0
"Bonaire, Saint Eustatius and Saba",2013,rel,1524,0,0,0
"Bonaire, Saint Eustatius and Saba",2013,rel,2534,0,0,0
"Bonaire, Saint Eustatius and Saba",2013,rel,3544,0,0,0
"Bonaire, Saint Eustatius and Saba",2013,rel,4554,0,0,0
"Bonaire, Saint Eustatius and Saba",2013,rel,5564,0,0,0
"Bonaire, Saint Eustatius and Saba",2013,rel,65,0,0,0
Bosnia and Herzegovina,1995,sp,014,0,0,0
Bosnia and Herzegovina,1995,sp,1524,40,15,55
Bosnia and Herzegovina,1995,sp,2534,67,61,128
Bosnia and Herzegovina,1995,sp,3544,64,90,154
Bosnia and Herzegovina,1995,sp,4554,49,140,189
Bosnia and Herzegovina,1995,sp,5564,77,139,216
Bosnia and Herzegovina,1995,sp,65,23,100,123
Bosnia and Herzegovina,1996,sp,014,0,5,5
Bosnia and Herzegovina,1996,sp,1524,23,30,53
Bosnia and Herzegovina,1996,sp,2534,28,48,76
Bosnia and Herzegovina,1996,sp,3544,39,62,101
Bosnia and Herzegovina,1996,sp,4554,16,51,67
Bosnia and Herzegovina,1996,sp,5564,27,60,87
Bosnia and Herzegovina,1996,sp,65,39,39,78
Bosnia and Herzegovina,1997,sp,014,11,5,16
Bosnia and Herzegovina,1997,sp,1524,53,48,101
Bosnia and Herzegovina,1997,sp,2534,42,84,126
Bosnia and Herzegovina,1997,sp,3544,50,99,149
Bosnia and Herzegovina,1997,sp,4554,35,66,101
Bosnia and Herzegovina,1997,sp,5564,65,36,101
Bosnia and Herzegovina,1997,sp,65,83,74,157
Bosnia and Herzegovina,1998,sp,014,3,1,4
Bosnia and Herzegovina,1998,sp,1524,37,28,65
Bosnia and Herzegovina,1998,sp,2534,42,75,117
Bosnia and Herzegovina,1998,sp,3544,27,85,112
Bosnia and Herzegovina,1998,sp,4554,22,75,97
Bosnia and Herzegovina,1998,sp,5564,30,55,85
Bosnia and Herzegovina,1998,sp,65,85,75,160
Bosnia and Herzegovina,1999,sp,014,6,2,8
Bosnia and Herzegovina,1999,sp,1524,49,44,93
Bosnia and Herzegovina,1999,sp,2534,59,76,135
Bosnia and Herzegovina,1999,sp,3544,34,113,147
Bosnia and Herzegovina,1999,sp,4554,24,89,113
Bosnia and Herzegovina,1999,sp,5564,38,60,98
Bosnia and Herzegovina,1999,sp,65,87,68,155
Bosnia and Herzegovina,2000,sp,014,4,4,8
Bosnia and Herzegovina,2000,sp,1524,30,56,86
Bosnia and Herzegovina,2000,sp,2534,46,82,128
Bosnia and Herzegovina,2000,sp,3544,29,99,128
Bosnia and Herzegovina,2000,sp,4554,29,66,95
Bosnia and Herzegovina,2000,sp,5564,48,58,106
Bosnia and Herzegovina,2000,sp,65,124,77,201
Bosnia and Herzegovina,2001,sp,014,7,6,13
Bosnia and Herzegovina,2001,sp,1524,45,39,84
Bosnia and Herzegovina,2001,sp,2534,50,70,120
Bosnia and Herzegovina,2001,sp,3544,34,110,144
Bosnia and Herzegovina,2001,sp,4554,17,89,106
Bosnia and Herzegovina,2001,sp,5564,50,53,103
Bosnia and Herzegovina,2001,sp,65,127,99,226
Bosnia and Herzegovina,2002,sp,014,2,1,3
Bosnia and Herzegovina,2002,sp,1524,22,36,58
Bosnia and Herzegovina,2002,sp,2534,33,48,81
Bosnia and Herzegovina,2002,sp,3544,18,70,88
Bosnia and Herzegovina,2002,sp,4554,19,69,88
Bosnia and Herzegovina,2002,sp,5564,31,33,64
Bosnia and Herzegovina,2002,sp,65,81,63,144
Bosnia and Herzegovina,2003,sp,014,4,4,8
Bosnia and Herzegovina,2003,sp,1524,27,32,59
Bosnia and Herzegovina,2003,sp,2534,37,42,79
Bosnia and Herzegovina,2003,sp,3544,34,49,83
Bosnia and Herzegovina,2003,sp,4554,14,52,66
Bosnia and Herzegovina,2003,sp,5564,30,45,75
Bosnia and Herzegovina,2003,sp,65,73,50,123
Bosnia and Herzegovina,2004,sp,014,3,3,6
Bosnia and Herzegovina,2004,sp,1524,45,66,111
Bosnia and Herzegovina,2004,sp,2534,67,79,146
Bosnia and Herzegovina,2004,sp,3544,43,95,138
Bosnia and Herzegovina,2004,sp,4554,51,82,133
Bosnia and Herzegovina,2004,sp,5564,59,77,136
Bosnia and Herzegovina,2004,sp,65,102,115,217
Bosnia and Herzegovina,2005,sp,014,2,1,3
Bosnia and Herzegovina,2005,sp,1524,35,22,57
Bosnia and Herzegovina,2005,sp,2534,39,58,97
Bosnia and Herzegovina,2005,sp,3544,33,61,94
Bosnia and Herzegovina,2005,sp,4554,28,78,106
Bosnia and Herzegovina,2005,sp,5564,28,44,72
Bosnia and Herzegovina,2005,sp,65,130,80,210
Bosnia and Herzegovina,2006,ep,014,2,5,7
Bosnia and Herzegovina,2006,ep,1524,14,23,37
Bosnia and Herzegovina,2006,ep,2534,20,11,31
Bosnia and Herzegovina,2006,ep,3544,12,13,25
Bosnia and Herzegovina,2006,ep,4554,15,13,28
Bosnia and Herzegovina,2006,ep,5564,12,10,22
Bosnia and Herzegovina,2006,ep,65,36,29,65
Bosnia and Herzegovina,2006,sn,014,10,7,17
Bosnia and Herzegovina,2006,sn,1524,22,22,44
Bosnia and Herzegovina,2006,sn,2534,18,30,48
Bosnia and Herzegovina,2006,sn,3544,34,55,89
Bosnia and Herzegovina,2006,sn,4554,48,73,121
Bosnia and Herzegovina,2006,sn,5564,68,82,150
Bosnia and Herzegovina,2006,sn,65,243,196,439
Bosnia and Herzegovina,2006,sp,014,0,0,0
Bosnia and Herzegovina,2006,sp,1524,41,40,81
Bosnia and Herzegovina,2006,sp,2534,50,58,108
Bosnia and Herzegovina,2006,sp,3544,24,47,71
Bosnia and Herzegovina,2006,sp,4554,29,53,82
Bosnia and Herzegovina,2006,sp,5564,20,42,62
Bosnia and Herzegovina,2006,sp,65,88,66,154
Bosnia and Herzegovina,2007,ep,014,0,0,0
Bosnia and Herzegovina,2007,ep,1524,0,0,0
Bosnia and Herzegovina,2007,ep,2534,0,0,0
Bosnia and Herzegovina,2007,ep,3544,0,0,0
Bosnia and Herzegovina,2007,ep,4554,0,0,0
Bosnia and Herzegovina,2007,ep,5564,0,0,0
Bosnia and Herzegovina,2007,ep,65,0,0,0
Bosnia and Herzegovina,2007,sn,014,0,0,0
Bosnia and Herzegovina,2007,sn,1524,0,0,0
Bosnia and Herzegovina,2007,sn,2534,0,0,0
Bosnia and Herzegovina,2007,sn,3544,0,0,0
Bosnia and Herzegovina,2007,sn,4554,0,0,0
Bosnia and Herzegovina,2007,sn,5564,0,0,0
Bosnia and Herzegovina,2007,sn,65,0,0,0
Bosnia and Herzegovina,2007,sp,014,0,0,0
Bosnia and Herzegovina,2007,sp,1524,0,0,0
Bosnia and Herzegovina,2007,sp,2534,0,0,0
Bosnia and Herzegovina,2007,sp,3544,0,0,0
Bosnia and Herzegovina,2007,sp,4554,0,0,0
Bosnia and Herzegovina,2007,sp,5564,0,0,0
Bosnia and Herzegovina,2007,sp,65,0,0,0
Bosnia and Herzegovina,2008,ep,014,4,4,8
Bosnia and Herzegovina,2008,ep,1524,12,13,25
Bosnia and Herzegovina,2008,ep,2534,12,18,30
Bosnia and Herzegovina,2008,ep,3544,18,23,41
Bosnia and Herzegovina,2008,ep,4554,12,24,36
Bosnia and Herzegovina,2008,ep,5564,18,13,31
Bosnia and Herzegovina,2008,ep,65,37,33,70
Bosnia and Herzegovina,2008,sn,014,1,5,6
Bosnia and Herzegovina,2008,sn,1524,19,39,58
Bosnia and Herzegovina,2008,sn,2534,31,47,78
Bosnia and Herzegovina,2008,sn,3544,39,45,84
Bosnia and Herzegovina,2008,sn,4554,40,99,139
Bosnia and Herzegovina,2008,sn,5564,66,80,146
Bosnia and Herzegovina,2008,sn,65,212,196,408
Bosnia and Herzegovina,2008,sp,014,3,0,3
Bosnia and Herzegovina,2008,sp,1524,26,20,46
Bosnia and Herzegovina,2008,sp,2534,26,35,61
Bosnia and Herzegovina,2008,sp,3544,20,38,58
Bosnia and Herzegovina,2008,sp,4554,11,84,95
Bosnia and Herzegovina,2008,sp,5564,6,49,55
Bosnia and Herzegovina,2008,sp,65,112,79,191
Bosnia and Herzegovina,2009,ep,014,0,3,3
Bosnia and Herzegovina,2009,ep,1524,12,12,24
Bosnia and Herzegovina,2009,ep,2534,14,12,26
Bosnia and Herzegovina,2009,ep,3544,8,15,23
Bosnia and Herzegovina,2009,ep,4554,14,17,31
Bosnia and Herzegovina,2009,ep,5564,10,17,27
Bosnia and Herzegovina,2009,ep,65,20,28,48
Bosnia and Herzegovina,2009,sn,014,2,3,5
Bosnia and Herzegovina,2009,sn,1524,19,28,47
Bosnia and Herzegovina,2009,sn,2534,27,44,71
Bosnia and Herzegovina,2009,sn,3544,27,48,75
Bosnia and Herzegovina,2009,sn,4554,31,103,134
Bosnia and Herzegovina,2009,sn,5564,59,76,135
Bosnia and Herzegovina,2009,sn,65,197,198,395
Bosnia and Herzegovina,2009,sp,014,4,2,6
Bosnia and Herzegovina,2009,sp,1524,31,27,58
Bosnia and Herzegovina,2009,sp,2534,30,35,65
Bosnia and Herzegovina,2009,sp,3544,17,75,92
Bosnia and Herzegovina,2009,sp,4554,19,77,96
Bosnia and Herzegovina,2009,sp,5564,13,67,80
Bosnia and Herzegovina,2009,sp,65,113,99,212
Bosnia and Herzegovina,2010,ep,014,1,1,2
Bosnia and Herzegovina,2010,ep,1524,15,12,27
Bosnia and Herzegovina,2010,ep,2534,8,12,20
Bosnia and Herzegovina,2010,ep,3544,8,7,15
Bosnia and Herzegovina,2010,ep,4554,10,15,25
Bosnia and Herzegovina,2010,ep,5564,8,14,22
Bosnia and Herzegovina,2010,ep,65,21,29,50
Bosnia and Herzegovina,2010,sn,014,4,6,10
Bosnia and Herzegovina,2010,sn,1524,27,27,54
Bosnia and Herzegovina,2010,sn,2534,19,26,45
Bosnia and Herzegovina,2010,sn,3544,26,41,67
Bosnia and Herzegovina,2010,sn,4554,31,64,95
Bosnia and Herzegovina,2010,sn,5564,41,71,112
Bosnia and Herzegovina,2010,sn,65,150,154,304
Bosnia and Herzegovina,2010,sp,014,0,1,1
Bosnia and Herzegovina,2010,sp,1524,27,27,54
Bosnia and Herzegovina,2010,sp,2534,19,37,56
Bosnia and Herzegovina,2010,sp,3544,16,34,50
Bosnia and Herzegovina,2010,sp,4554,10,61,71
Bosnia and Herzegovina,2010,sp,5564,18,46,64
Bosnia and Herzegovina,2010,sp,65,94,51,145
Bosnia and Herzegovina,2011,ep,014,2,1,3
Bosnia and Herzegovina,2011,ep,1524,5,15,20
Bosnia and Herzegovina,2011,ep,2534,9,7,16
Bosnia and Herzegovina,2011,ep,3544,8,9,17
Bosnia and Herzegovina,2011,ep,4554,11,14,25
Bosnia and Herzegovina,2011,ep,5564,20,16,36
Bosnia and Herzegovina,2011,ep,65,20,25,45
Bosnia and Herzegovina,2011,sn,014,6,6,12
Bosnia and Herzegovina,2011,sn,1524,19,24,43
Bosnia and Herzegovina,2011,sn,2534,31,34,65
Bosnia and Herzegovina,2011,sn,3544,25,39,64
Bosnia and Herzegovina,2011,sn,4554,31,61,92
Bosnia and Herzegovina,2011,sn,5564,35,91,126
Bosnia and Herzegovina,2011,sn,65,127,80,207
Bosnia and Herzegovina,2011,sp,014,3,2,5
Bosnia and Herzegovina,2011,sp,1524,17,33,50
Bosnia and Herzegovina,2011,sp,2534,27,32,59
Bosnia and Herzegovina,2011,sp,3544,17,52,69
Bosnia and Herzegovina,2011,sp,4554,13,75,88
Bosnia and Herzegovina,2011,sp,5564,25,61,86
Bosnia and Herzegovina,2011,sp,65,128,62,190
Bosnia and Herzegovina,2012,ep,014,4,4,8
Bosnia and Herzegovina,2012,ep,1524,9,17,26
Bosnia and Herzegovina,2012,ep,2534,6,14,20
Bosnia and Herzegovina,2012,ep,3544,12,10,22
Bosnia and Herzegovina,2012,ep,4554,13,13,26
Bosnia and Herzegovina,2012,ep,5564,10,14,24
Bosnia and Herzegovina,2012,ep,65,23,27,50
Bosnia and Herzegovina,2012,sn,014,2,7,9
Bosnia and Herzegovina,2012,sn,1524,19,19,38
Bosnia and Herzegovina,2012,sn,2534,20,32,52
Bosnia and Herzegovina,2012,sn,3544,9,29,38
Bosnia and Herzegovina,2012,sn,4554,19,59,78
Bosnia and Herzegovina,2012,sn,5564,27,80,107
Bosnia and Herzegovina,2012,sn,65,105,102,207
Bosnia and Herzegovina,2012,sp,014,0,1,1
Bosnia and Herzegovina,2012,sp,1524,33,23,56
Bosnia and Herzegovina,2012,sp,2534,26,32,58
Bosnia and Herzegovina,2012,sp,3544,21,58,79
Bosnia and Herzegovina,2012,sp,4554,10,74,84
Bosnia and Herzegovina,2012,sp,5564,25,62,87
Bosnia and Herzegovina,2012,sp,65,116,92,208
Bosnia and Herzegovina,2013,rel,014,5,7,12
Bosnia and Herzegovina,2013,rel,1524,53,57,110
Bosnia and Herzegovina,2013,rel,2534,46,73,119
Bosnia and Herzegovina,2013,rel,3544,47,89,136
Bosnia and Herzegovina,2013,rel,4554,50,125,175
Bosnia and Herzegovina,2013,rel,5564,71,136,207
Bosnia and Herzegovina,2013,rel,65,294,208,502
Botswana,1997,sp,014,28,29,57
Botswana,1997,sp,1524,291,193,484
Botswana,1997,sp,2534,359,509,868
Botswana,1997,sp,3544,181,422,603
Botswana,1997,sp,4554,97,244,341
Botswana,1997,sp,5564,60,143,203
Botswana,1997,sp,65,35,95,130
Botswana,1999,sp,014,46,18,64
Botswana,1999,sp,1524,274,177,451
Botswana,1999,sp,2534,434,526,960
Botswana,1999,sp,3544,225,492,717
Botswana,1999,sp,4554,90,274,364
Botswana,1999,sp,5564,30,139,169
Botswana,1999,sp,65,37,93,130
Botswana,2000,sp,014,37,25,62
Botswana,2000,sp,1524,335,185,520
Botswana,2000,sp,2534,469,605,1074
Botswana,2000,sp,3544,262,488,750
Botswana,2000,sp,4554,98,267,365
Botswana,2000,sp,5564,57,135,192
Botswana,2000,sp,65,36,96,132
Botswana,2001,sp,014,33,15,48
Botswana,2001,sp,1524,328,190,518
Botswana,2001,sp,2534,493,539,1032
Botswana,2001,sp,3544,309,490,799
Botswana,2001,sp,4554,116,288,404
Botswana,2001,sp,5564,46,116,162
Botswana,2001,sp,65,23,73,96
Botswana,2002,sp,014,45,17,62
Botswana,2002,sp,1524,393,226,619
Botswana,2002,sp,2534,566,595,1161
Botswana,2002,sp,3544,290,517,807
Botswana,2002,sp,4554,144,244,388
Botswana,2002,sp,5564,54,136,190
Botswana,2002,sp,65,26,84,110
Botswana,2003,sp,014,32,22,54
Botswana,2003,sp,1524,338,203,541
Botswana,2003,sp,2534,524,552,1076
Botswana,2003,sp,3544,276,446,722
Botswana,2003,sp,4554,104,244,348
Botswana,2003,sp,5564,52,136,188
Botswana,2003,sp,65,43,78,121
Botswana,2004,sp,014,49,29,78
Botswana,2004,sp,1524,358,245,603
Botswana,2004,sp,2534,544,490,1034
Botswana,2004,sp,3544,290,436,726
Botswana,2004,sp,4554,110,271,381
Botswana,2004,sp,5564,52,122,174
Botswana,2004,sp,65,36,96,132
Botswana,2005,sp,014,45,27,72
Botswana,2005,sp,1524,321,260,581
Botswana,2005,sp,2534,491,563,1054
Botswana,2005,sp,3544,253,506,759
Botswana,2005,sp,4554,97,272,369
Botswana,2005,sp,5564,55,135,190
Botswana,2005,sp,65,48,97,145
Botswana,2006,sp,014,54,36,90
Botswana,2006,sp,1524,326,262,588
Botswana,2006,sp,2534,507,577,1084
Botswana,2006,sp,3544,259,490,749
Botswana,2006,sp,4554,133,289,422
Botswana,2006,sp,5564,55,122,177
Botswana,2006,sp,65,38,104,142
Botswana,2007,sp,014,46,25,71
Botswana,2007,sp,1524,347,251,598
Botswana,2007,sp,2534,430,535,965
Botswana,2007,sp,3544,254,442,696
Botswana,2007,sp,4554,123,263,386
Botswana,2007,sp,5564,47,120,167
Botswana,2007,sp,65,37,82,119
Botswana,2008,ep,014,87,90,177
Botswana,2008,ep,1524,110,63,173
Botswana,2008,ep,2534,274,226,500
Botswana,2008,ep,3544,154,204,358
Botswana,2008,ep,4554,79,103,182
Botswana,2008,ep,5564,21,53,74
Botswana,2008,ep,65,28,52,80
Botswana,2008,sn,014,215,225,440
Botswana,2008,sn,1524,227,144,371
Botswana,2008,sn,2534,461,492,953
Botswana,2008,sn,3544,298,473,771
Botswana,2008,sn,4554,131,282,413
Botswana,2008,sn,5564,67,152,219
Botswana,2008,sn,65,67,132,199
Botswana,2008,sp,014,42,27,69
Botswana,2008,sp,1524,347,254,601
Botswana,2008,sp,2534,474,528,1002
Botswana,2008,sp,3544,226,384,610
Botswana,2008,sp,4554,135,220,355
Botswana,2008,sp,5564,51,113,164
Botswana,2008,sp,65,30,85,115
Botswana,2009,ep,014,84,81,165
Botswana,2009,ep,1524,99,69,168
Botswana,2009,ep,2534,226,217,443
Botswana,2009,ep,3544,149,188,337
Botswana,2009,ep,4554,73,96,169
Botswana,2009,ep,5564,24,55,79
Botswana,2009,ep,65,25,43,68
Botswana,2009,sn,014,274,311,585
Botswana,2009,sn,1524,217,138,355
Botswana,2009,sn,2534,488,442,930
Botswana,2009,sn,3544,284,439,723
Botswana,2009,sn,4554,142,259,401
Botswana,2009,sn,5564,67,149,216
Botswana,2009,sn,65,60,123,183
Botswana,2009,sp,014,63,40,103
Botswana,2009,sp,1524,331,262,593
Botswana,2009,sp,2534,455,539,994
Botswana,2009,sp,3544,256,461,717
Botswana,2009,sp,4554,128,271,399
Botswana,2009,sp,5564,56,136,192
Botswana,2009,sp,65,45,101,146
Botswana,2010,ep,014,58,57,115
Botswana,2010,ep,1524,83,53,136
Botswana,2010,ep,2534,196,177,373
Botswana,2010,ep,3544,166,144,310
Botswana,2010,ep,4554,58,87,145
Botswana,2010,ep,5564,19,50,69
Botswana,2010,ep,65,28,34,62
Botswana,2010,sn,014,153,142,295
Botswana,2010,sn,1524,120,108,228
Botswana,2010,sn,2534,271,266,537
Botswana,2010,sn,3544,169,327,496
Botswana,2010,sn,4554,80,147,227
Botswana,2010,sn,5564,41,90,131
Botswana,2010,sn,65,55,86,141
Botswana,2010,sp,014,68,45,113
Botswana,2010,sp,1524,338,256,594
Botswana,2010,sp,2534,509,590,1099
Botswana,2010,sp,3544,301,477,778
Botswana,2010,sp,4554,119,239,358
Botswana,2010,sp,5564,56,137,193
Botswana,2010,sp,65,53,107,160
Botswana,2011,ep,014,40,63,103
Botswana,2011,ep,1524,84,46,130
Botswana,2011,ep,2534,227,169,396
Botswana,2011,ep,3544,138,149,287
Botswana,2011,ep,4554,53,99,152
Botswana,2011,ep,5564,21,48,69
Botswana,2011,ep,65,24,52,76
Botswana,2011,sn,014,129,141,270
Botswana,2011,sn,1524,163,70,233
Botswana,2011,sn,2534,254,259,513
Botswana,2011,sn,3544,192,259,451
Botswana,2011,sn,4554,83,150,233
Botswana,2011,sn,5564,38,105,143
Botswana,2011,sn,65,40,100,140
Botswana,2011,sp,014,65,36,101
Botswana,2011,sp,1524,286,220,506
Botswana,2011,sp,2534,421,464,885
Botswana,2011,sp,3544,211,354,565
Botswana,2011,sp,4554,105,206,311
Botswana,2011,sp,5564,48,110,158
Botswana,2011,sp,65,49,94,143
Botswana,2012,ep,014,46,54,100
Botswana,2012,ep,1524,76,47,123
Botswana,2012,ep,2534,189,169,358
Botswana,2012,ep,3544,127,174,301
Botswana,2012,ep,4554,45,79,124
Botswana,2012,ep,5564,30,46,76
Botswana,2012,ep,65,22,47,69
Botswana,2012,sn,014,162,170,332
Botswana,2012,sn,1524,125,99,224
Botswana,2012,sn,2534,314,283,597
Botswana,2012,sn,3544,196,325,521
Botswana,2012,sn,4554,102,151,253
Botswana,2012,sn,5564,44,91,135
Botswana,2012,sn,65,47,99,146
Botswana,2012,sp,014,63,40,103
Botswana,2012,sp,1524,267,207,474
Botswana,2012,sp,2534,402,394,796
Botswana,2012,sp,3544,193,333,526
Botswana,2012,sp,4554,109,190,299
Botswana,2012,sp,5564,43,79,122
Botswana,2012,sp,65,31,75,106
Botswana,2013,rel,014,258,298,556
Botswana,2013,rel,1524,501,423,924
Botswana,2013,rel,2534,898,908,1806
Botswana,2013,rel,3544,636,1024,1660
Botswana,2013,rel,4554,317,584,901
Botswana,2013,rel,5564,146,346,492
Botswana,2013,rel,65,167,328,495
Brazil,1999,sp,014,372,301,673
Brazil,1999,sp,1524,2909,3662,6571
Brazil,1999,sp,2534,3450,5401,8851
Brazil,1999,sp,3544,2621,5827,8448
Brazil,1999,sp,4554,1661,4630,6291
Brazil,1999,sp,5564,1042,2634,3676
Brazil,1999,sp,65,1106,2121,3227
Brazil,2000,sp,014,1859,1894,3753
Brazil,2000,sp,1524,6719,7268,13987
Brazil,2000,sp,2534,7215,11568,18783
Brazil,2000,sp,3544,5395,11906,17301
Brazil,2000,sp,4554,3582,8623,12205
Brazil,2000,sp,5564,2384,5085,7469
Brazil,2000,sp,65,2496,4494,6990
Brazil,2001,sp,014,516,468,984
Brazil,2001,sp,1524,3632,4455,8087
Brazil,2001,sp,2534,3303,5536,8839
Brazil,2001,sp,3544,2296,5184,7480
Brazil,2001,sp,4554,1701,4285,5986
Brazil,2001,sp,5564,1050,2353,3403
Brazil,2001,sp,65,1018,1694,2712
Brazil,2002,sp,014,380,344,724
Brazil,2002,sp,1524,3715,4695,8410
Brazil,2002,sp,2534,3584,5890,9474
Brazil,2002,sp,3544,2817,6325,9142
Brazil,2002,sp,4554,1755,4834,6589
Brazil,2002,sp,5564,1031,2738,3769
Brazil,2002,sp,65,535,2080,2615
Brazil,2003,sp,014,401,382,783
Brazil,2003,sp,1524,3582,4485,8067
Brazil,2003,sp,2534,3542,5709,9251
Brazil,2003,sp,3544,2540,6034,8574
Brazil,2003,sp,4554,1676,4863,6539
Brazil,2003,sp,5564,1001,2589,3590
Brazil,2003,sp,65,1022,2057,3079
Brazil,2004,sp,014,375,337,712
Brazil,2004,sp,1524,3684,5041,8725
Brazil,2004,sp,2534,3763,6321,10084
Brazil,2004,sp,3544,2742,6481,9223
Brazil,2004,sp,4554,1865,5157,7022
Brazil,2004,sp,5564,1041,2716,3757
Brazil,2004,sp,65,1189,2169,3358
Brazil,2005,sp,014,355,317,672
Brazil,2005,sp,1524,3496,5074,8570
Brazil,2005,sp,2534,3663,6119,9782
Brazil,2005,sp,3544,2626,6128,8754
Brazil,2005,sp,4554,1897,5259,7156
Brazil,2005,sp,5564,1112,2803,3915
Brazil,2005,sp,65,1104,2140,3244
Brazil,2006,ep,014,311,365,676
Brazil,2006,ep,1524,672,825,1497
Brazil,2006,ep,2534,1026,1504,2530
Brazil,2006,ep,3544,941,1458,2399
Brazil,2006,ep,4554,612,1066,1678
Brazil,2006,ep,5564,399,567,966
Brazil,2006,ep,65,379,531,910
Brazil,2006,sn,014,787,781,1568
Brazil,2006,sn,1524,1412,2046,3458
Brazil,2006,sn,2534,1733,2804,4537
Brazil,2006,sn,3544,1420,2990,4410
Brazil,2006,sn,4554,1096,2643,3739
Brazil,2006,sn,5564,726,1606,2332
Brazil,2006,sn,65,896,1645,2541
Brazil,2006,sp,014,343,343,686
Brazil,2006,sp,1524,3132,4783,7915
Brazil,2006,sp,2534,3506,6098,9604
Brazil,2006,sp,3544,2569,6050,8619
Brazil,2006,sp,4554,1885,5042,6927
Brazil,2006,sp,5564,1121,2885,4006
Brazil,2006,sp,65,1139,2221,3360
Brazil,2007,ep,014,314,385,699
Brazil,2007,ep,1524,587,821,1408
Brazil,2007,ep,2534,976,1489,2465
Brazil,2007,ep,3544,873,1414,2287
Brazil,2007,ep,4554,618,1022,1640
Brazil,2007,ep,5564,397,570,967
Brazil,2007,ep,65,373,479,852
Brazil,2007,sn,014,733,789,1522
Brazil,2007,sn,1524,1334,2092,3426
Brazil,2007,sn,2534,1817,2879,4696
Brazil,2007,sn,3544,1428,3097,4525
Brazil,2007,sn,4554,1189,2687,3876
Brazil,2007,sn,5564,842,1725,2567
Brazil,2007,sn,65,823,1630,2453
Brazil,2007,sp,014,344,371,715
Brazil,2007,sp,1524,2952,4399,7351
Brazil,2007,sp,2534,3250,5990,9240
Brazil,2007,sp,3544,2327,5456,7783
Brazil,2007,sp,4554,1727,4878,6605
Brazil,2007,sp,5564,977,2726,3703
Brazil,2007,sp,65,972,2075,3047
Brazil,2008,ep,014,296,356,652
Brazil,2008,ep,1524,592,790,1382
Brazil,2008,ep,2534,951,1477,2428
Brazil,2008,ep,3544,814,1388,2202
Brazil,2008,ep,4554,584,1043,1627
Brazil,2008,ep,5564,384,586,970
Brazil,2008,ep,65,367,494,861
Brazil,2008,sn,014,711,715,1426
Brazil,2008,sn,1524,1315,2108,3423
Brazil,2008,sn,2534,1857,2977,4834
Brazil,2008,sn,3544,1434,2894,4328
Brazil,2008,sn,4554,1171,2612,3783
Brazil,2008,sn,5564,767,1638,2405
Brazil,2008,sn,65,929,1537,2466
Brazil,2008,sp,014,356,298,654
Brazil,2008,sp,1524,2709,4436,7145
Brazil,2008,sp,2534,3233,6173,9406
Brazil,2008,sp,3544,2266,5305,7571
Brazil,2008,sp,4554,1669,4854,6523
Brazil,2008,sp,5564,964,2650,3614
Brazil,2008,sp,65,879,1905,2784
Brazil,2009,ep,014,293,363,656
Brazil,2009,ep,1524,577,901,1478
Brazil,2009,ep,2534,980,1441,2421
Brazil,2009,ep,3544,798,1315,2113
Brazil,2009,ep,4554,657,1044,1701
Brazil,2009,ep,5564,385,576,961
Brazil,2009,ep,65,379,542,921
Brazil,2009,sn,014,663,750,1413
Brazil,2009,sn,1524,1336,2037,3373
Brazil,2009,sn,2534,1734,2908,4642
Brazil,2009,sn,3544,1362,2728,4090
Brazil,2009,sn,4554,1171,2547,3718
Brazil,2009,sn,5564,750,1696,2446
Brazil,2009,sn,65,915,1512,2427
Brazil,2009,sp,014,352,328,680
Brazil,2009,sp,1524,2880,4621,7501
Brazil,2009,sp,2534,3326,6399,9725
Brazil,2009,sp,3544,2271,5291,7562
Brazil,2009,sp,4554,1758,5058,6816
Brazil,2009,sp,5564,1077,2846,3923
Brazil,2009,sp,65,1011,1994,3005
Brazil,2010,ep,014,239,362,601
Brazil,2010,ep,1524,579,819,1398
Brazil,2010,ep,2534,1004,1464,2468
Brazil,2010,ep,3544,830,1277,2107
Brazil,2010,ep,4554,602,1006,1608
Brazil,2010,ep,5564,374,597,971
Brazil,2010,ep,65,349,495,844
Brazil,2010,sn,014,596,675,1271
Brazil,2010,sn,1524,1350,2081,3431
Brazil,2010,sn,2534,1812,3206,5018
Brazil,2010,sn,3544,1381,2795,4176
Brazil,2010,sn,4554,1198,2609,3807
Brazil,2010,sn,5564,835,1783,2618
Brazil,2010,sn,65,993,1663,2656
Brazil,2010,sp,014,280,298,578
Brazil,2010,sp,1524,2677,4405,7082
Brazil,2010,sp,2534,3008,6381,9389
Brazil,2010,sp,3544,2211,5293,7504
Brazil,2010,sp,4554,1720,4762,6482
Brazil,2010,sp,5564,1038,2875,3913
Brazil,2010,sp,65,979,1947,2926
Brazil,2011,ep,014,284,296,580
Brazil,2011,ep,1524,564,801,1365
Brazil,2011,ep,2534,975,1485,2460
Brazil,2011,ep,3544,757,1288,2045
Brazil,2011,ep,4554,668,1011,1679
Brazil,2011,ep,5564,393,644,1037
Brazil,2011,ep,65,379,502,881
Brazil,2011,sn,014,602,641,1243
Brazil,2011,sn,1524,1125,1786,2911
Brazil,2011,sn,2534,1517,2793,4310
Brazil,2011,sn,3544,1247,2621,3868
Brazil,2011,sn,4554,1068,2522,3590
Brazil,2011,sn,5564,821,1707,2528
Brazil,2011,sn,65,896,1556,2452
Brazil,2011,sp,014,356,336,692
Brazil,2011,sp,1524,2815,4877,7692
Brazil,2011,sp,2534,3131,6755,9886
Brazil,2011,sp,3544,2230,5462,7692
Brazil,2011,sp,4554,1779,5054,6833
Brazil,2011,sp,5564,1164,3083,4247
Brazil,2011,sp,65,1069,2142,3211
Brazil,2012,ep,014,244,298,542
Brazil,2012,ep,1524,590,879,1469
Brazil,2012,ep,2534,975,1521,2496
Brazil,2012,ep,3544,802,1250,2052
Brazil,2012,ep,4554,664,1075,1739
Brazil,2012,ep,5564,420,659,1079
Brazil,2012,ep,65,367,532,899
Brazil,2012,sn,014,623,643,1266
Brazil,2012,sn,1524,1097,1937,3034
Brazil,2012,sn,2534,1446,2916,4362
Brazil,2012,sn,3544,1235,2449,3684
Brazil,2012,sn,4554,1176,2350,3526
Brazil,2012,sn,5564,853,1730,2583
Brazil,2012,sn,65,853,1380,2233
Brazil,2012,sp,014,303,277,580
Brazil,2012,sp,1524,2798,5027,7825
Brazil,2012,sp,2534,3013,6811,9824
Brazil,2012,sp,3544,2173,5387,7560
Brazil,2012,sp,4554,1785,5128,6913
Brazil,2012,sp,5564,1113,3103,4216
Brazil,2012,sp,65,1030,2160,3190
Brazil,2013,rel,014,1249,1398,2647
Brazil,2013,rel,1524,4670,7903,12573
Brazil,2013,rel,2534,5673,11759,17432
Brazil,2013,rel,3544,4547,10043,14590
Brazil,2013,rel,4554,3868,8991,12859
Brazil,2013,rel,5564,2672,6041,8713
Brazil,2013,rel,65,2580,4602,7182
British Virgin Islands,2000,sp,5564,NA,1,NA
British Virgin Islands,2002,sp,65,1,NA,NA
British Virgin Islands,2004,sp,2534,1,NA,NA
British Virgin Islands,2004,sp,4554,NA,1,NA
British Virgin Islands,2010,ep,014,0,0,0
British Virgin Islands,2010,ep,1524,0,0,0
British Virgin Islands,2010,ep,2534,0,0,0
British Virgin Islands,2010,ep,3544,0,0,0
British Virgin Islands,2010,ep,4554,0,0,0
British Virgin Islands,2010,ep,5564,0,0,0
British Virgin Islands,2010,ep,65,0,0,0
British Virgin Islands,2010,sn,014,0,0,0
British Virgin Islands,2010,sn,1524,0,0,0
British Virgin Islands,2010,sn,2534,0,0,0
British Virgin Islands,2010,sn,3544,0,0,0
British Virgin Islands,2010,sn,4554,0,0,0
British Virgin Islands,2010,sn,5564,0,0,0
British Virgin Islands,2010,sn,65,0,0,0
British Virgin Islands,2010,sp,014,0,0,0
British Virgin Islands,2010,sp,1524,0,0,0
British Virgin Islands,2010,sp,2534,0,0,0
British Virgin Islands,2010,sp,3544,0,0,0
British Virgin Islands,2010,sp,4554,0,0,0
British Virgin Islands,2010,sp,5564,0,1,1
British Virgin Islands,2010,sp,65,0,0,0
British Virgin Islands,2011,ep,014,0,0,0
British Virgin Islands,2011,ep,1524,0,0,0
British Virgin Islands,2011,ep,2534,0,0,0
British Virgin Islands,2011,ep,3544,0,0,0
British Virgin Islands,2011,ep,4554,0,0,0
British Virgin Islands,2011,ep,5564,0,0,0
British Virgin Islands,2011,ep,65,0,0,0
British Virgin Islands,2011,sn,014,0,0,0
British Virgin Islands,2011,sn,1524,0,0,0
British Virgin Islands,2011,sn,2534,0,0,0
British Virgin Islands,2011,sn,3544,0,0,0
British Virgin Islands,2011,sn,4554,0,0,0
British Virgin Islands,2011,sn,5564,0,0,0
British Virgin Islands,2011,sn,65,0,0,0
British Virgin Islands,2011,sp,014,0,0,0
British Virgin Islands,2011,sp,1524,0,0,0
British Virgin Islands,2011,sp,2534,0,0,0
British Virgin Islands,2011,sp,3544,0,0,0
British Virgin Islands,2011,sp,4554,0,0,0
British Virgin Islands,2011,sp,5564,0,0,0
British Virgin Islands,2011,sp,65,0,0,0
British Virgin Islands,2012,ep,014,0,0,0
British Virgin Islands,2012,ep,1524,0,0,0
British Virgin Islands,2012,ep,2534,0,0,0
British Virgin Islands,2012,ep,3544,0,0,0
British Virgin Islands,2012,ep,4554,0,0,0
British Virgin Islands,2012,ep,5564,0,0,0
British Virgin Islands,2012,ep,65,0,0,0
British Virgin Islands,2012,sn,014,0,0,0
British Virgin Islands,2012,sn,1524,0,0,0
British Virgin Islands,2012,sn,2534,0,0,0
British Virgin Islands,2012,sn,3544,0,0,0
British Virgin Islands,2012,sn,4554,0,0,0
British Virgin Islands,2012,sn,5564,0,0,0
British Virgin Islands,2012,sn,65,0,0,0
British Virgin Islands,2012,sp,014,0,0,0
British Virgin Islands,2012,sp,1524,0,0,0
British Virgin Islands,2012,sp,2534,0,0,0
British Virgin Islands,2012,sp,3544,0,0,0
British Virgin Islands,2012,sp,4554,0,0,0
British Virgin Islands,2012,sp,5564,0,0,0
British Virgin Islands,2012,sp,65,0,0,0
British Virgin Islands,2013,rel,014,0,0,0
British Virgin Islands,2013,rel,1524,0,0,0
British Virgin Islands,2013,rel,2534,0,0,0
British Virgin Islands,2013,rel,3544,0,0,0
British Virgin Islands,2013,rel,4554,0,0,0
British Virgin Islands,2013,rel,5564,0,0,0
British Virgin Islands,2013,rel,65,0,0,0
Brunei Darussalam,1999,sp,014,1,0,1
Brunei Darussalam,1999,sp,1524,16,16,32
Brunei Darussalam,1999,sp,2534,36,42,78
Brunei Darussalam,1999,sp,3544,16,30,46
Brunei Darussalam,1999,sp,4554,16,11,27
Brunei Darussalam,1999,sp,5564,13,25,38
Brunei Darussalam,1999,sp,65,14,31,45
Brunei Darussalam,2000,sp,014,0,0,0
Brunei Darussalam,2000,sp,1524,4,6,10
Brunei Darussalam,2000,sp,2534,6,4,10
Brunei Darussalam,2000,sp,3544,9,15,24
Brunei Darussalam,2000,sp,4554,6,5,11
Brunei Darussalam,2000,sp,5564,3,7,10
Brunei Darussalam,2000,sp,65,4,15,19
Brunei Darussalam,2002,sp,014,0,2,2
Brunei Darussalam,2002,sp,1524,11,15,26
Brunei Darussalam,2002,sp,2534,9,15,24
Brunei Darussalam,2002,sp,3544,8,7,15
Brunei Darussalam,2002,sp,4554,5,6,11
Brunei Darussalam,2002,sp,5564,5,8,13
Brunei Darussalam,2002,sp,65,7,14,21
Brunei Darussalam,2003,sp,014,0,0,0
Brunei Darussalam,2003,sp,1524,9,5,14
Brunei Darussalam,2003,sp,2534,14,25,39
Brunei Darussalam,2003,sp,3544,11,17,28
Brunei Darussalam,2003,sp,4554,4,8,12
Brunei Darussalam,2003,sp,5564,5,8,13
Brunei Darussalam,2003,sp,65,6,9,15
Brunei Darussalam,2004,sp,014,0,0,0
Brunei Darussalam,2004,sp,1524,6,10,16
Brunei Darussalam,2004,sp,2534,11,13,24
Brunei Darussalam,2004,sp,3544,12,12,24
Brunei Darussalam,2004,sp,4554,8,16,24
Brunei Darussalam,2004,sp,5564,2,11,13
Brunei Darussalam,2004,sp,65,4,10,14
Brunei Darussalam,2005,sp,014,0,0,0
Brunei Darussalam,2005,sp,1524,9,9,18
Brunei Darussalam,2005,sp,2534,11,19,30
Brunei Darussalam,2005,sp,3544,8,19,27
Brunei Darussalam,2005,sp,4554,3,12,15
Brunei Darussalam,2005,sp,5564,2,9,11
Brunei Darussalam,2005,sp,65,0,0,0
Brunei Darussalam,2006,ep,014,1,NA,NA
Brunei Darussalam,2006,ep,1524,1,2,3
Brunei Darussalam,2006,ep,2534,10,2,12
Brunei Darussalam,2006,ep,3544,4,1,5
Brunei Darussalam,2006,ep,4554,3,2,5
Brunei Darussalam,2006,ep,5564,3,4,7
Brunei Darussalam,2006,ep,65,1,2,3
Brunei Darussalam,2006,sn,014,0,NA,NA
Brunei Darussalam,2006,sn,1524,2,0,2
Brunei Darussalam,2006,sn,2534,0,3,3
Brunei Darussalam,2006,sn,3544,1,1,2
Brunei Darussalam,2006,sn,4554,3,3,6
Brunei Darussalam,2006,sn,5564,0,3,3
Brunei Darussalam,2006,sn,65,6,3,9
Brunei Darussalam,2006,sp,014,1,2,3
Brunei Darussalam,2006,sp,1524,5,10,15
Brunei Darussalam,2006,sp,2534,11,11,22
Brunei Darussalam,2006,sp,3544,8,12,20
Brunei Darussalam,2006,sp,4554,11,13,24
Brunei Darussalam,2006,sp,5564,4,10,14
Brunei Darussalam,2006,sp,65,9,11,20
Brunei Darussalam,2007,ep,014,0,0,0
Brunei Darussalam,2007,ep,1524,3,3,6
Brunei Darussalam,2007,ep,2534,5,7,12
Brunei Darussalam,2007,ep,3544,8,2,10
Brunei Darussalam,2007,ep,4554,7,4,11
Brunei Darussalam,2007,ep,5564,1,2,3
Brunei Darussalam,2007,ep,65,1,6,7
Brunei Darussalam,2007,sn,014,0,0,0
Brunei Darussalam,2007,sn,1524,0,1,1
Brunei Darussalam,2007,sn,2534,0,0,0
Brunei Darussalam,2007,sn,3544,1,2,3
Brunei Darussalam,2007,sn,4554,0,1,1
Brunei Darussalam,2007,sn,5564,1,1,2
Brunei Darussalam,2007,sn,65,1,1,2
Brunei Darussalam,2007,sp,014,0,0,0
Brunei Darussalam,2007,sp,1524,6,5,11
Brunei Darussalam,2007,sp,2534,6,10,16
Brunei Darussalam,2007,sp,3544,12,15,27
Brunei Darussalam,2007,sp,4554,15,21,36
Brunei Darussalam,2007,sp,5564,9,10,19
Brunei Darussalam,2007,sp,65,2,17,19
Brunei Darussalam,2008,ep,014,0,0,0
Brunei Darussalam,2008,ep,1524,5,1,6
Brunei Darussalam,2008,ep,2534,8,3,11
Brunei Darussalam,2008,ep,3544,5,2,7
Brunei Darussalam,2008,ep,4554,2,6,8
Brunei Darussalam,2008,ep,5564,1,4,5
Brunei Darussalam,2008,ep,65,2,4,6
Brunei Darussalam,2008,sn,014,0,0,0
Brunei Darussalam,2008,sn,1524,2,2,4
Brunei Darussalam,2008,sn,2534,4,2,6
Brunei Darussalam,2008,sn,3544,1,6,7
Brunei Darussalam,2008,sn,4554,1,2,3
Brunei Darussalam,2008,sn,5564,1,1,2
Brunei Darussalam,2008,sn,65,1,5,6
Brunei Darussalam,2008,sp,014,1,0,1
Brunei Darussalam,2008,sp,1524,6,10,16
Brunei Darussalam,2008,sp,2534,11,10,21
Brunei Darussalam,2008,sp,3544,8,12,20
Brunei Darussalam,2008,sp,4554,7,21,28
Brunei Darussalam,2008,sp,5564,7,6,13
Brunei Darussalam,2008,sp,65,10,23,33
Brunei Darussalam,2009,ep,014,2,1,3
Brunei Darussalam,2009,ep,1524,4,2,6
Brunei Darussalam,2009,ep,2534,8,3,11
Brunei Darussalam,2009,ep,3544,6,4,10
Brunei Darussalam,2009,ep,4554,7,2,9
Brunei Darussalam,2009,ep,5564,3,2,5
Brunei Darussalam,2009,ep,65,3,2,5
Brunei Darussalam,2009,sn,014,0,0,0
Brunei Darussalam,2009,sn,1524,1,0,1
Brunei Darussalam,2009,sn,2534,4,0,4
Brunei Darussalam,2009,sn,3544,3,3,6
Brunei Darussalam,2009,sn,4554,0,2,2
Brunei Darussalam,2009,sn,5564,2,0,2
Brunei Darussalam,2009,sn,65,1,2,3
Brunei Darussalam,2009,sp,014,0,1,1
Brunei Darussalam,2009,sp,1524,10,5,15
Brunei Darussalam,2009,sp,2534,12,5,17
Brunei Darussalam,2009,sp,3544,11,16,27
Brunei Darussalam,2009,sp,4554,7,13,20
Brunei Darussalam,2009,sp,5564,3,18,21
Brunei Darussalam,2009,sp,65,10,29,39
Brunei Darussalam,2010,ep,014,0,1,1
Brunei Darussalam,2010,ep,1524,2,3,5
Brunei Darussalam,2010,ep,2534,7,3,10
Brunei Darussalam,2010,ep,3544,5,4,9
Brunei Darussalam,2010,ep,4554,2,5,7
Brunei Darussalam,2010,ep,5564,2,4,6
Brunei Darussalam,2010,ep,65,1,4,5
Brunei Darussalam,2010,sn,014,0,0,0
Brunei Darussalam,2010,sn,1524,0,2,2
Brunei Darussalam,2010,sn,2534,4,4,8
Brunei Darussalam,2010,sn,3544,1,6,7
Brunei Darussalam,2010,sn,4554,0,4,4
Brunei Darussalam,2010,sn,5564,1,1,2
Brunei Darussalam,2010,sn,65,3,4,7
Brunei Darussalam,2010,sp,014,2,0,2
Brunei Darussalam,2010,sp,1524,7,17,24
Brunei Darussalam,2010,sp,2534,15,15,30
Brunei Darussalam,2010,sp,3544,12,13,25
Brunei Darussalam,2010,sp,4554,8,18,26
Brunei Darussalam,2010,sp,5564,4,7,11
Brunei Darussalam,2010,sp,65,10,18,28
Brunei Darussalam,2011,ep,014,0,0,0
Brunei Darussalam,2011,ep,1524,5,5,10
Brunei Darussalam,2011,ep,2534,3,10,13
Brunei Darussalam,2011,ep,3544,4,5,9
Brunei Darussalam,2011,ep,4554,2,4,6
Brunei Darussalam,2011,ep,5564,1,2,3
Brunei Darussalam,2011,ep,65,3,4,7
Brunei Darussalam,2011,sn,014,0,0,0
Brunei Darussalam,2011,sn,1524,1,6,7
Brunei Darussalam,2011,sn,2534,3,6,9
Brunei Darussalam,2011,sn,3544,5,5,10
Brunei Darussalam,2011,sn,4554,1,12,13
Brunei Darussalam,2011,sn,5564,1,2,3
Brunei Darussalam,2011,sn,65,3,7,10
Brunei Darussalam,2011,sp,014,2,0,2
Brunei Darussalam,2011,sp,1524,5,11,16
Brunei Darussalam,2011,sp,2534,9,11,20
Brunei Darussalam,2011,sp,3544,6,11,17
Brunei Darussalam,2011,sp,4554,7,10,17
Brunei Darussalam,2011,sp,5564,3,11,14
Brunei Darussalam,2011,sp,65,10,13,23
Brunei Darussalam,2012,ep,014,0,1,1
Brunei Darussalam,2012,ep,1524,3,2,5
Brunei Darussalam,2012,ep,2534,1,1,2
Brunei Darussalam,2012,ep,3544,4,1,5
Brunei Darussalam,2012,ep,4554,3,4,7
Brunei Darussalam,2012,ep,5564,0,3,3
Brunei Darussalam,2012,ep,65,2,6,8
Brunei Darussalam,2012,sn,014,0,0,0
Brunei Darussalam,2012,sn,1524,4,4,8
Brunei Darussalam,2012,sn,2534,3,8,11
Brunei Darussalam,2012,sn,3544,6,11,17
Brunei Darussalam,2012,sn,4554,3,8,11
Brunei Darussalam,2012,sn,5564,4,6,10
Brunei Darussalam,2012,sn,65,11,11,22
Brunei Darussalam,2012,sp,014,0,0,0
Brunei Darussalam,2012,sp,1524,5,10,15
Brunei Darussalam,2012,sp,2534,6,13,19
Brunei Darussalam,2012,sp,3544,9,15,24
Brunei Darussalam,2012,sp,4554,10,13,23
Brunei Darussalam,2012,sp,5564,6,8,14
Brunei Darussalam,2012,sp,65,5,19,24
Brunei Darussalam,2013,rel,014,3,1,4
Brunei Darussalam,2013,rel,1524,9,14,23
Brunei Darussalam,2013,rel,2534,24,20,44
Brunei Darussalam,2013,rel,3544,17,20,37
Brunei Darussalam,2013,rel,4554,12,27,39
Brunei Darussalam,2013,rel,5564,10,16,26
Brunei Darussalam,2013,rel,65,12,27,39
Bulgaria,2000,sp,014,0,0,0
Bulgaria,2000,sp,1524,11,13,24
Bulgaria,2000,sp,2534,14,16,30
Bulgaria,2000,sp,3544,7,20,27
Bulgaria,2000,sp,4554,3,3,6
Bulgaria,2000,sp,5564,4,9,13
Bulgaria,2000,sp,65,6,10,16
Bulgaria,2001,sp,014,1,1,2
Bulgaria,2001,sp,1524,11,15,26
Bulgaria,2001,sp,2534,16,20,36
Bulgaria,2001,sp,3544,13,23,36
Bulgaria,2001,sp,4554,5,23,28
Bulgaria,2001,sp,5564,2,18,20
Bulgaria,2001,sp,65,9,13,22
Bulgaria,2002,sp,014,6,2,8
Bulgaria,2002,sp,1524,48,62,110
Bulgaria,2002,sp,2534,73,86,159
Bulgaria,2002,sp,3544,45,116,161
Bulgaria,2002,sp,4554,19,132,151
Bulgaria,2002,sp,5564,9,58,67
Bulgaria,2002,sp,65,30,56,86
Bulgaria,2003,sp,014,7,3,10
Bulgaria,2003,sp,1524,85,99,184
Bulgaria,2003,sp,2534,106,169,275
Bulgaria,2003,sp,3544,63,178,241
Bulgaria,2003,sp,4554,44,200,244
Bulgaria,2003,sp,5564,32,121,153
Bulgaria,2003,sp,65,58,89,147
Bulgaria,2004,sp,014,4,10,14
Bulgaria,2004,sp,1524,84,97,181
Bulgaria,2004,sp,2534,111,156,267
Bulgaria,2004,sp,3544,64,166,230
Bulgaria,2004,sp,4554,49,204,253
Bulgaria,2004,sp,5564,35,153,188
Bulgaria,2004,sp,65,71,111,182
Bulgaria,2005,sp,014,9,9,18
Bulgaria,2005,sp,1524,90,98,188
Bulgaria,2005,sp,2534,111,150,261
Bulgaria,2005,sp,3544,59,195,254
Bulgaria,2005,sp,4554,29,195,224
Bulgaria,2005,sp,5564,37,150,187
Bulgaria,2005,sp,65,70,136,206
Bulgaria,2006,sp,014,12,6,18
Bulgaria,2006,sp,1524,76,86,162
Bulgaria,2006,sp,2534,96,146,242
Bulgaria,2006,sp,3544,86,170,256
Bulgaria,2006,sp,4554,34,184,218
Bulgaria,2006,sp,5564,24,133,157
Bulgaria,2006,sp,65,59,123,182
Bulgaria,2007,ep,014,67,75,142
Bulgaria,2007,ep,1524,37,46,83
Bulgaria,2007,ep,2534,25,35,60
Bulgaria,2007,ep,3544,31,39,70
Bulgaria,2007,ep,4554,31,41,72
Bulgaria,2007,ep,5564,36,54,90
Bulgaria,2007,ep,65,63,73,136
Bulgaria,2007,sn,014,24,17,41
Bulgaria,2007,sn,1524,43,53,96
Bulgaria,2007,sn,2534,71,104,175
Bulgaria,2007,sn,3544,35,83,118
Bulgaria,2007,sn,4554,41,128,169
Bulgaria,2007,sn,5564,45,132,177
Bulgaria,2007,sn,65,70,164,234
Bulgaria,2007,sp,014,4,7,11
Bulgaria,2007,sp,1524,63,63,126
Bulgaria,2007,sp,2534,77,122,199
Bulgaria,2007,sp,3544,53,181,234
Bulgaria,2007,sp,4554,38,176,214
Bulgaria,2007,sp,5564,29,131,160
Bulgaria,2007,sp,65,46,90,136
Bulgaria,2008,ep,014,83,118,201
Bulgaria,2008,ep,1524,20,36,56
Bulgaria,2008,ep,2534,35,33,68
Bulgaria,2008,ep,3544,27,43,70
Bulgaria,2008,ep,4554,34,31,65
Bulgaria,2008,ep,5564,57,43,100
Bulgaria,2008,ep,65,59,68,127
Bulgaria,2008,sn,014,10,11,21
Bulgaria,2008,sn,1524,48,67,115
Bulgaria,2008,sn,2534,56,98,154
Bulgaria,2008,sn,3544,51,103,154
Bulgaria,2008,sn,4554,54,150,204
Bulgaria,2008,sn,5564,44,157,201
Bulgaria,2008,sn,65,100,172,272
Bulgaria,2008,sp,014,1,2,3
Bulgaria,2008,sp,1524,57,80,137
Bulgaria,2008,sp,2534,78,145,223
Bulgaria,2008,sp,3544,54,151,205
Bulgaria,2008,sp,4554,31,159,190
Bulgaria,2008,sp,5564,23,127,150
Bulgaria,2008,sp,65,44,68,112
Bulgaria,2009,ep,014,79,94,173
Bulgaria,2009,ep,1524,31,52,83
Bulgaria,2009,ep,2534,23,33,56
Bulgaria,2009,ep,3544,26,50,76
Bulgaria,2009,ep,4554,42,39,81
Bulgaria,2009,ep,5564,37,52,89
Bulgaria,2009,ep,65,92,90,182
Bulgaria,2009,sn,014,10,10,20
Bulgaria,2009,sn,1524,34,46,80
Bulgaria,2009,sn,2534,46,73,119
Bulgaria,2009,sn,3544,49,72,121
Bulgaria,2009,sn,4554,41,126,167
Bulgaria,2009,sn,5564,58,107,165
Bulgaria,2009,sn,65,74,144,218
Bulgaria,2009,sp,014,2,7,9
Bulgaria,2009,sp,1524,65,51,116
Bulgaria,2009,sp,2534,72,93,165
Bulgaria,2009,sp,3544,44,120,164
Bulgaria,2009,sp,4554,44,158,202
Bulgaria,2009,sp,5564,21,96,117
Bulgaria,2009,sp,65,39,84,123
Bulgaria,2010,ep,014,102,93,195
Bulgaria,2010,ep,1524,41,34,75
Bulgaria,2010,ep,2534,32,40,72
Bulgaria,2010,ep,3544,31,41,72
Bulgaria,2010,ep,4554,34,42,76
Bulgaria,2010,ep,5564,37,58,95
Bulgaria,2010,ep,65,81,81,162
Bulgaria,2010,sn,014,8,6,14
Bulgaria,2010,sn,1524,37,45,82
Bulgaria,2010,sn,2534,44,73,117
Bulgaria,2010,sn,3544,40,69,109
Bulgaria,2010,sn,4554,32,78,110
Bulgaria,2010,sn,5564,35,97,132
Bulgaria,2010,sn,65,67,117,184
Bulgaria,2010,sp,014,3,1,4
Bulgaria,2010,sp,1524,42,40,82
Bulgaria,2010,sp,2534,59,115,174
Bulgaria,2010,sp,3544,43,143,186
Bulgaria,2010,sp,4554,23,133,156
Bulgaria,2010,sp,5564,15,90,105
Bulgaria,2010,sp,65,34,65,99
Bulgaria,2011,ep,014,69,88,157
Bulgaria,2011,ep,1524,27,33,60
Bulgaria,2011,ep,2534,21,39,60
Bulgaria,2011,ep,3544,20,32,52
Bulgaria,2011,ep,4554,26,32,58
Bulgaria,2011,ep,5564,50,43,93
Bulgaria,2011,ep,65,66,82,148
Bulgaria,2011,sn,014,6,6,12
Bulgaria,2011,sn,1524,20,35,55
Bulgaria,2011,sn,2534,44,68,112
Bulgaria,2011,sn,3544,49,78,127
Bulgaria,2011,sn,4554,37,81,118
Bulgaria,2011,sn,5564,36,94,130
Bulgaria,2011,sn,65,56,97,153
Bulgaria,2011,sp,014,2,2,4
Bulgaria,2011,sp,1524,41,38,79
Bulgaria,2011,sp,2534,40,100,140
Bulgaria,2011,sp,3544,36,110,146
Bulgaria,2011,sp,4554,28,122,150
Bulgaria,2011,sp,5564,14,92,106
Bulgaria,2011,sp,65,30,61,91
Bulgaria,2012,ep,014,80,87,167
Bulgaria,2012,ep,1524,23,31,54
Bulgaria,2012,ep,2534,11,36,47
Bulgaria,2012,ep,3544,21,26,47
Bulgaria,2012,ep,4554,28,37,65
Bulgaria,2012,ep,5564,30,46,76
Bulgaria,2012,ep,65,64,86,150
Bulgaria,2012,sn,014,3,6,9
Bulgaria,2012,sn,1524,16,30,46
Bulgaria,2012,sn,2534,40,58,98
Bulgaria,2012,sn,3544,40,62,102
Bulgaria,2012,sn,4554,28,73,101
Bulgaria,2012,sn,5564,32,90,122
Bulgaria,2012,sn,65,47,93,140
Bulgaria,2012,sp,014,0,0,0
Bulgaria,2012,sp,1524,37,46,83
Bulgaria,2012,sp,2534,50,89,139
Bulgaria,2012,sp,3544,44,130,174
Bulgaria,2012,sp,4554,24,131,155
Bulgaria,2012,sp,5564,16,82,98
Bulgaria,2012,sp,65,35,57,92
Bulgaria,2013,rel,014,82,64,146
Bulgaria,2013,rel,1524,73,89,162
Bulgaria,2013,rel,2534,102,196,298
Bulgaria,2013,rel,3544,111,218,329
Bulgaria,2013,rel,4554,81,247,328
Bulgaria,2013,rel,5564,62,240,302
Bulgaria,2013,rel,65,137,228,365
Burkina Faso,1995,sp,014,7,4,11
Burkina Faso,1995,sp,1524,76,67,143
Burkina Faso,1995,sp,2534,53,133,186
Burkina Faso,1995,sp,3544,39,124,163
Burkina Faso,1995,sp,4554,26,62,88
Burkina Faso,1995,sp,5564,11,48,59
Burkina Faso,1995,sp,65,10,29,39
Burkina Faso,1996,sp,014,10,3,13
Burkina Faso,1996,sp,1524,51,47,98
Burkina Faso,1996,sp,2534,97,161,258
Burkina Faso,1996,sp,3544,67,148,215
Burkina Faso,1996,sp,4554,58,115,173
Burkina Faso,1996,sp,5564,31,65,96
Burkina Faso,1996,sp,65,10,36,46
Burkina Faso,1997,sp,014,10,3,13
Burkina Faso,1997,sp,1524,51,47,98
Burkina Faso,1997,sp,2534,97,161,258
Burkina Faso,1997,sp,3544,67,148,215
Burkina Faso,1997,sp,4554,58,115,173
Burkina Faso,1997,sp,5564,31,65,96
Burkina Faso,1997,sp,65,10,36,46
Burkina Faso,1998,sp,014,9,4,13
Burkina Faso,1998,sp,1524,83,104,187
Burkina Faso,1998,sp,2534,98,270,368
Burkina Faso,1998,sp,3544,86,236,322
Burkina Faso,1998,sp,4554,82,159,241
Burkina Faso,1998,sp,5564,32,89,121
Burkina Faso,1998,sp,65,14,65,79
Burkina Faso,1999,sp,014,8,13,21
Burkina Faso,1999,sp,1524,67,85,152
Burkina Faso,1999,sp,2534,141,247,388
Burkina Faso,1999,sp,3544,92,216,308
Burkina Faso,1999,sp,4554,63,118,181
Burkina Faso,1999,sp,5564,39,83,122
Burkina Faso,1999,sp,65,20,56,76
Burkina Faso,2000,sp,014,7,12,19
Burkina Faso,2000,sp,1524,59,91,150
Burkina Faso,2000,sp,2534,128,274,402
Burkina Faso,2000,sp,3544,101,252,353
Burkina Faso,2000,sp,4554,45,133,178
Burkina Faso,2000,sp,5564,38,68,106
Burkina Faso,2000,sp,65,14,65,79
Burkina Faso,2001,sp,014,17,7,24
Burkina Faso,2001,sp,1524,80,124,204
Burkina Faso,2001,sp,2534,155,283,438
Burkina Faso,2001,sp,3544,100,279,379
Burkina Faso,2001,sp,4554,49,168,217
Burkina Faso,2001,sp,5564,32,122,154
Burkina Faso,2001,sp,65,32,70,102
Burkina Faso,2002,sp,014,12,6,18
Burkina Faso,2002,sp,1524,85,123,208
Burkina Faso,2002,sp,2534,159,273,432
Burkina Faso,2002,sp,3544,104,266,370
Burkina Faso,2002,sp,4554,80,156,236
Burkina Faso,2002,sp,5564,30,124,154
Burkina Faso,2002,sp,65,25,83,108
Burkina Faso,2003,sp,014,19,14,33
Burkina Faso,2003,sp,1524,102,148,250
Burkina Faso,2003,sp,2534,131,313,444
Burkina Faso,2003,sp,3544,132,321,453
Burkina Faso,2003,sp,4554,70,162,232
Burkina Faso,2003,sp,5564,46,129,175
Burkina Faso,2003,sp,65,36,80,116
Burkina Faso,2004,sp,014,22,10,32
Burkina Faso,2004,sp,1524,109,155,264
Burkina Faso,2004,sp,2534,196,375,571
Burkina Faso,2004,sp,3544,148,308,456
Burkina Faso,2004,sp,4554,72,204,276
Burkina Faso,2004,sp,5564,54,138,192
Burkina Faso,2004,sp,65,33,102,135
Burkina Faso,2005,sp,014,15,18,33
Burkina Faso,2005,sp,1524,125,181,306
Burkina Faso,2005,sp,2534,248,430,678
Burkina Faso,2005,sp,3544,174,370,544
Burkina Faso,2005,sp,4554,109,273,382
Burkina Faso,2005,sp,5564,54,144,198
Burkina Faso,2005,sp,65,40,113,153
Burkina Faso,2006,sp,014,33,13,46
Burkina Faso,2006,sp,1524,155,227,382
Burkina Faso,2006,sp,2534,252,473,725
Burkina Faso,2006,sp,3544,198,433,631
Burkina Faso,2006,sp,4554,99,307,406
Burkina Faso,2006,sp,5564,99,183,282
Burkina Faso,2006,sp,65,47,140,187
Burkina Faso,2007,ep,014,20,27,47
Burkina Faso,2007,ep,1524,30,49,79
Burkina Faso,2007,ep,2534,68,59,127
Burkina Faso,2007,ep,3544,44,51,95
Burkina Faso,2007,ep,4554,26,53,79
Burkina Faso,2007,ep,5564,14,30,44
Burkina Faso,2007,ep,65,15,27,42
Burkina Faso,2007,sn,014,29,42,71
Burkina Faso,2007,sn,1524,22,22,44
Burkina Faso,2007,sn,2534,52,62,114
Burkina Faso,2007,sn,3544,54,68,122
Burkina Faso,2007,sn,4554,34,66,100
Burkina Faso,2007,sn,5564,24,35,59
Burkina Faso,2007,sn,65,17,50,67
Burkina Faso,2007,sp,014,29,8,37
Burkina Faso,2007,sp,1524,157,233,390
Burkina Faso,2007,sp,2534,243,442,685
Burkina Faso,2007,sp,3544,187,429,616
Burkina Faso,2007,sp,4554,129,303,432
Burkina Faso,2007,sp,5564,88,176,264
Burkina Faso,2007,sp,65,45,145,190
Burkina Faso,2008,sp,014,33,8,41
Burkina Faso,2008,sp,1524,143,225,368
Burkina Faso,2008,sp,2534,250,555,805
Burkina Faso,2008,sp,3544,180,448,628
Burkina Faso,2008,sp,4554,116,314,430
Burkina Faso,2008,sp,5564,107,174,281
Burkina Faso,2008,sp,65,57,146,203
Burkina Faso,2009,sp,014,38,27,65
Burkina Faso,2009,sp,1524,156,221,377
Burkina Faso,2009,sp,2534,269,592,861
Burkina Faso,2009,sp,3544,209,467,676
Burkina Faso,2009,sp,4554,154,336,490
Burkina Faso,2009,sp,5564,96,230,326
Burkina Faso,2009,sp,65,77,189,266
Burkina Faso,2010,sp,014,33,20,53
Burkina Faso,2010,sp,1524,158,231,389
Burkina Faso,2010,sp,2534,259,620,879
Burkina Faso,2010,sp,3544,198,493,691
Burkina Faso,2010,sp,4554,124,328,452
Burkina Faso,2010,sp,5564,97,224,321
Burkina Faso,2010,sp,65,83,173,256
Burkina Faso,2011,sp,014,31,22,53
Burkina Faso,2011,sp,1524,163,265,428
Burkina Faso,2011,sp,2534,277,708,985
Burkina Faso,2011,sp,3544,221,582,803
Burkina Faso,2011,sp,4554,146,375,521
Burkina Faso,2011,sp,5564,110,262,372
Burkina Faso,2011,sp,65,92,196,288
Burkina Faso,2012,sp,014,27,25,52
Burkina Faso,2012,sp,1524,160,277,437
Burkina Faso,2012,sp,2534,288,769,1057
Burkina Faso,2012,sp,3544,191,631,822
Burkina Faso,2012,sp,4554,156,423,579
Burkina Faso,2012,sp,5564,106,250,356
Burkina Faso,2012,sp,65,82,198,280
Burkina Faso,2013,rel,014,32,22,54
Burkina Faso,2013,rel,1524,163,274,437
Burkina Faso,2013,rel,2534,251,828,1079
Burkina Faso,2013,rel,3544,190,671,861
Burkina Faso,2013,rel,4554,134,416,550
Burkina Faso,2013,rel,5564,95,252,347
Burkina Faso,2013,rel,65,76,212,288
Burundi,1995,sp,014,19,5,24
Burundi,1995,sp,1524,109,128,237
Burundi,1995,sp,2534,124,238,362
Burundi,1995,sp,3544,89,224,313
Burundi,1995,sp,4554,33,73,106
Burundi,1995,sp,5564,12,32,44
Burundi,1995,sp,65,4,19,23
Burundi,1996,sp,014,18,16,34
Burundi,1996,sp,1524,132,217,349
Burundi,1996,sp,2534,203,283,486
Burundi,1996,sp,3544,112,274,386
Burundi,1996,sp,4554,53,116,169
Burundi,1996,sp,5564,16,41,57
Burundi,1996,sp,65,7,17,24
Burundi,1997,sp,014,30,21,51
Burundi,1997,sp,1524,189,208,397
Burundi,1997,sp,2534,265,446,711
Burundi,1997,sp,3544,198,431,629
Burundi,1997,sp,4554,71,198,269
Burundi,1997,sp,5564,39,79,118
Burundi,1997,sp,65,19,32,51
Burundi,1998,sp,014,49,45,94
Burundi,1998,sp,1524,265,301,566
Burundi,1998,sp,2534,321,527,848
Burundi,1998,sp,3544,240,530,770
Burundi,1998,sp,4554,126,319,445
Burundi,1998,sp,5564,47,102,149
Burundi,1998,sp,65,16,33,49
Burundi,1999,sp,014,66,64,130
Burundi,1999,sp,1524,291,349,640
Burundi,1999,sp,2534,253,566,819
Burundi,1999,sp,3544,236,492,728
Burundi,1999,sp,4554,109,281,390
Burundi,1999,sp,5564,30,102,132
Burundi,1999,sp,65,28,57,85
Burundi,2001,sp,014,81,34,115
Burundi,2001,sp,1524,369,344,713
Burundi,2001,sp,2534,364,559,923
Burundi,2001,sp,3544,337,469,806
Burundi,2001,sp,4554,86,238,324
Burundi,2001,sp,5564,30,75,105
Burundi,2001,sp,65,15,39,54
Burundi,2002,sp,014,48,16,64
Burundi,2002,sp,1524,243,310,553
Burundi,2002,sp,2534,242,470,712
Burundi,2002,sp,3544,324,520,844
Burundi,2002,sp,4554,152,270,422
Burundi,2002,sp,5564,24,97,121
Burundi,2002,sp,65,23,52,75
Burundi,2003,sp,014,75,32,107
Burundi,2003,sp,1524,308,348,656
Burundi,2003,sp,2534,361,572,933
Burundi,2003,sp,3544,276,488,764
Burundi,2003,sp,4554,119,260,379
Burundi,2003,sp,5564,27,106,133
Burundi,2003,sp,65,10,35,45
Burundi,2004,sp,014,51,24,75
Burundi,2004,sp,1524,325,352,677
Burundi,2004,sp,2534,370,674,1044
Burundi,2004,sp,3544,232,468,700
Burundi,2004,sp,4554,114,292,406
Burundi,2004,sp,5564,40,78,118
Burundi,2004,sp,65,19,48,67
Burundi,2005,sp,014,46,34,80
Burundi,2005,sp,1524,298,352,650
Burundi,2005,sp,2534,399,591,990
Burundi,2005,sp,3544,288,525,813
Burundi,2005,sp,4554,122,372,494
Burundi,2005,sp,5564,36,111,147
Burundi,2005,sp,65,33,55,88
Burundi,2006,sp,014,41,30,71
Burundi,2006,sp,1524,296,347,643
Burundi,2006,sp,2534,367,600,967
Burundi,2006,sp,3544,242,488,730
Burundi,2006,sp,4554,140,320,460
Burundi,2006,sp,5564,56,114,170
Burundi,2006,sp,65,14,64,78
Burundi,2007,ep,014,0,0,0
Burundi,2007,ep,1524,0,0,0
Burundi,2007,ep,2534,0,0,0
Burundi,2007,ep,3544,0,0,0
Burundi,2007,ep,4554,0,0,0
Burundi,2007,ep,5564,0,0,0
Burundi,2007,ep,65,0,0,0
Burundi,2007,sn,014,0,0,0
Burundi,2007,sn,1524,0,0,0
Burundi,2007,sn,2534,0,0,0
Burundi,2007,sn,3544,0,0,0
Burundi,2007,sn,4554,0,0,0
Burundi,2007,sn,5564,0,0,0
Burundi,2007,sn,65,0,0,0
Burundi,2007,sp,014,55,26,81
Burundi,2007,sp,1524,360,425,785
Burundi,2007,sp,2534,392,637,1029
Burundi,2007,sp,3544,276,542,818
Burundi,2007,sp,4554,140,372,512
Burundi,2007,sp,5564,67,177,244
Burundi,2007,sp,65,38,88,126
Burundi,2008,sp,014,38,30,68
Burundi,2008,sp,1524,335,430,765
Burundi,2008,sp,2534,340,684,1024
Burundi,2008,sp,3544,264,526,790
Burundi,2008,sp,4554,139,459,598
Burundi,2008,sp,5564,72,175,247
Burundi,2008,sp,65,38,80,118
Burundi,2009,sp,014,50,34,84
Burundi,2009,sp,1524,326,452,778
Burundi,2009,sp,2534,397,717,1114
Burundi,2009,sp,3544,309,584,893
Burundi,2009,sp,4554,157,468,625
Burundi,2009,sp,5564,83,240,323
Burundi,2009,sp,65,40,117,157
Burundi,2010,ep,014,214,245,459
Burundi,2010,ep,1524,117,125,242
Burundi,2010,ep,2534,197,191,388
Burundi,2010,ep,3544,143,182,325
Burundi,2010,ep,4554,86,153,239
Burundi,2010,ep,5564,43,70,113
Burundi,2010,ep,65,16,44,60
Burundi,2010,sn,014,33,43,76
Burundi,2010,sn,1524,55,57,112
Burundi,2010,sn,2534,84,108,192
Burundi,2010,sn,3544,84,131,215
Burundi,2010,sn,4554,77,119,196
Burundi,2010,sn,5564,29,78,107
Burundi,2010,sn,65,22,43,65
Burundi,2010,sp,014,78,56,134
Burundi,2010,sp,1524,390,481,871
Burundi,2010,sp,2534,421,773,1194
Burundi,2010,sp,3544,332,651,983
Burundi,2010,sp,4554,225,570,795
Burundi,2010,sp,5564,99,270,369
Burundi,2010,sp,65,87,157,244
Burundi,2011,ep,014,159,188,347
Burundi,2011,ep,1524,118,132,250
Burundi,2011,ep,2534,171,199,370
Burundi,2011,ep,3544,128,177,305
Burundi,2011,ep,4554,67,135,202
Burundi,2011,ep,5564,43,64,107
Burundi,2011,ep,65,25,43,68
Burundi,2011,sn,014,17,18,35
Burundi,2011,sn,1524,53,49,102
Burundi,2011,sn,2534,63,81,144
Burundi,2011,sn,3544,57,107,164
Burundi,2011,sn,4554,45,103,148
Burundi,2011,sn,5564,36,60,96
Burundi,2011,sn,65,36,60,96
Burundi,2011,sp,014,56,37,93
Burundi,2011,sp,1524,345,484,829
Burundi,2011,sp,2534,374,743,1117
Burundi,2011,sp,3544,263,620,883
Burundi,2011,sp,4554,180,504,684
Burundi,2011,sp,5564,81,235,316
Burundi,2011,sp,65,40,98,138
Burundi,2012,ep,014,177,188,365
Burundi,2012,ep,1524,152,141,293
Burundi,2012,ep,2534,167,229,396
Burundi,2012,ep,3544,143,195,338
Burundi,2012,ep,4554,89,173,262
Burundi,2012,ep,5564,47,96,143
Burundi,2012,ep,65,37,53,90
Burundi,2012,sn,014,19,22,41
Burundi,2012,sn,1524,46,56,102
Burundi,2012,sn,2534,46,121,167
Burundi,2012,sn,3544,67,90,157
Burundi,2012,sn,4554,41,82,123
Burundi,2012,sn,5564,32,63,95
Burundi,2012,sn,65,27,34,61
Burundi,2012,sp,014,74,45,119
Burundi,2012,sp,1524,338,447,785
Burundi,2012,sp,2534,367,801,1168
Burundi,2012,sp,3544,283,667,950
Burundi,2012,sp,4554,162,461,623
Burundi,2012,sp,5564,64,233,297
Burundi,2012,sp,65,30,103,133
Burundi,2013,rel,014,266,262,528
Burundi,2013,rel,1524,534,679,1213
Burundi,2013,rel,2534,658,1204,1862
Burundi,2013,rel,3544,461,1071,1532
Burundi,2013,rel,4554,336,803,1139
Burundi,2013,rel,5564,179,426,605
Burundi,2013,rel,65,126,244,370
Cabo Verde,1997,sp,014,2,0,2
Cabo Verde,1997,sp,1524,10,11,21
Cabo Verde,1997,sp,2534,10,16,26
Cabo Verde,1997,sp,3544,8,19,27
Cabo Verde,1997,sp,4554,3,4,7
Cabo Verde,1997,sp,5564,10,10,20
Cabo Verde,1997,sp,65,9,10,19
Cabo Verde,1998,sp,014,2,2,4
Cabo Verde,1998,sp,1524,12,9,21
Cabo Verde,1998,sp,2534,4,14,18
Cabo Verde,1998,sp,3544,5,14,19
Cabo Verde,1998,sp,4554,3,6,9
Cabo Verde,1998,sp,5564,5,6,11
Cabo Verde,1998,sp,65,10,9,19
Cabo Verde,2001,sp,014,2,0,2
Cabo Verde,2001,sp,1524,7,5,12
Cabo Verde,2001,sp,2534,9,15,24
Cabo Verde,2001,sp,3544,7,6,13
Cabo Verde,2001,sp,4554,1,5,6
Cabo Verde,2001,sp,5564,2,5,7
Cabo Verde,2001,sp,65,3,1,4
Cabo Verde,2002,sp,014,2,3,5
Cabo Verde,2002,sp,1524,11,9,20
Cabo Verde,2002,sp,2534,11,29,40
Cabo Verde,2002,sp,3544,12,20,32
Cabo Verde,2002,sp,4554,3,14,17
Cabo Verde,2002,sp,5564,4,1,5
Cabo Verde,2002,sp,65,4,2,6
Cabo Verde,2003,sp,014,1,3,4
Cabo Verde,2003,sp,1524,6,12,18
Cabo Verde,2003,sp,2534,7,32,39
Cabo Verde,2003,sp,3544,13,32,45
Cabo Verde,2003,sp,4554,7,9,16
Cabo Verde,2003,sp,5564,4,7,11
Cabo Verde,2003,sp,65,11,8,19
Cabo Verde,2004,sp,014,2,1,3
Cabo Verde,2004,sp,1524,17,8,25
Cabo Verde,2004,sp,2534,34,33,67
Cabo Verde,2004,sp,3544,11,17,28
Cabo Verde,2004,sp,4554,7,20,27
Cabo Verde,2004,sp,5564,6,2,8
Cabo Verde,2004,sp,65,4,7,11
Cabo Verde,2005,sp,014,2,0,2
Cabo Verde,2005,sp,1524,9,22,31
Cabo Verde,2005,sp,2534,16,23,39
Cabo Verde,2005,sp,3544,4,26,30
Cabo Verde,2005,sp,4554,5,9,14
Cabo Verde,2005,sp,5564,3,2,5
Cabo Verde,2005,sp,65,6,8,14
Cabo Verde,2006,sp,014,2,2,4
Cabo Verde,2006,sp,1524,14,15,29
Cabo Verde,2006,sp,2534,16,22,38
Cabo Verde,2006,sp,3544,5,18,23
Cabo Verde,2006,sp,4554,6,8,14
Cabo Verde,2006,sp,5564,4,6,10
Cabo Verde,2006,sp,65,9,4,13
Cabo Verde,2007,sp,014,0,0,0
Cabo Verde,2007,sp,1524,18,24,42
Cabo Verde,2007,sp,2534,17,30,47
Cabo Verde,2007,sp,3544,5,26,31
Cabo Verde,2007,sp,4554,1,18,19
Cabo Verde,2007,sp,5564,3,4,7
Cabo Verde,2007,sp,65,6,6,12
Cabo Verde,2008,sp,014,6,0,6
Cabo Verde,2008,sp,1524,18,23,41
Cabo Verde,2008,sp,2534,21,33,54
Cabo Verde,2008,sp,3544,11,29,40
Cabo Verde,2008,sp,4554,3,27,30
Cabo Verde,2008,sp,5564,5,12,17
Cabo Verde,2008,sp,65,3,6,9
Cabo Verde,2009,ep,014,1,2,3
Cabo Verde,2009,ep,1524,3,5,8
Cabo Verde,2009,ep,2534,2,11,13
Cabo Verde,2009,ep,3544,3,8,11
Cabo Verde,2009,ep,4554,3,9,12
Cabo Verde,2009,ep,5564,1,2,3
Cabo Verde,2009,ep,65,0,3,3
Cabo Verde,2009,sn,014,4,7,11
Cabo Verde,2009,sn,1524,4,3,7
Cabo Verde,2009,sn,2534,10,12,22
Cabo Verde,2009,sn,3544,6,14,20
Cabo Verde,2009,sn,4554,10,11,21
Cabo Verde,2009,sn,5564,3,6,9
Cabo Verde,2009,sn,65,2,2,4
Cabo Verde,2009,sp,014,4,1,5
Cabo Verde,2009,sp,1524,13,27,40
Cabo Verde,2009,sp,2534,10,40,50
Cabo Verde,2009,sp,3544,8,31,39
Cabo Verde,2009,sp,4554,4,19,23
Cabo Verde,2009,sp,5564,1,3,4
Cabo Verde,2009,sp,65,5,6,11
Cabo Verde,2011,ep,014,1,4,5
Cabo Verde,2011,ep,1524,4,7,11
Cabo Verde,2011,ep,2534,7,13,20
Cabo Verde,2011,ep,3544,4,7,11
Cabo Verde,2011,ep,4554,3,5,8
Cabo Verde,2011,ep,5564,2,0,2
Cabo Verde,2011,ep,65,0,0,0
Cabo Verde,2011,sn,014,6,17,23
Cabo Verde,2011,sn,1524,4,9,13
Cabo Verde,2011,sn,2534,5,18,23
Cabo Verde,2011,sn,3544,4,17,21
Cabo Verde,2011,sn,4554,6,17,23
Cabo Verde,2011,sn,5564,1,7,8
Cabo Verde,2011,sn,65,5,11,16
Cabo Verde,2011,sp,014,4,0,4
Cabo Verde,2011,sp,1524,14,17,31
Cabo Verde,2011,sp,2534,15,43,58
Cabo Verde,2011,sp,3544,4,35,39
Cabo Verde,2011,sp,4554,6,31,37
Cabo Verde,2011,sp,5564,3,3,6
Cabo Verde,2011,sp,65,4,3,7
Cabo Verde,2012,ep,014,5,6,11
Cabo Verde,2012,ep,1524,5,9,14
Cabo Verde,2012,ep,2534,6,11,17
Cabo Verde,2012,ep,3544,3,6,9
Cabo Verde,2012,ep,4554,1,7,8
Cabo Verde,2012,ep,5564,1,3,4
Cabo Verde,2012,ep,65,3,0,3
Cabo Verde,2012,sn,014,10,11,21
Cabo Verde,2012,sn,1524,6,15,21
Cabo Verde,2012,sn,2534,6,19,25
Cabo Verde,2012,sn,3544,5,18,23
Cabo Verde,2012,sn,4554,6,11,17
Cabo Verde,2012,sn,5564,1,8,9
Cabo Verde,2012,sn,65,4,10,14
Cabo Verde,2012,sp,014,0,0,0
Cabo Verde,2012,sp,1524,19,29,48
Cabo Verde,2012,sp,2534,13,36,49
Cabo Verde,2012,sp,3544,9,34,43
Cabo Verde,2012,sp,4554,8,24,32
Cabo Verde,2012,sp,5564,3,8,11
Cabo Verde,2012,sp,65,4,2,6
Cabo Verde,2013,rel,014,2,0,2
Cabo Verde,2013,rel,1524,12,23,35
Cabo Verde,2013,rel,2534,12,46,58
Cabo Verde,2013,rel,3544,10,29,39
Cabo Verde,2013,rel,4554,4,20,24
Cabo Verde,2013,rel,5564,5,9,14
Cabo Verde,2013,rel,65,4,9,13
Cambodia,1995,sp,014,123,161,284
Cambodia,1995,sp,1524,388,453,841
Cambodia,1995,sp,2534,1133,1244,2377
Cambodia,1995,sp,3544,1435,1147,2582
Cambodia,1995,sp,4554,1426,1253,2679
Cambodia,1995,sp,5564,1180,1257,2437
Cambodia,1995,sp,65,578,707,1285
Cambodia,1996,sp,014,124,148,272
Cambodia,1996,sp,1524,27,32,59
Cambodia,1996,sp,2534,1087,1272,2359
Cambodia,1996,sp,3544,1430,1363,2793
Cambodia,1996,sp,4554,1534,1348,2882
Cambodia,1996,sp,5564,1201,1226,2427
Cambodia,1996,sp,65,547,726,1273
Cambodia,1998,sp,014,23,36,59
Cambodia,1998,sp,1524,367,446,813
Cambodia,1998,sp,2534,1184,1330,2514
Cambodia,1998,sp,3544,1531,1477,3008
Cambodia,1998,sp,4554,1667,1521,3188
Cambodia,1998,sp,5564,1359,1293,2652
Cambodia,1998,sp,65,691,924,1615
Cambodia,1999,sp,014,51,41,92
Cambodia,1999,sp,1524,445,525,970
Cambodia,1999,sp,2534,1229,1389,2618
Cambodia,1999,sp,3544,1861,1734,3595
Cambodia,1999,sp,4554,1857,1645,3502
Cambodia,1999,sp,5564,1448,1578,3026
Cambodia,1999,sp,65,852,1089,1941
Cambodia,2000,sp,014,38,26,64
Cambodia,2000,sp,1524,457,519,976
Cambodia,2000,sp,2534,1157,1323,2480
Cambodia,2000,sp,3544,1649,1618,3267
Cambodia,2000,sp,4554,1798,1456,3254
Cambodia,2000,sp,5564,1459,1373,2832
Cambodia,2000,sp,65,892,1058,1950
Cambodia,2001,sp,014,25,29,54
Cambodia,2001,sp,1524,455,600,1055
Cambodia,2001,sp,2534,1033,1302,2335
Cambodia,2001,sp,3544,1526,1601,3127
Cambodia,2001,sp,4554,1687,1406,3093
Cambodia,2001,sp,5564,1428,1403,2831
Cambodia,2001,sp,65,829,1037,1866
Cambodia,2002,sp,014,54,54,108
Cambodia,2002,sp,1524,600,791,1391
Cambodia,2002,sp,2534,1114,1449,2563
Cambodia,2002,sp,3544,1737,1956,3693
Cambodia,2002,sp,4554,1898,1799,3697
Cambodia,2002,sp,5564,1650,1624,3274
Cambodia,2002,sp,65,1100,1432,2532
Cambodia,2003,sp,014,46,37,83
Cambodia,2003,sp,1524,691,805,1496
Cambodia,2003,sp,2534,1287,1514,2801
Cambodia,2003,sp,3544,1975,2183,4158
Cambodia,2003,sp,4554,2208,1848,4056
Cambodia,2003,sp,5564,1857,1729,3586
Cambodia,2003,sp,65,1256,1487,2743
Cambodia,2004,sp,014,28,36,64
Cambodia,2004,sp,1524,658,850,1508
Cambodia,2004,sp,2534,1276,1466,2742
Cambodia,2004,sp,3544,1882,2261,4143
Cambodia,2004,sp,4554,2176,1942,4118
Cambodia,2004,sp,5564,1836,1759,3595
Cambodia,2004,sp,65,1270,1538,2808
Cambodia,2005,sp,014,45,49,94
Cambodia,2005,sp,1524,790,894,1684
Cambodia,2005,sp,2534,1413,1600,3013
Cambodia,2005,sp,3544,2089,2349,4438
Cambodia,2005,sp,4554,2323,2043,4366
Cambodia,2005,sp,5564,2058,1964,4022
Cambodia,2005,sp,65,1573,1811,3384
Cambodia,2006,sp,014,44,50,94
Cambodia,2006,sp,1524,749,791,1540
Cambodia,2006,sp,2534,1330,1486,2816
Cambodia,2006,sp,3544,1839,2205,4044
Cambodia,2006,sp,4554,2072,1902,3974
Cambodia,2006,sp,5564,1915,1689,3604
Cambodia,2006,sp,65,1557,1665,3222
Cambodia,2007,sp,014,64,50,114
Cambodia,2007,sp,1524,749,883,1632
Cambodia,2007,sp,2534,1351,1526,2877
Cambodia,2007,sp,3544,1698,2190,3888
Cambodia,2007,sp,4554,2105,2102,4207
Cambodia,2007,sp,5564,1839,1761,3600
Cambodia,2007,sp,65,1459,1644,3103
Cambodia,2008,sp,014,72,49,121
Cambodia,2008,sp,1524,808,920,1728
Cambodia,2008,sp,2534,1403,1570,2973
Cambodia,2008,sp,3544,1809,2040,3849
Cambodia,2008,sp,4554,2093,2117,4210
Cambodia,2008,sp,5564,1943,1746,3689
Cambodia,2008,sp,65,1607,1683,3290
Cambodia,2009,sp,014,45,37,82
Cambodia,2009,sp,1524,801,746,1547
Cambodia,2009,sp,2534,1252,1522,2774
Cambodia,2009,sp,3544,1461,1884,3345
Cambodia,2009,sp,4554,1894,2117,4011
Cambodia,2009,sp,5564,1637,1543,3180
Cambodia,2009,sp,65,1376,1548,2924
Cambodia,2010,sp,014,60,39,99
Cambodia,2010,sp,1524,752,750,1502
Cambodia,2010,sp,2534,1321,1564,2885
Cambodia,2010,sp,3544,1303,1760,3063
Cambodia,2010,sp,4554,1732,2105,3837
Cambodia,2010,sp,5564,1607,1531,3138
Cambodia,2010,sp,65,1331,1599,2930
Cambodia,2011,sp,014,39,34,73
Cambodia,2011,sp,1524,690,791,1481
Cambodia,2011,sp,2534,1211,1469,2680
Cambodia,2011,sp,3544,1092,1557,2649
Cambodia,2011,sp,4554,1528,1972,3500
Cambodia,2011,sp,5564,1473,1439,2912
Cambodia,2011,sp,65,1242,1339,2581
Cambodia,2012,sp,014,22,31,53
Cambodia,2012,sp,1524,612,673,1285
Cambodia,2012,sp,2534,1088,1256,2344
Cambodia,2012,sp,3544,957,1414,2371
Cambodia,2012,sp,4554,1424,1904,3328
Cambodia,2012,sp,5564,1302,1434,2736
Cambodia,2012,sp,65,1198,1526,2724
Cambodia,2013,rel,014,32,32,64
Cambodia,2013,rel,1524,540,583,1123
Cambodia,2013,rel,2534,1079,1213,2292
Cambodia,2013,rel,3544,893,1316,2209
Cambodia,2013,rel,4554,1319,1825,3144
Cambodia,2013,rel,5564,1264,1373,2637
Cambodia,2013,rel,65,1247,1367,2614
Cameroon,1995,sp,014,9,20,29
Cameroon,1995,sp,1524,185,208,393
Cameroon,1995,sp,2534,313,569,882
Cameroon,1995,sp,3544,223,323,546
Cameroon,1995,sp,4554,153,287,440
Cameroon,1995,sp,5564,106,204,310
Cameroon,1995,sp,65,93,164,257
Cameroon,1996,sp,014,21,34,55
Cameroon,1996,sp,1524,123,151,274
Cameroon,1996,sp,2534,388,735,1123
Cameroon,1996,sp,3544,202,291,493
Cameroon,1996,sp,4554,103,178,281
Cameroon,1996,sp,5564,24,38,62
Cameroon,1996,sp,65,8,17,25
Cameroon,1997,sp,014,25,36,61
Cameroon,1997,sp,1524,277,321,598
Cameroon,1997,sp,2534,522,1011,1533
Cameroon,1997,sp,3544,341,387,728
Cameroon,1997,sp,4554,179,269,448
Cameroon,1997,sp,5564,63,79,142
Cameroon,1997,sp,65,14,24,38
Cameroon,1998,sp,014,30,15,45
Cameroon,1998,sp,1524,443,651,1094
Cameroon,1998,sp,2534,595,1006,1601
Cameroon,1998,sp,3544,268,787,1055
Cameroon,1998,sp,4554,112,262,374
Cameroon,1998,sp,5564,53,87,140
Cameroon,1998,sp,65,30,35,65
Cameroon,1999,sp,014,47,49,96
Cameroon,1999,sp,1524,506,602,1108
Cameroon,1999,sp,2534,783,1595,2378
Cameroon,1999,sp,3544,505,736,1241
Cameroon,1999,sp,4554,235,433,668
Cameroon,1999,sp,5564,95,166,261
Cameroon,1999,sp,65,21,59,80
Cameroon,2000,sp,014,63,41,104
Cameroon,2000,sp,1524,368,518,886
Cameroon,2000,sp,2534,530,842,1372
Cameroon,2000,sp,3544,293,584,877
Cameroon,2000,sp,4554,139,284,423
Cameroon,2000,sp,5564,60,130,190
Cameroon,2000,sp,65,33,75,108
Cameroon,2001,sp,014,49,24,73
Cameroon,2001,sp,1524,482,643,1125
Cameroon,2001,sp,2534,609,1000,1609
Cameroon,2001,sp,3544,328,732,1060
Cameroon,2001,sp,4554,155,322,477
Cameroon,2001,sp,5564,62,154,216
Cameroon,2001,sp,65,50,86,136
Cameroon,2002,sp,014,59,66,125
Cameroon,2002,sp,1524,950,818,1768
Cameroon,2002,sp,2534,1053,1335,2388
Cameroon,2002,sp,3544,545,1117,1662
Cameroon,2002,sp,4554,236,619,855
Cameroon,2002,sp,5564,140,258,398
Cameroon,2002,sp,65,44,125,169
Cameroon,2003,sp,014,136,100,236
Cameroon,2003,sp,1524,1273,1176,2449
Cameroon,2003,sp,2534,1542,2274,3816
Cameroon,2003,sp,3544,745,1516,2261
Cameroon,2003,sp,4554,363,788,1151
Cameroon,2003,sp,5564,217,330,547
Cameroon,2003,sp,65,72,160,232
Cameroon,2004,sp,014,181,127,308
Cameroon,2004,sp,1524,1310,1312,2622
Cameroon,2004,sp,2534,1449,2147,3596
Cameroon,2004,sp,3544,756,1575,2331
Cameroon,2004,sp,4554,412,928,1340
Cameroon,2004,sp,5564,214,408,622
Cameroon,2004,sp,65,140,259,399
Cameroon,2005,sp,014,226,134,360
Cameroon,2005,sp,1524,1467,1472,2939
Cameroon,2005,sp,2534,1788,2482,4270
Cameroon,2005,sp,3544,1028,1766,2794
Cameroon,2005,sp,4554,503,1035,1538
Cameroon,2005,sp,5564,205,463,668
Cameroon,2005,sp,65,143,289,432
Cameroon,2006,sp,014,151,112,263
Cameroon,2006,sp,1524,1358,1401,2759
Cameroon,2006,sp,2534,1823,2550,4373
Cameroon,2006,sp,3544,960,1820,2780
Cameroon,2006,sp,4554,470,1080,1550
Cameroon,2006,sp,5564,266,437,703
Cameroon,2006,sp,65,142,300,442
Cameroon,2007,sp,014,152,121,273
Cameroon,2007,sp,1524,1443,1392,2835
Cameroon,2007,sp,2534,1963,2613,4576
Cameroon,2007,sp,3544,985,1874,2859
Cameroon,2007,sp,4554,483,1011,1494
Cameroon,2007,sp,5564,248,480,728
Cameroon,2007,sp,65,148,307,455
Cameroon,2008,sp,014,173,108,281
Cameroon,2008,sp,1524,1506,1613,3119
Cameroon,2008,sp,2534,2041,2861,4902
Cameroon,2008,sp,3544,1027,2016,3043
Cameroon,2008,sp,4554,568,1135,1703
Cameroon,2008,sp,5564,234,526,760
Cameroon,2008,sp,65,148,281,429
Cameroon,2009,sp,014,155,107,262
Cameroon,2009,sp,1524,1521,1635,3156
Cameroon,2009,sp,2534,1997,2822,4819
Cameroon,2009,sp,3544,1123,2029,3152
Cameroon,2009,sp,4554,529,1245,1774
Cameroon,2009,sp,5564,245,567,812
Cameroon,2009,sp,65,157,355,512
Cameroon,2010,sp,014,172,106,278
Cameroon,2010,sp,1524,1474,1497,2971
Cameroon,2010,sp,2534,2031,2750,4781
Cameroon,2010,sp,3544,1121,1996,3117
Cameroon,2010,sp,4554,642,1314,1956
Cameroon,2010,sp,5564,290,559,849
Cameroon,2010,sp,65,183,329,512
Cameroon,2011,sp,014,178,114,292
Cameroon,2011,sp,1524,1461,1580,3041
Cameroon,2011,sp,2534,2022,2931,4953
Cameroon,2011,sp,3544,1177,2139,3316
Cameroon,2011,sp,4554,581,1283,1864
Cameroon,2011,sp,5564,281,625,906
Cameroon,2011,sp,65,194,361,555
Cameroon,2012,sp,014,184,108,292
Cameroon,2012,sp,1524,1417,1597,3014
Cameroon,2012,sp,2534,2053,2900,4953
Cameroon,2012,sp,3544,1177,2182,3359
Cameroon,2012,sp,4554,579,1304,1883
Cameroon,2012,sp,5564,295,658,953
Cameroon,2012,sp,65,187,375,562
Cameroon,2013,rel,014,176,115,291
Canada,1980,sp,014,18,12,30
Canada,1980,sp,1524,62,54,116
Canada,1980,sp,2534,51,75,126
Canada,1980,sp,3544,34,83,117
Canada,1980,sp,4554,31,100,131
Canada,1980,sp,5564,33,108,141
Canada,1980,sp,65,104,186,290
Canada,1981,sp,014,6,8,14
Canada,1981,sp,1524,46,49,95
Canada,1981,sp,2534,57,61,118
Canada,1981,sp,3544,26,64,90
Canada,1981,sp,4554,28,87,115
Canada,1981,sp,5564,35,103,138
Canada,1981,sp,65,92,141,233
Canada,1982,sp,014,7,6,13
Canada,1982,sp,1524,51,52,103
Canada,1982,sp,2534,57,66,123
Canada,1982,sp,3544,30,69,99
Canada,1982,sp,4554,25,90,115
Canada,1982,sp,5564,38,91,129
Canada,1982,sp,65,80,150,230
Canada,1983,sp,014,11,9,20
Canada,1983,sp,1524,50,47,97
Canada,1983,sp,2534,50,63,113
Canada,1983,sp,3544,29,62,91
Canada,1983,sp,4554,24,90,114
Canada,1983,sp,5564,35,92,127
Canada,1983,sp,65,86,123,209
Canada,1984,sp,014,9,3,12
Canada,1984,sp,1524,51,44,95
Canada,1984,sp,2534,59,75,134
Canada,1984,sp,3544,28,58,86
Canada,1984,sp,4554,28,68,96
Canada,1984,sp,5564,36,83,119
Canada,1984,sp,65,100,169,269
Canada,1985,sp,014,5,11,16
Canada,1985,sp,1524,30,42,72
Canada,1985,sp,2534,56,70,126
Canada,1985,sp,3544,19,59,78
Canada,1985,sp,4554,28,77,105
Canada,1985,sp,5564,48,81,129
Canada,1985,sp,65,97,168,265
Canada,1986,sp,014,10,9,19
Canada,1986,sp,1524,33,58,91
Canada,1986,sp,2534,54,73,127
Canada,1986,sp,3544,33,62,95
Canada,1986,sp,4554,20,59,79
Canada,1986,sp,5564,26,73,99
Canada,1986,sp,65,95,147,242
Canada,1987,sp,014,8,9,17
Canada,1987,sp,1524,39,40,79
Canada,1987,sp,2534,48,71,119
Canada,1987,sp,3544,29,60,89
Canada,1987,sp,4554,17,49,66
Canada,1987,sp,5564,26,64,90
Canada,1987,sp,65,79,129,208
Canada,1988,sp,014,6,4,10
Canada,1988,sp,1524,38,43,81
Canada,1988,sp,2534,56,73,129
Canada,1988,sp,3544,27,62,89
Canada,1988,sp,4554,16,52,68
Canada,1988,sp,5564,26,68,94
Canada,1988,sp,65,80,131,211
Canada,1989,sp,014,6,10,16
Canada,1989,sp,1524,37,45,82
Canada,1989,sp,2534,51,56,107
Canada,1989,sp,3544,23,60,83
Canada,1989,sp,4554,24,54,78
Canada,1989,sp,5564,21,62,83
Canada,1989,sp,65,81,122,203
Canada,1990,sp,014,1,3,4
Canada,1990,sp,1524,30,35,65
Canada,1990,sp,2534,38,70,108
Canada,1990,sp,3544,26,55,81
Canada,1990,sp,4554,17,40,57
Canada,1990,sp,5564,20,42,62
Canada,1990,sp,65,72,100,172
Canada,1991,sp,014,4,7,11
Canada,1991,sp,1524,23,37,60
Canada,1991,sp,2534,37,79,116
Canada,1991,sp,3544,31,53,84
Canada,1991,sp,4554,9,37,46
Canada,1991,sp,5564,20,36,56
Canada,1991,sp,65,60,110,170
Canada,1992,sp,014,2,6,8
Canada,1992,sp,1524,27,42,69
Canada,1992,sp,2534,28,47,75
Canada,1992,sp,3544,21,58,79
Canada,1992,sp,4554,11,41,52
Canada,1992,sp,5564,15,51,66
Canada,1992,sp,65,78,79,157
Canada,1993,sp,014,6,8,14
Canada,1993,sp,1524,22,33,55
Canada,1993,sp,2534,50,47,97
Canada,1993,sp,3544,22,53,75
Canada,1993,sp,4554,21,43,64
Canada,1993,sp,5564,21,33,54
Canada,1993,sp,65,55,74,129
Canada,1994,sp,014,3,2,5
Canada,1994,sp,1524,37,42,79
Canada,1994,sp,2534,37,54,91
Canada,1994,sp,3544,19,42,61
Canada,1994,sp,4554,11,43,54
Canada,1994,sp,5564,13,34,47
Canada,1994,sp,65,59,87,146
Canada,1995,sp,014,7,1,8
Canada,1995,sp,1524,33,28,61
Canada,1995,sp,2534,28,31,59
Canada,1995,sp,3544,22,60,82
Canada,1995,sp,4554,12,34,46
Canada,1995,sp,5564,18,41,59
Canada,1995,sp,65,51,70,121
Canada,1996,sp,014,2,3,5
Canada,1996,sp,1524,23,28,51
Canada,1996,sp,2534,34,49,83
Canada,1996,sp,3544,28,48,76
Canada,1996,sp,4554,14,31,45
Canada,1996,sp,5564,16,34,50
Canada,1996,sp,65,50,70,120
Canada,1997,sp,014,1,0,1
Canada,1997,sp,1524,36,21,57
Canada,1997,sp,2534,44,55,99
Canada,1997,sp,3544,26,44,70
Canada,1997,sp,4554,13,30,43
Canada,1997,sp,5564,16,44,60
Canada,1997,sp,65,53,90,143
Canada,1998,sp,014,1,4,5
Canada,1998,sp,1524,26,33,59
Canada,1998,sp,2534,31,43,74
Canada,1998,sp,3544,26,51,77
Canada,1998,sp,4554,14,31,45
Canada,1998,sp,5564,18,26,44
Canada,1998,sp,65,54,80,134
Canada,1999,sp,014,4,0,4
Canada,1999,sp,1524,33,23,56
Canada,1999,sp,2534,31,47,78
Canada,1999,sp,3544,28,51,79
Canada,1999,sp,4554,13,36,49
Canada,1999,sp,5564,11,33,44
Canada,1999,sp,65,51,94,145
Canada,2000,sp,014,4,5,9
Canada,2000,sp,1524,33,34,67
Canada,2000,sp,2534,40,45,85
Canada,2000,sp,3544,30,46,76
Canada,2000,sp,4554,25,41,66
Canada,2000,sp,5564,12,32,44
Canada,2000,sp,65,66,79,145
Canada,2001,sp,014,5,6,11
Canada,2001,sp,1524,23,24,47
Canada,2001,sp,2534,41,49,90
Canada,2001,sp,3544,33,56,89
Canada,2001,sp,4554,16,40,56
Canada,2001,sp,5564,14,22,36
Canada,2001,sp,65,53,76,129
Canada,2002,sp,014,6,0,6
Canada,2002,sp,1524,32,25,57
Canada,2002,sp,2534,31,34,65
Canada,2002,sp,3544,26,50,76
Canada,2002,sp,4554,17,34,51
Canada,2002,sp,5564,17,27,44
Canada,2002,sp,65,45,64,109
Canada,2003,sp,014,3,1,4
Canada,2003,sp,1524,21,26,47
Canada,2003,sp,2534,28,36,64
Canada,2003,sp,3544,25,37,62
Canada,2003,sp,4554,15,32,47
Canada,2003,sp,5564,9,21,30
Canada,2003,sp,65,36,42,78
Canada,2004,sp,014,0,2,2
Canada,2004,sp,1524,34,25,59
Canada,2004,sp,2534,55,34,89
Canada,2004,sp,3544,34,38,72
Canada,2004,sp,4554,19,32,51
Canada,2004,sp,5564,22,31,53
Canada,2004,sp,65,48,64,112
Canada,2005,sp,014,6,3,9
Canada,2005,sp,1524,28,37,65
Canada,2005,sp,2534,40,45,85
Canada,2005,sp,3544,27,44,71
Canada,2005,sp,4554,24,40,64
Canada,2005,sp,5564,13,20,33
Canada,2005,sp,65,37,68,105
Canada,2006,ep,014,7,6,13
Canada,2006,ep,1524,30,19,49
Canada,2006,ep,2534,46,42,88
Canada,2006,ep,3544,41,43,84
Canada,2006,ep,4554,33,20,53
Canada,2006,ep,5564,29,14,43
Canada,2006,ep,65,32,40,72
Canada,2006,sn,014,39,43,82
Canada,2006,sn,1524,40,60,100
Canada,2006,sn,2534,41,25,66
Canada,2006,sn,3544,46,52,98
Canada,2006,sn,4554,23,42,65
Canada,2006,sn,5564,24,29,53
Canada,2006,sn,65,51,71,122
Canada,2006,sp,014,4,2,6
Canada,2006,sp,1524,39,34,73
Canada,2006,sp,2534,30,34,64
Canada,2006,sp,3544,25,33,58
Canada,2006,sp,4554,16,42,58
Canada,2006,sp,5564,6,26,32
Canada,2006,sp,65,52,64,116
Canada,2007,ep,014,22,36,58
Canada,2007,ep,1524,21,29,50
Canada,2007,ep,2534,55,32,87
Canada,2007,ep,3544,47,49,96
Canada,2007,ep,4554,39,29,68
Canada,2007,ep,5564,30,25,55
Canada,2007,ep,65,37,33,70
Canada,2007,sn,014,16,14,30
Canada,2007,sn,1524,34,36,70
Canada,2007,sn,2534,33,38,71
Canada,2007,sn,3544,36,38,74
Canada,2007,sn,4554,20,29,49
Canada,2007,sn,5564,12,28,40
Canada,2007,sn,65,60,55,115
Canada,2007,sp,014,2,5,7
Canada,2007,sp,1524,32,31,63
Canada,2007,sp,2534,33,41,74
Canada,2007,sp,3544,33,51,84
Canada,2007,sp,4554,11,50,61
Canada,2007,sp,5564,13,35,48
Canada,2007,sp,65,51,75,126
Canada,2008,ep,014,19,24,43
Canada,2008,ep,1524,32,18,50
Canada,2008,ep,2534,44,39,83
Canada,2008,ep,3544,39,38,77
Canada,2008,ep,4554,20,34,54
Canada,2008,ep,5564,16,14,30
Canada,2008,ep,65,41,38,79
Canada,2008,sn,014,20,15,35
Canada,2008,sn,1524,24,30,54
Canada,2008,sn,2534,51,44,95
Canada,2008,sn,3544,40,40,80
Canada,2008,sn,4554,28,28,56
Canada,2008,sn,5564,13,34,47
Canada,2008,sn,65,40,59,99
Canada,2008,sp,014,3,2,5
Canada,2008,sp,1524,36,39,75
Canada,2008,sp,2534,39,36,75
Canada,2008,sp,3544,39,49,88
Canada,2008,sp,4554,27,53,80
Canada,2008,sp,5564,20,38,58
Canada,2008,sp,65,45,62,107
Canada,2009,ep,014,28,29,57
Canada,2009,ep,1524,24,26,50
Canada,2009,ep,2534,50,39,89
Canada,2009,ep,3544,42,42,84
Canada,2009,ep,4554,32,37,69
Canada,2009,ep,5564,28,23,51
Canada,2009,ep,65,32,34,66
Canada,2009,sn,014,12,12,24
Canada,2009,sn,1524,45,44,89
Canada,2009,sn,2534,50,49,99
Canada,2009,sn,3544,39,51,90
Canada,2009,sn,4554,20,41,61
Canada,2009,sn,5564,16,29,45
Canada,2009,sn,65,47,64,111
Canada,2009,sp,014,3,2,5
Canada,2009,sp,1524,19,45,64
Canada,2009,sp,2534,39,41,80
Canada,2009,sp,3544,28,53,81
Canada,2009,sp,4554,27,55,82
Canada,2009,sp,5564,20,30,50
Canada,2009,sp,65,42,58,100
Canada,2010,ep,014,13,12,25
Canada,2010,ep,1524,22,25,47
Canada,2010,ep,2534,66,29,95
Canada,2010,ep,3544,45,43,88
Canada,2010,ep,4554,37,30,67
Canada,2010,ep,5564,30,16,46
Canada,2010,ep,65,38,38,76
Canada,2010,sn,014,8,6,14
Canada,2010,sn,1524,19,22,41
Canada,2010,sn,2534,43,39,82
Canada,2010,sn,3544,34,55,89
Canada,2010,sn,4554,26,40,66
Canada,2010,sn,5564,17,38,55
Canada,2010,sn,65,50,75,125
Canada,2010,sp,014,1,3,4
Canada,2010,sp,1524,28,30,58
Canada,2010,sp,2534,24,28,52
Canada,2010,sp,3544,16,36,52
Canada,2010,sp,4554,10,32,42
Canada,2010,sp,5564,19,25,44
Canada,2010,sp,65,44,62,106
Canada,2011,ep,014,19,18,37
Canada,2011,ep,1524,24,28,52
Canada,2011,ep,2534,66,37,103
Canada,2011,ep,3544,50,44,94
Canada,2011,ep,4554,30,32,62
Canada,2011,ep,5564,32,18,50
Canada,2011,ep,65,33,38,71
Canada,2011,sn,014,14,18,32
Canada,2011,sn,1524,34,34,68
Canada,2011,sn,2534,49,45,94
Canada,2011,sn,3544,26,31,57
Canada,2011,sn,4554,22,38,60
Canada,2011,sn,5564,13,23,36
Canada,2011,sn,65,49,60,109
Canada,2011,sp,014,3,2,5
Canada,2011,sp,1524,23,34,57
Canada,2011,sp,2534,29,36,65
Canada,2011,sp,3544,28,31,59
Canada,2011,sp,4554,14,40,54
Canada,2011,sp,5564,9,33,42
Canada,2011,sp,65,55,70,125
Canada,2012,ep,014,24,28,52
Canada,2012,ep,1524,34,41,75
Canada,2012,ep,2534,45,52,97
Canada,2012,ep,3544,52,43,95
Canada,2012,ep,4554,35,31,66
Canada,2012,ep,5564,19,28,47
Canada,2012,ep,65,34,53,87
Canada,2012,sn,014,21,28,49
Canada,2012,sn,1524,40,46,86
Canada,2012,sn,2534,57,57,114
Canada,2012,sn,3544,35,38,73
Canada,2012,sn,4554,27,54,81
Canada,2012,sn,5564,12,35,47
Canada,2012,sn,65,45,79,124
Canada,2012,sp,014,6,1,7
Canada,2012,sp,1524,32,33,65
Canada,2012,sp,2534,34,32,66
Canada,2012,sp,3544,29,53,82
Canada,2012,sp,4554,19,51,70
Canada,2012,sp,5564,11,35,46
Canada,2012,sp,65,45,97,142
Canada,2013,rel,014,47,61,108
Canada,2013,rel,1524,85,117,202
Canada,2013,rel,2534,161,110,271
Canada,2013,rel,3544,125,119,244
Canada,2013,rel,4554,92,142,234
Canada,2013,rel,5564,62,127,189
Canada,2013,rel,65,164,226,390
Cayman Islands,1998,sp,014,0,0,0
Cayman Islands,1998,sp,1524,0,0,0
Cayman Islands,1998,sp,2534,1,0,1
Cayman Islands,1998,sp,3544,0,0,0
Cayman Islands,1998,sp,4554,0,0,0
Cayman Islands,1998,sp,5564,0,0,0
Cayman Islands,1998,sp,65,0,1,1
Cayman Islands,1999,sp,014,0,0,0
Cayman Islands,1999,sp,1524,1,0,1
Cayman Islands,1999,sp,2534,0,0,0
Cayman Islands,1999,sp,3544,0,1,1
Cayman Islands,1999,sp,4554,0,0,0
Cayman Islands,1999,sp,5564,0,0,0
Cayman Islands,1999,sp,65,0,0,0
Cayman Islands,2000,sp,014,NA,0,NA
Cayman Islands,2000,sp,1524,NA,0,NA
Cayman Islands,2000,sp,2534,NA,3,NA
Cayman Islands,2000,sp,3544,NA,1,NA
Cayman Islands,2000,sp,4554,NA,0,NA
Cayman Islands,2000,sp,5564,NA,1,NA
Cayman Islands,2000,sp,65,NA,0,NA
Cayman Islands,2001,sp,014,NA,0,NA
Cayman Islands,2001,sp,1524,NA,0,NA
Cayman Islands,2001,sp,2534,NA,1,NA
Cayman Islands,2001,sp,3544,NA,0,NA
Cayman Islands,2001,sp,4554,NA,0,NA
Cayman Islands,2001,sp,5564,NA,0,NA
Cayman Islands,2001,sp,65,NA,0,NA
Cayman Islands,2003,sp,014,0,0,0
Cayman Islands,2003,sp,1524,0,0,0
Cayman Islands,2003,sp,2534,0,0,0
Cayman Islands,2003,sp,3544,0,0,0
Cayman Islands,2003,sp,4554,0,0,0
Cayman Islands,2003,sp,5564,0,0,0
Cayman Islands,2003,sp,65,0,0,0
Cayman Islands,2004,sp,014,0,0,0
Cayman Islands,2004,sp,1524,0,0,0
Cayman Islands,2004,sp,2534,0,0,0
Cayman Islands,2004,sp,3544,1,0,1
Cayman Islands,2004,sp,4554,0,0,0
Cayman Islands,2004,sp,5564,0,0,0
Cayman Islands,2004,sp,65,0,0,0
Cayman Islands,2006,ep,014,0,0,0
Cayman Islands,2006,ep,1524,0,0,0
Cayman Islands,2006,ep,2534,0,0,0
Cayman Islands,2006,ep,3544,0,0,0
Cayman Islands,2006,ep,4554,0,0,0
Cayman Islands,2006,ep,5564,0,0,0
Cayman Islands,2006,ep,65,0,0,0
Cayman Islands,2006,sn,014,0,0,0
Cayman Islands,2006,sn,1524,0,0,0
Cayman Islands,2006,sn,2534,0,0,0
Cayman Islands,2006,sn,3544,0,0,0
Cayman Islands,2006,sn,4554,0,0,0
Cayman Islands,2006,sn,5564,0,0,0
Cayman Islands,2006,sn,65,0,0,0
Cayman Islands,2006,sp,014,0,0,0
Cayman Islands,2006,sp,1524,0,0,0
Cayman Islands,2006,sp,2534,0,0,0
Cayman Islands,2006,sp,3544,0,0,0
Cayman Islands,2006,sp,4554,0,0,0
Cayman Islands,2006,sp,5564,0,0,0
Cayman Islands,2006,sp,65,0,0,0
Cayman Islands,2007,ep,014,0,0,0
Cayman Islands,2007,ep,1524,0,0,0
Cayman Islands,2007,ep,2534,0,0,0
Cayman Islands,2007,ep,3544,0,0,0
Cayman Islands,2007,ep,4554,0,0,0
Cayman Islands,2007,ep,5564,0,0,0
Cayman Islands,2007,ep,65,0,0,0
Cayman Islands,2007,sn,014,0,0,0
Cayman Islands,2007,sn,1524,0,0,0
Cayman Islands,2007,sn,2534,0,0,0
Cayman Islands,2007,sn,3544,0,0,0
Cayman Islands,2007,sn,4554,0,0,0
Cayman Islands,2007,sn,5564,0,0,0
Cayman Islands,2007,sn,65,0,0,0
Cayman Islands,2007,sp,014,0,0,0
Cayman Islands,2007,sp,1524,0,0,0
Cayman Islands,2007,sp,2534,0,0,0
Cayman Islands,2007,sp,3544,0,0,0
Cayman Islands,2007,sp,4554,0,0,0
Cayman Islands,2007,sp,5564,0,1,1
Cayman Islands,2007,sp,65,0,0,0
Cayman Islands,2010,ep,014,0,0,0
Cayman Islands,2010,ep,1524,0,0,0
Cayman Islands,2010,ep,2534,0,0,0
Cayman Islands,2010,ep,3544,0,0,0
Cayman Islands,2010,ep,4554,0,0,0
Cayman Islands,2010,ep,5564,0,0,0
Cayman Islands,2010,ep,65,0,0,0
Cayman Islands,2010,sn,014,0,0,0
Cayman Islands,2010,sn,1524,0,0,0
Cayman Islands,2010,sn,2534,1,0,1
Cayman Islands,2010,sn,3544,0,1,1
Cayman Islands,2010,sn,4554,0,0,0
Cayman Islands,2010,sn,5564,0,0,0
Cayman Islands,2010,sn,65,0,0,0
Cayman Islands,2010,sp,014,0,0,0
Cayman Islands,2010,sp,1524,0,0,0
Cayman Islands,2010,sp,2534,0,0,0
Cayman Islands,2010,sp,3544,0,1,1
Cayman Islands,2010,sp,4554,1,0,1
Cayman Islands,2010,sp,5564,0,0,0
Cayman Islands,2010,sp,65,0,0,0
Cayman Islands,2011,ep,014,0,0,0
Cayman Islands,2011,ep,1524,0,0,0
Cayman Islands,2011,ep,2534,0,0,0
Cayman Islands,2011,ep,3544,0,0,0
Cayman Islands,2011,ep,4554,0,0,0
Cayman Islands,2011,ep,5564,0,0,0
Cayman Islands,2011,ep,65,0,0,0
Cayman Islands,2011,sn,014,0,0,0
Cayman Islands,2011,sn,1524,0,0,0
Cayman Islands,2011,sn,2534,0,0,0
Cayman Islands,2011,sn,3544,0,0,0
Cayman Islands,2011,sn,4554,0,1,1
Cayman Islands,2011,sn,5564,0,0,0
Cayman Islands,2011,sn,65,0,0,0
Cayman Islands,2011,sp,014,0,0,0
Cayman Islands,2011,sp,1524,0,0,0
Cayman Islands,2011,sp,2534,0,0,0
Cayman Islands,2011,sp,3544,0,0,0
Cayman Islands,2011,sp,4554,0,0,0
Cayman Islands,2011,sp,5564,0,1,1
Cayman Islands,2011,sp,65,0,0,0
Cayman Islands,2012,ep,014,0,0,0
Cayman Islands,2012,ep,1524,0,0,0
Cayman Islands,2012,ep,2534,0,0,0
Cayman Islands,2012,ep,3544,0,0,0
Cayman Islands,2012,ep,4554,0,0,0
Cayman Islands,2012,ep,5564,0,0,0
Cayman Islands,2012,ep,65,0,0,0
Cayman Islands,2012,sn,014,0,0,0
Cayman Islands,2012,sn,1524,0,0,0
Cayman Islands,2012,sn,2534,0,0,0
Cayman Islands,2012,sn,3544,0,0,0
Cayman Islands,2012,sn,4554,1,0,1
Cayman Islands,2012,sn,5564,0,0,0
Cayman Islands,2012,sn,65,0,0,0
Cayman Islands,2012,sp,014,0,0,0
Cayman Islands,2012,sp,1524,0,0,0
Cayman Islands,2012,sp,2534,0,2,2
Cayman Islands,2012,sp,3544,0,2,2
Cayman Islands,2012,sp,4554,0,1,1
Cayman Islands,2012,sp,5564,0,0,0
Cayman Islands,2012,sp,65,0,0,0
Cayman Islands,2013,rel,014,0,0,0
Cayman Islands,2013,rel,1524,1,0,1
Cayman Islands,2013,rel,2534,1,0,1
Cayman Islands,2013,rel,3544,0,2,2
Cayman Islands,2013,rel,4554,0,1,1
Cayman Islands,2013,rel,5564,0,0,0
Cayman Islands,2013,rel,65,0,0,0
Central African Republic,1995,sp,014,39,38,77
Central African Republic,1995,sp,1524,233,162,395
Central African Republic,1995,sp,2534,350,356,706
Central African Republic,1995,sp,3544,145,206,351
Central African Republic,1995,sp,4554,57,120,177
Central African Republic,1995,sp,5564,21,40,61
Central African Republic,1995,sp,65,9,18,27
Central African Republic,1996,sp,014,52,46,98
Central African Republic,1996,sp,1524,273,192,465
Central African Republic,1996,sp,2534,346,385,731
Central African Republic,1996,sp,3544,177,234,411
Central African Republic,1996,sp,4554,62,94,156
Central African Republic,1996,sp,5564,45,57,102
Central African Republic,1996,sp,65,6,15,21
Central African Republic,1997,sp,014,53,54,107
Central African Republic,1997,sp,1524,301,211,512
Central African Republic,1997,sp,2534,394,403,797
Central African Republic,1997,sp,3544,207,282,489
Central African Republic,1997,sp,4554,100,144,244
Central African Republic,1997,sp,5564,23,65,88
Central African Republic,1997,sp,65,10,26,36
Central African Republic,1998,sp,014,67,28,95
Central African Republic,1998,sp,1524,353,205,558
Central African Republic,1998,sp,2534,476,482,958
Central African Republic,1998,sp,3544,217,328,545
Central African Republic,1998,sp,4554,115,157,272
Central African Republic,1998,sp,5564,61,76,137
Central African Republic,1998,sp,65,26,46,72
Central African Republic,1999,sp,014,72,28,100
Central African Republic,1999,sp,1524,376,224,600
Central African Republic,1999,sp,2534,498,529,1027
Central African Republic,1999,sp,3544,196,367,563
Central African Republic,1999,sp,4554,86,123,209
Central African Republic,1999,sp,5564,52,67,119
Central African Republic,1999,sp,65,42,65,107
Central African Republic,2001,sp,014,25,15,40
Central African Republic,2001,sp,1524,179,127,306
Central African Republic,2001,sp,2534,236,279,515
Central African Republic,2001,sp,3544,123,171,294
Central African Republic,2001,sp,4554,64,78,142
Central African Republic,2001,sp,5564,23,45,68
Central African Republic,2001,sp,65,1,16,17
Central African Republic,2002,sp,014,66,76,142
Central African Republic,2002,sp,1524,315,264,579
Central African Republic,2002,sp,2534,402,462,864
Central African Republic,2002,sp,3544,262,414,676
Central African Republic,2002,sp,4554,139,154,293
Central African Republic,2002,sp,5564,82,82,164
Central African Republic,2002,sp,65,18,22,40
Central African Republic,2004,sp,014,14,12,26
Central African Republic,2004,sp,1524,60,58,118
Central African Republic,2004,sp,2534,430,694,1124
Central African Republic,2004,sp,3544,559,575,1134
Central African Republic,2004,sp,4554,181,241,422
Central African Republic,2004,sp,5564,46,30,76
Central African Republic,2004,sp,65,9,14,23
Central African Republic,2005,sp,014,30,29,59
Central African Republic,2005,sp,1524,32,40,72
Central African Republic,2005,sp,2534,420,1136,1556
Central African Republic,2005,sp,3544,145,160,305
Central African Republic,2005,sp,4554,30,26,56
Central African Republic,2005,sp,5564,40,35,75
Central African Republic,2005,sp,65,15,15,30
Central African Republic,2006,ep,014,47,46,93
Central African Republic,2006,ep,1524,86,116,202
Central African Republic,2006,ep,2534,708,107,815
Central African Republic,2006,ep,3544,47,72,119
Central African Republic,2006,ep,4554,5,15,20
Central African Republic,2006,ep,5564,3,8,11
Central African Republic,2006,ep,65,1,0,1
Central African Republic,2006,sn,014,6,12,18
Central African Republic,2006,sn,1524,99,127,226
Central African Republic,2006,sn,2534,150,172,322
Central African Republic,2006,sn,3544,36,81,117
Central African Republic,2006,sn,4554,5,8,13
Central African Republic,2006,sn,5564,4,5,9
Central African Republic,2006,sn,65,1,1,2
Central African Republic,2006,sp,014,52,48,100
Central African Republic,2006,sp,1524,538,409,947
Central African Republic,2006,sp,2534,613,770,1383
Central African Republic,2006,sp,3544,647,923,1570
Central African Republic,2006,sp,4554,126,152,278
Central African Republic,2006,sp,5564,42,83,125
Central African Republic,2006,sp,65,16,30,46
Central African Republic,2008,sp,014,102,68,170
Central African Republic,2008,sp,1524,481,466,947
Central African Republic,2008,sp,2534,673,643,1316
Central African Republic,2008,sp,3544,378,515,893
Central African Republic,2008,sp,4554,196,276,472
Central African Republic,2008,sp,5564,136,160,296
Central African Republic,2008,sp,65,57,81,138
Central African Republic,2009,sp,014,137,124,261
Central African Republic,2009,sp,1524,611,546,1157
Central African Republic,2009,sp,2534,723,850,1573
Central African Republic,2009,sp,3544,426,662,1088
Central African Republic,2009,sp,4554,228,351,579
Central African Republic,2009,sp,5564,128,184,312
Central African Republic,2009,sp,65,68,94,162
Central African Republic,2010,ep,014,157,206,363
Central African Republic,2010,ep,1524,78,79,157
Central African Republic,2010,ep,2534,140,84,224
Central African Republic,2010,ep,3544,96,84,180
Central African Republic,2010,ep,4554,39,55,94
Central African Republic,2010,ep,5564,19,18,37
Central African Republic,2010,ep,65,9,11,20
Central African Republic,2010,sn,014,139,144,283
Central African Republic,2010,sn,1524,171,130,301
Central African Republic,2010,sn,2534,214,154,368
Central African Republic,2010,sn,3544,146,171,317
Central African Republic,2010,sn,4554,72,108,180
Central African Republic,2010,sn,5564,42,56,98
Central African Republic,2010,sn,65,12,39,51
Central African Republic,2010,sp,014,88,78,166
Central African Republic,2010,sp,1524,367,379,746
Central African Republic,2010,sp,2534,576,633,1209
Central African Republic,2010,sp,3544,319,468,787
Central African Republic,2010,sp,4554,155,251,406
Central African Republic,2010,sp,5564,73,135,208
Central African Republic,2010,sp,65,44,63,107
Central African Republic,2011,ep,014,138,166,304
Central African Republic,2011,ep,1524,78,49,127
Central African Republic,2011,ep,2534,117,90,207
Central African Republic,2011,ep,3544,59,61,120
Central African Republic,2011,ep,4554,30,37,67
Central African Republic,2011,ep,5564,13,18,31
Central African Republic,2011,ep,65,8,11,19
Central African Republic,2011,sn,014,104,87,191
Central African Republic,2011,sn,1524,88,52,140
Central African Republic,2011,sn,2534,163,120,283
Central African Republic,2011,sn,3544,77,126,203
Central African Republic,2011,sn,4554,36,43,79
Central African Republic,2011,sn,5564,25,25,50
Central African Republic,2011,sn,65,8,9,17
Central African Republic,2011,sp,014,96,70,166
Central African Republic,2011,sp,1524,382,362,744
Central African Republic,2011,sp,2534,530,576,1106
Central African Republic,2011,sp,3544,289,467,756
Central African Republic,2011,sp,4554,162,269,431
Central African Republic,2011,sp,5564,62,119,181
Central African Republic,2011,sp,65,26,59,85
Central African Republic,2012,sp,014,101,73,174
Central African Republic,2012,sp,1524,511,502,1013
Central African Republic,2012,sp,2534,689,799,1488
Central African Republic,2012,sp,3544,370,660,1030
Central African Republic,2012,sp,4554,191,360,551
Central African Republic,2012,sp,5564,96,158,254
Central African Republic,2012,sp,65,39,92,131
Central African Republic,2013,rel,014,93,54,147
Central African Republic,2013,rel,1524,496,479,975
Central African Republic,2013,rel,2534,626,714,1340
Central African Republic,2013,rel,3544,343,568,911
Central African Republic,2013,rel,4554,170,349,519
Central African Republic,2013,rel,5564,71,140,211
Central African Republic,2013,rel,65,36,57,93
Chad,1999,sp,014,13,20,33
Chad,1999,sp,1524,28,172,200
Chad,1999,sp,2534,230,414,644
Chad,1999,sp,3544,458,957,1415
Chad,1999,sp,4554,78,477,555
Chad,1999,sp,5564,16,42,58
Chad,1999,sp,65,11,4,15
Chad,2002,sp,014,18,24,42
Chad,2002,sp,1524,28,90,118
Chad,2002,sp,2534,495,1029,1524
Chad,2002,sp,3544,500,794,1294
Chad,2002,sp,4554,187,269,456
Chad,2002,sp,5564,18,37,55
Chad,2002,sp,65,11,17,28
Chad,2003,sp,014,112,155,267
Chad,2003,sp,1524,206,256,462
Chad,2003,sp,2534,363,428,791
Chad,2003,sp,3544,497,549,1046
Chad,2003,sp,4554,259,303,562
Chad,2003,sp,5564,151,191,342
Chad,2003,sp,65,51,78,129
Chad,2004,sp,014,41,72,113
Chad,2004,sp,1524,89,141,230
Chad,2004,sp,2534,317,466,783
Chad,2004,sp,3544,262,415,677
Chad,2004,sp,4554,129,207,336
Chad,2004,sp,5564,25,61,86
Chad,2004,sp,65,16,29,45
Chad,2005,sp,014,28,25,53
Chad,2005,sp,1524,148,194,342
Chad,2005,sp,2534,298,535,833
Chad,2005,sp,3544,211,409,620
Chad,2005,sp,4554,148,229,377
Chad,2005,sp,5564,59,123,182
Chad,2005,sp,65,27,82,109
Chad,2008,sp,014,78,63,141
Chad,2008,sp,3544,777,1543,2320
Chad,2008,sp,4554,264,584,848
Chad,2009,sp,014,47,48,95
Chad,2009,sp,1524,256,355,611
Chad,2009,sp,2534,339,808,1147
Chad,2009,sp,3544,319,642,961
Chad,2009,sp,4554,196,336,532
Chad,2009,sp,5564,90,196,286
Chad,2009,sp,65,60,126,186
Chad,2010,ep,014,102,134,236
Chad,2010,ep,1524,86,135,221
Chad,2010,ep,2534,102,139,241
Chad,2010,ep,3544,81,138,219
Chad,2010,ep,4554,49,70,119
Chad,2010,ep,5564,35,44,79
Chad,2010,ep,65,21,52,73
Chad,2010,sn,014,140,168,308
Chad,2010,sn,1524,165,207,372
Chad,2010,sn,2534,238,408,646
Chad,2010,sn,3544,185,406,591
Chad,2010,sn,4554,94,245,339
Chad,2010,sn,5564,44,151,195
Chad,2010,sn,65,37,110,147
Chad,2010,sp,014,59,76,135
Chad,2010,sp,1524,274,382,656
Chad,2010,sp,2534,413,850,1263
Chad,2010,sp,3544,263,666,929
Chad,2010,sp,4554,158,379,537
Chad,2010,sp,5564,79,173,252
Chad,2010,sp,65,44,99,143
Chad,2011,ep,014,103,118,221
Chad,2011,ep,1524,65,99,164
Chad,2011,ep,2534,105,124,229
Chad,2011,ep,3544,62,104,166
Chad,2011,ep,4554,41,67,108
Chad,2011,ep,5564,33,52,85
Chad,2011,ep,65,21,39,60
Chad,2011,sn,014,143,177,320
Chad,2011,sn,1524,221,279,500
Chad,2011,sn,2534,263,438,701
Chad,2011,sn,3544,209,371,580
Chad,2011,sn,4554,99,225,324
Chad,2011,sn,5564,86,141,227
Chad,2011,sn,65,38,109,147
Chad,2011,sp,014,84,92,176
Chad,2011,sp,1524,296,469,765
Chad,2011,sp,2534,438,951,1389
Chad,2011,sp,3544,298,764,1062
Chad,2011,sp,4554,166,418,584
Chad,2011,sp,5564,109,184,293
Chad,2011,sp,65,44,121,165
Chad,2012,ep,014,96,148,244
Chad,2012,ep,1524,83,111,194
Chad,2012,ep,2534,97,151,248
Chad,2012,ep,3544,65,93,158
Chad,2012,ep,4554,47,78,125
Chad,2012,ep,5564,41,51,92
Chad,2012,ep,65,16,36,52
Chad,2012,sn,014,154,216,370
Chad,2012,sn,1524,235,288,523
Chad,2012,sn,2534,303,553,856
Chad,2012,sn,3544,225,502,727
Chad,2012,sn,4554,138,253,391
Chad,2012,sn,5564,105,175,280
Chad,2012,sn,65,66,114,180
Chad,2012,sp,014,51,68,119
Chad,2012,sp,1524,273,405,678
Chad,2012,sp,2534,403,842,1245
Chad,2012,sp,3544,227,634,861
Chad,2012,sp,4554,135,376,511
Chad,2012,sp,5564,91,210,301
Chad,2012,sp,65,46,88,134
Chad,2013,rel,014,396,471,867
Chad,2013,rel,1524,629,910,1539
Chad,2013,rel,2534,1075,1874,2949
Chad,2013,rel,3544,676,1599,2275
Chad,2013,rel,4554,609,1124,1733
Chad,2013,rel,5564,476,721,1197
Chad,2013,rel,65,236,441,677
Chile,1995,sp,014,24,24,48
Chile,1995,sp,1524,100,148,248
Chile,1995,sp,2534,120,182,302
Chile,1995,sp,3544,108,204,312
Chile,1995,sp,4554,75,155,230
Chile,1995,sp,5564,73,141,214
Chile,1995,sp,65,107,163,270
Chile,1996,sp,014,11,8,19
Chile,1996,sp,1524,88,123,211
Chile,1996,sp,2534,117,201,318
Chile,1996,sp,3544,72,207,279
Chile,1996,sp,4554,63,207,270
Chile,1996,sp,5564,47,125,172
Chile,1996,sp,65,72,139,211
Chile,1997,sp,014,11,11,22
Chile,1997,sp,1524,92,107,199
Chile,1997,sp,2534,121,182,303
Chile,1997,sp,3544,80,224,304
Chile,1997,sp,4554,66,165,231
Chile,1997,sp,5564,60,153,213
Chile,1997,sp,65,88,163,251
Chile,1999,sp,014,9,4,13
Chile,1999,sp,1524,87,118,205
Chile,1999,sp,2534,109,173,282
Chile,1999,sp,3544,97,204,301
Chile,1999,sp,4554,52,206,258
Chile,1999,sp,5564,76,132,208
Chile,1999,sp,65,98,132,230
Chile,2000,sp,014,10,6,16
Chile,2000,sp,1524,66,81,147
Chile,2000,sp,2534,96,160,256
Chile,2000,sp,3544,70,198,268
Chile,2000,sp,4554,54,150,204
Chile,2000,sp,5564,58,132,190
Chile,2000,sp,65,83,126,209
Chile,2001,sp,014,9,2,11
Chile,2001,sp,1524,69,78,147
Chile,2001,sp,2534,85,183,268
Chile,2001,sp,3544,76,213,289
Chile,2001,sp,4554,58,190,248
Chile,2001,sp,5564,55,116,171
Chile,2001,sp,65,83,138,221
Chile,2002,sp,014,7,6,13
Chile,2002,sp,1524,64,87,151
Chile,2002,sp,2534,91,163,254
Chile,2002,sp,3544,82,196,278
Chile,2002,sp,4554,76,193,269
Chile,2002,sp,5564,54,144,198
Chile,2002,sp,65,89,160,249
Chile,2003,sp,014,8,1,9
Chile,2003,sp,1524,59,77,136
Chile,2003,sp,2534,106,131,237
Chile,2003,sp,3544,81,181,262
Chile,2003,sp,4554,42,183,225
Chile,2003,sp,5564,41,150,191
Chile,2003,sp,65,80,136,216
Chile,2004,sp,014,5,3,8
Chile,2004,sp,1524,58,87,145
Chile,2004,sp,2534,74,148,222
Chile,2004,sp,3544,76,179,255
Chile,2004,sp,4554,57,187,244
Chile,2004,sp,5564,57,124,181
Chile,2004,sp,65,74,168,242
Chile,2005,sp,014,4,3,7
Chile,2005,sp,1524,55,74,129
Chile,2005,sp,2534,78,128,206
Chile,2005,sp,3544,60,179,239
Chile,2005,sp,4554,56,162,218
Chile,2005,sp,5564,36,115,151
Chile,2005,sp,65,93,133,226
Chile,2006,ep,014,15,14,29
Chile,2006,ep,1524,23,42,65
Chile,2006,ep,2534,36,51,87
Chile,2006,ep,3544,41,52,93
Chile,2006,ep,4554,37,62,99
Chile,2006,ep,5564,37,47,84
Chile,2006,ep,65,70,43,113
Chile,2006,sn,014,5,6,11
Chile,2006,sn,1524,12,14,26
Chile,2006,sn,2534,17,14,31
Chile,2006,sn,3544,6,21,27
Chile,2006,sn,4554,10,16,26
Chile,2006,sn,5564,4,10,14
Chile,2006,sn,65,12,21,33
Chile,2006,sp,014,7,12,19
Chile,2006,sp,1524,70,107,177
Chile,2006,sp,2534,91,140,231
Chile,2006,sp,3544,74,176,250
Chile,2006,sp,4554,95,197,292
Chile,2006,sp,5564,64,179,243
Chile,2006,sp,65,122,199,321
Chile,2007,ep,014,8,13,21
Chile,2007,ep,1524,23,37,60
Chile,2007,ep,2534,36,60,96
Chile,2007,ep,3544,46,66,112
Chile,2007,ep,4554,44,61,105
Chile,2007,ep,5564,56,51,107
Chile,2007,ep,65,60,43,103
Chile,2007,sn,014,11,4,15
Chile,2007,sn,1524,16,35,51
Chile,2007,sn,2534,29,49,78
Chile,2007,sn,3544,17,51,68
Chile,2007,sn,4554,23,61,84
Chile,2007,sn,5564,15,48,63
Chile,2007,sn,65,53,84,137
Chile,2007,sp,014,8,3,11
Chile,2007,sp,1524,59,86,145
Chile,2007,sp,2534,75,137,212
Chile,2007,sp,3544,63,140,203
Chile,2007,sp,4554,49,169,218
Chile,2007,sp,5564,39,139,178
Chile,2007,sp,65,78,121,199
Chile,2008,ep,014,5,16,21
Chile,2008,ep,1524,19,32,51
Chile,2008,ep,2534,45,68,113
Chile,2008,ep,3544,58,75,133
Chile,2008,ep,4554,42,65,107
Chile,2008,ep,5564,55,39,94
Chile,2008,ep,65,58,59,117
Chile,2008,sn,014,8,10,18
Chile,2008,sn,1524,21,41,62
Chile,2008,sn,2534,23,70,93
Chile,2008,sn,3544,15,49,64
Chile,2008,sn,4554,26,53,79
Chile,2008,sn,5564,20,51,71
Chile,2008,sn,65,52,86,138
Chile,2008,sp,014,3,7,10
Chile,2008,sp,1524,52,86,138
Chile,2008,sp,2534,86,131,217
Chile,2008,sp,3544,49,148,197
Chile,2008,sp,4554,37,167,204
Chile,2008,sp,5564,30,135,165
Chile,2008,sp,65,65,118,183
Chile,2009,ep,014,7,15,22
Chile,2009,ep,1524,22,36,58
Chile,2009,ep,2534,27,58,85
Chile,2009,ep,3544,46,49,95
Chile,2009,ep,4554,38,58,96
Chile,2009,ep,5564,43,31,74
Chile,2009,ep,65,61,58,119
Chile,2009,sn,014,12,8,20
Chile,2009,sn,1524,30,32,62
Chile,2009,sn,2534,19,41,60
Chile,2009,sn,3544,25,54,79
Chile,2009,sn,4554,24,50,74
Chile,2009,sn,5564,37,58,95
Chile,2009,sn,65,46,73,119
Chile,2009,sp,014,8,7,15
Chile,2009,sp,1524,51,85,136
Chile,2009,sp,2534,67,141,208
Chile,2009,sp,3544,68,147,215
Chile,2009,sp,4554,52,169,221
Chile,2009,sp,5564,49,109,158
Chile,2009,sp,65,59,140,199
Chile,2010,ep,014,16,12,28
Chile,2010,ep,1524,26,31,57
Chile,2010,ep,2534,41,69,110
Chile,2010,ep,3544,42,54,96
Chile,2010,ep,4554,37,56,93
Chile,2010,ep,5564,39,39,78
Chile,2010,ep,65,44,47,91
Chile,2010,sn,014,10,6,16
Chile,2010,sn,1524,22,23,45
Chile,2010,sn,2534,24,39,63
Chile,2010,sn,3544,32,65,97
Chile,2010,sn,4554,20,52,72
Chile,2010,sn,5564,29,52,81
Chile,2010,sn,65,47,81,128
Chile,2010,sp,014,6,2,8
Chile,2010,sp,1524,56,90,146
Chile,2010,sp,2534,76,115,191
Chile,2010,sp,3544,59,144,203
Chile,2010,sp,4554,56,159,215
Chile,2010,sp,5564,40,122,162
Chile,2010,sp,65,72,157,229
Chile,2011,ep,014,13,13,26
Chile,2011,ep,1524,23,43,66
Chile,2011,ep,2534,32,74,106
Chile,2011,ep,3544,35,57,92
Chile,2011,ep,4554,44,57,101
Chile,2011,ep,5564,42,35,77
Chile,2011,ep,65,65,61,126
Chile,2011,sn,014,5,9,14
Chile,2011,sn,1524,17,35,52
Chile,2011,sn,2534,20,45,65
Chile,2011,sn,3544,22,49,71
Chile,2011,sn,4554,21,70,91
Chile,2011,sn,5564,21,39,60
Chile,2011,sn,65,48,72,120
Chile,2011,sp,014,6,4,10
Chile,2011,sp,1524,62,88,150
Chile,2011,sp,2534,75,139,214
Chile,2011,sp,3544,66,143,209
Chile,2011,sp,4554,69,164,233
Chile,2011,sp,5564,48,127,175
Chile,2011,sp,65,71,134,205
Chile,2012,ep,014,5,10,15
Chile,2012,ep,1524,24,31,55
Chile,2012,ep,2534,35,66,101
Chile,2012,ep,3544,31,45,76
Chile,2012,ep,4554,33,46,79
Chile,2012,ep,5564,39,38,77
Chile,2012,ep,65,57,53,110
Chile,2012,sn,014,18,8,26
Chile,2012,sn,1524,17,33,50
Chile,2012,sn,2534,18,41,59
Chile,2012,sn,3544,22,50,72
Chile,2012,sn,4554,25,61,86
Chile,2012,sn,5564,29,61,90
Chile,2012,sn,65,60,94,154
Chile,2012,sp,014,4,4,8
Chile,2012,sp,1524,59,91,150
Chile,2012,sp,2534,69,122,191
Chile,2012,sp,3544,53,135,188
Chile,2012,sp,4554,56,170,226
Chile,2012,sp,5564,60,117,177
Chile,2012,sp,65,76,149,225
Chile,2013,rel,014,19,40,59
Chile,2013,rel,1524,116,135,251
Chile,2013,rel,2534,147,275,422
Chile,2013,rel,3544,118,253,371
Chile,2013,rel,4554,124,300,424
Chile,2013,rel,5564,150,240,390
Chile,2013,rel,65,184,303,487
China,1995,sp,014,1169,1102,2271
China,1995,sp,1524,10890,12791,23681
China,1995,sp,2534,13250,18306,31556
China,1995,sp,3544,8376,15487,23863
China,1995,sp,4554,5679,13105,18784
China,1995,sp,5564,4579,13489,18068
China,1995,sp,65,2841,10130,12971
China,1996,sp,014,1624,1409,3033
China,1996,sp,1524,13773,16490,30263
China,1996,sp,2534,17218,24057,41275
China,1996,sp,3544,10214,19695,29909
China,1996,sp,4554,7020,17024,24044
China,1996,sp,5564,5346,16758,22104
China,1996,sp,65,3945,13697,17642
China,1997,sp,014,1534,1456,2990
China,1997,sp,1524,15258,18547,33805
China,1997,sp,2534,19547,28247,47794
China,1997,sp,3544,11758,23006,34764
China,1997,sp,4554,8259,20330,28589
China,1997,sp,5564,6422,19667,26089
China,1997,sp,65,4823,17041,21864
China,1998,sp,014,1558,1481,3039
China,1998,sp,1524,15726,19699,35425
China,1998,sp,2534,20203,30093,50296
China,1998,sp,3544,12672,25088,37760
China,1998,sp,4554,9399,23483,32882
China,1998,sp,5564,7122,21651,28773
China,1998,sp,65,5728,20501,26229
China,1999,sp,014,1431,1247,2678
China,1999,sp,1524,15178,18961,34139
China,1999,sp,2534,18846,29328,48174
China,1999,sp,3544,12370,25095,37465
China,1999,sp,4554,9838,24239,34077
China,1999,sp,5564,7131,21564,28695
China,1999,sp,65,5663,21367,27030
China,2000,sp,014,1420,1131,2551
China,2000,sp,1524,14536,19111,33647
China,2000,sp,2534,18496,29399,47895
China,2000,sp,3544,12377,25206,37583
China,2000,sp,4554,9899,25593,35492
China,2000,sp,5564,7102,21429,28531
China,2000,sp,65,6296,21771,28067
China,2001,sp,014,1405,1213,2618
China,2001,sp,1524,14500,19121,33621
China,2001,sp,2534,17446,28520,45966
China,2001,sp,3544,12041,25544,37585
China,2001,sp,4554,9963,25759,35722
China,2001,sp,5564,7175,20789,27964
China,2001,sp,65,6491,22799,29290
China,2002,sp,014,1152,925,2077
China,2002,sp,1524,13250,17933,31183
China,2002,sp,2534,15188,25242,40430
China,2002,sp,3544,10505,22645,33150
China,2002,sp,4554,8796,23884,32680
China,2002,sp,5564,6586,19564,26150
China,2002,sp,65,6740,22562,29302
China,2003,sp,014,1407,1133,2540
China,2003,sp,1524,18811,25125,43936
China,2003,sp,2534,19248,32760,52008
China,2003,sp,3544,14783,31604,46387
China,2003,sp,4554,12101,32585,44686
China,2003,sp,5564,8988,27243,36231
China,2003,sp,65,9465,32027,41492
China,2004,sp,014,1659,1375,3034
China,2004,sp,1524,25951,35465,61416
China,2004,sp,2534,25150,43594,68744
China,2004,sp,3544,20613,45408,66021
China,2004,sp,4554,16995,46256,63251
China,2004,sp,5564,14038,41846,55884
China,2004,sp,65,15739,50797,66536
China,2005,sp,014,1864,1416,3280
China,2005,sp,1524,31180,43005,74185
China,2005,sp,2534,27759,49558,77317
China,2005,sp,3544,24728,55400,80128
China,2005,sp,4554,19889,54872,74761
China,2005,sp,5564,18203,53822,72025
China,2005,sp,65,21244,69779,91023
China,2006,sp,014,1408,1023,2431
China,2006,sp,1524,30904,44528,75432
China,2006,sp,2534,26526,48232,74758
China,2006,sp,3544,24564,56733,81297
China,2006,sp,4554,18775,54301,73076
China,2006,sp,5564,17782,53746,71528
China,2006,sp,65,21212,68557,89769
China,2007,sp,014,1235,878,2113
China,2007,sp,1524,29960,44011,73971
China,2007,sp,2534,24914,46374,71288
China,2007,sp,3544,23542,56224,79766
China,2007,sp,4554,18129,54960,73089
China,2007,sp,5564,17647,56288,73935
China,2007,sp,65,21339,70376,91715
China,2008,sp,014,964,751,1715
China,2008,sp,1524,29223,45596,74819
China,2008,sp,2534,23484,44651,68135
China,2008,sp,3544,22370,56182,78552
China,2008,sp,4554,17565,55740,73305
China,2008,sp,5564,17814,57492,75306
China,2008,sp,65,21086,69678,90764
China,2009,sn,014,2356,2865,5221
China,2009,sn,1524,32424,51307,83731
China,2009,sn,2534,23121,42063,65184
China,2009,sn,3544,22432,47112,69544
China,2009,sn,4554,18704,44567,63271
China,2009,sn,5564,19685,47249,66934
China,2009,sn,65,22662,58778,81440
China,2009,sp,014,1078,944,2022
China,2009,sp,1524,29195,44757,73952
China,2009,sp,2534,22179,41439,63618
China,2009,sp,3544,21636,53300,74936
China,2009,sp,4554,16898,54700,71598
China,2009,sp,5564,17537,57653,75190
China,2009,sp,65,20623,67213,87836
China,2010,ep,014,112,198,310
China,2010,ep,1524,486,403,889
China,2010,ep,2534,580,477,1057
China,2010,ep,3544,798,507,1305
China,2010,ep,4554,602,505,1107
China,2010,ep,5564,520,429,949
China,2010,ep,65,358,350,708
China,2010,sn,014,2193,2522,4715
China,2010,sn,1524,33194,54328,87522
China,2010,sn,2534,24042,41926,65968
China,2010,sn,3544,22604,45869,68473
China,2010,sn,4554,18710,43632,62342
China,2010,sn,5564,19627,47016,66643
China,2010,sn,65,22202,55003,77205
China,2010,sp,014,926,759,1685
China,2010,sp,1524,27064,42851,69915
China,2010,sp,2534,21022,38880,59902
China,2010,sp,3544,20422,50246,70668
China,2010,sp,4554,16075,52925,69000
China,2010,sp,5564,17441,56754,74195
China,2010,sp,65,20020,64514,84534
China,2011,ep,014,103,153,256
China,2011,ep,1524,493,415,908
China,2011,ep,2534,716,487,1203
China,2011,ep,3544,709,531,1240
China,2011,ep,4554,640,466,1106
China,2011,ep,5564,582,463,1045
China,2011,ep,65,392,390,782
China,2011,sn,014,1874,2291,4165
China,2011,sn,1524,34383,58225,92608
China,2011,sn,2534,26119,46051,72170
China,2011,sn,3544,24405,50724,75129
China,2011,sn,4554,21018,51044,72062
China,2011,sn,5564,22141,55593,77734
China,2011,sn,65,24341,63305,87646
China,2011,sp,014,733,645,1378
China,2011,sp,1524,22859,37514,60373
China,2011,sp,2534,18347,34597,52944
China,2011,sp,3544,17119,43087,60206
China,2011,sp,4554,14103,47949,62052
China,2011,sp,5564,15218,51315,66533
China,2011,sp,65,17638,55881,73519
China,2012,ep,014,91,155,246
China,2012,ep,1524,461,393,854
China,2012,ep,2534,633,463,1096
China,2012,ep,3544,677,578,1255
China,2012,ep,4554,684,499,1183
China,2012,ep,5564,578,452,1030
China,2012,ep,65,421,394,815
China,2012,sn,014,1926,2362,4288
China,2012,sn,1524,35518,60246,95764
China,2012,sn,2534,28753,50282,79035
China,2012,sn,3544,26472,54472,80944
China,2012,sn,4554,23869,57181,81050
China,2012,sn,5564,26085,64972,91057
China,2012,sn,65,29630,74282,103912
China,2012,sp,014,580,511,1091
China,2012,sp,1524,17786,29018,46804
China,2012,sp,2534,15549,28324,43873
China,2012,sp,3544,13485,34505,47990
China,2012,sp,4554,11981,40428,52409
China,2012,sp,5564,13384,44821,58205
China,2012,sp,65,16547,49413,65960
China,2013,rel,014,2301,2529,4830
China,2013,rel,1524,49491,84785,134276
China,2013,rel,2534,44985,76917,121902
China,2013,rel,3544,38804,84565,123369
China,2013,rel,4554,37138,100297,137435
China,2013,rel,5564,40892,112558,153450
China,2013,rel,65,47438,124476,171914
"China, Hong Kong SAR",1997,sp,014,12,5,17
"China, Hong Kong SAR",1997,sp,1524,85,90,175
"China, Hong Kong SAR",1997,sp,2534,114,122,236
"China, Hong Kong SAR",1997,sp,3544,83,174,257
"China, Hong Kong SAR",1997,sp,4554,49,198,247
"China, Hong Kong SAR",1997,sp,5564,64,271,335
"China, Hong Kong SAR",1997,sp,65,176,593,769
"China, Hong Kong SAR",1999,sp,014,8,3,11
"China, Hong Kong SAR",1999,sp,1524,85,88,173
"China, Hong Kong SAR",1999,sp,2534,109,121,230
"China, Hong Kong SAR",1999,sp,3544,72,162,234
"China, Hong Kong SAR",1999,sp,4554,50,173,223
"China, Hong Kong SAR",1999,sp,5564,43,233,276
"China, Hong Kong SAR",1999,sp,65,188,432,620
"China, Hong Kong SAR",2000,sp,014,5,4,9
"China, Hong Kong SAR",2000,sp,1524,65,78,143
"China, Hong Kong SAR",2000,sp,2534,115,102,217
"China, Hong Kong SAR",2000,sp,3544,86,160,246
"China, Hong Kong SAR",2000,sp,4554,44,211,255
"China, Hong Kong SAR",2000,sp,5564,45,236,281
"China, Hong Kong SAR",2000,sp,65,211,578,789
"China, Hong Kong SAR",2001,sp,014,13,6,19
"China, Hong Kong SAR",2001,sp,1524,88,79,167
"China, Hong Kong SAR",2001,sp,2534,119,99,218
"China, Hong Kong SAR",2001,sp,3544,83,162,245
"China, Hong Kong SAR",2001,sp,4554,58,196,254
"China, Hong Kong SAR",2001,sp,5564,34,201,235
"China, Hong Kong SAR",2001,sp,65,200,519,719
"China, Hong Kong SAR",2002,sp,014,8,2,10
"China, Hong Kong SAR",2002,sp,1524,97,99,196
"China, Hong Kong SAR",2002,sp,2534,115,105,220
"China, Hong Kong SAR",2002,sp,3544,90,163,253
"China, Hong Kong SAR",2002,sp,4554,57,207,264
"China, Hong Kong SAR",2002,sp,5564,35,218,253
"China, Hong Kong SAR",2002,sp,65,153,543,696
"China, Hong Kong SAR",2003,sp,014,10,8,18
"China, Hong Kong SAR",2003,sp,1524,88,104,192
"China, Hong Kong SAR",2003,sp,2534,136,91,227
"China, Hong Kong SAR",2003,sp,3544,102,140,242
"China, Hong Kong SAR",2003,sp,4554,65,195,260
"China, Hong Kong SAR",2003,sp,5564,43,180,223
"China, Hong Kong SAR",2003,sp,65,160,472,632
"China, Hong Kong SAR",2004,sp,014,6,3,9
"China, Hong Kong SAR",2004,sp,1524,97,59,156
"China, Hong Kong SAR",2004,sp,2534,112,94,206
"China, Hong Kong SAR",2004,sp,3544,87,128,215
"China, Hong Kong SAR",2004,sp,4554,56,226,282
"China, Hong Kong SAR",2004,sp,5564,34,175,209
"China, Hong Kong SAR",2004,sp,65,140,477,617
"China, Hong Kong SAR",2005,ep,014,10,11,21
"China, Hong Kong SAR",2005,ep,1524,30,26,56
"China, Hong Kong SAR",2005,ep,2534,85,40,125
"China, Hong Kong SAR",2005,ep,3544,83,38,121
"China, Hong Kong SAR",2005,ep,4554,90,40,130
"China, Hong Kong SAR",2005,ep,5564,46,37,83
"China, Hong Kong SAR",2005,ep,65,87,78,165
"China, Hong Kong SAR",2005,sn,014,14,19,33
"China, Hong Kong SAR",2005,sn,1524,172,177,349
"China, Hong Kong SAR",2005,sn,2534,237,190,427
"China, Hong Kong SAR",2005,sn,3544,148,213,361
"China, Hong Kong SAR",2005,sn,4554,123,264,387
"China, Hong Kong SAR",2005,sn,5564,78,283,361
"China, Hong Kong SAR",2005,sn,65,354,907,1261
"China, Hong Kong SAR",2005,sp,014,3,3,6
"China, Hong Kong SAR",2005,sp,1524,67,76,143
"China, Hong Kong SAR",2005,sp,2534,81,84,165
"China, Hong Kong SAR",2005,sp,3544,92,108,200
"China, Hong Kong SAR",2005,sp,4554,57,200,257
"China, Hong Kong SAR",2005,sp,5564,34,168,202
"China, Hong Kong SAR",2005,sp,65,135,453,588
"China, Hong Kong SAR",2006,ep,014,4,2,6
"China, Hong Kong SAR",2006,ep,1524,30,27,57
"China, Hong Kong SAR",2006,ep,2534,75,35,110
"China, Hong Kong SAR",2006,ep,3544,78,40,118
"China, Hong Kong SAR",2006,ep,4554,79,36,115
"China, Hong Kong SAR",2006,ep,5564,55,43,98
"China, Hong Kong SAR",2006,ep,65,92,101,193
"China, Hong Kong SAR",2006,sn,014,16,13,29
"China, Hong Kong SAR",2006,sn,1524,129,110,239
"China, Hong Kong SAR",2006,sn,2534,193,177,370
"China, Hong Kong SAR",2006,sn,3544,163,187,350
"China, Hong Kong SAR",2006,sn,4554,109,264,373
"China, Hong Kong SAR",2006,sn,5564,76,279,355
"China, Hong Kong SAR",2006,sn,65,304,888,1192
"China, Hong Kong SAR",2006,sp,014,9,3,12
"China, Hong Kong SAR",2006,sp,1524,59,75,134
"China, Hong Kong SAR",2006,sp,2534,97,84,181
"China, Hong Kong SAR",2006,sp,3544,73,135,208
"China, Hong Kong SAR",2006,sp,4554,54,174,228
"China, Hong Kong SAR",2006,sp,5564,42,161,203
"China, Hong Kong SAR",2006,sp,65,132,439,571
"China, Hong Kong SAR",2007,ep,014,9,8,17
"China, Hong Kong SAR",2007,ep,1524,35,20,55
"China, Hong Kong SAR",2007,ep,2534,85,21,106
"China, Hong Kong SAR",2007,ep,3544,74,38,112
"China, Hong Kong SAR",2007,ep,4554,76,48,124
"China, Hong Kong SAR",2007,ep,5564,49,45,94
"China, Hong Kong SAR",2007,ep,65,105,80,185
"China, Hong Kong SAR",2007,sn,014,11,15,26
"China, Hong Kong SAR",2007,sn,1524,112,108,220
"China, Hong Kong SAR",2007,sn,2534,183,152,335
"China, Hong Kong SAR",2007,sn,3544,147,146,293
"China, Hong Kong SAR",2007,sn,4554,105,257,362
"China, Hong Kong SAR",2007,sn,5564,75,259,334
"China, Hong Kong SAR",2007,sn,65,346,863,1209
"China, Hong Kong SAR",2007,sp,014,1,5,6
"China, Hong Kong SAR",2007,sp,1524,59,63,122
"China, Hong Kong SAR",2007,sp,2534,94,80,174
"China, Hong Kong SAR",2007,sp,3544,74,110,184
"China, Hong Kong SAR",2007,sp,4554,64,177,241
"China, Hong Kong SAR",2007,sp,5564,37,175,212
"China, Hong Kong SAR",2007,sp,65,137,425,562
"China, Hong Kong SAR",2008,ep,014,6,7,13
"China, Hong Kong SAR",2008,ep,1524,30,19,49
"China, Hong Kong SAR",2008,ep,2534,91,35,126
"China, Hong Kong SAR",2008,ep,3544,72,33,105
"China, Hong Kong SAR",2008,ep,4554,93,43,136
"China, Hong Kong SAR",2008,ep,5564,55,42,97
"China, Hong Kong SAR",2008,ep,65,98,104,202
"China, Hong Kong SAR",2008,sn,014,17,9,26
"China, Hong Kong SAR",2008,sn,1524,118,117,235
"China, Hong Kong SAR",2008,sn,2534,183,151,334
"China, Hong Kong SAR",2008,sn,3544,134,201,335
"China, Hong Kong SAR",2008,sn,4554,138,264,402
"China, Hong Kong SAR",2008,sn,5564,95,247,342
"China, Hong Kong SAR",2008,sn,65,348,959,1307
"China, Hong Kong SAR",2008,sp,014,8,0,8
"China, Hong Kong SAR",2008,sp,1524,65,59,124
"China, Hong Kong SAR",2008,sp,2534,84,79,163
"China, Hong Kong SAR",2008,sp,3544,65,95,160
"China, Hong Kong SAR",2008,sp,4554,45,166,211
"China, Hong Kong SAR",2008,sp,5564,40,208,248
"China, Hong Kong SAR",2008,sp,65,131,414,545
"China, Hong Kong SAR",2009,ep,014,5,7,12
"China, Hong Kong SAR",2009,ep,1524,25,24,49
"China, Hong Kong SAR",2009,ep,2534,89,37,126
"China, Hong Kong SAR",2009,ep,3544,58,34,92
"China, Hong Kong SAR",2009,ep,4554,81,50,131
"China, Hong Kong SAR",2009,ep,5564,59,42,101
"China, Hong Kong SAR",2009,ep,65,118,93,211
"China, Hong Kong SAR",2009,sn,014,16,8,24
"China, Hong Kong SAR",2009,sn,1524,89,107,196
"China, Hong Kong SAR",2009,sn,2534,189,134,323
"China, Hong Kong SAR",2009,sn,3544,132,159,291
"China, Hong Kong SAR",2009,sn,4554,123,220,343
"China, Hong Kong SAR",2009,sn,5564,91,256,347
"China, Hong Kong SAR",2009,sn,65,346,803,1149
"China, Hong Kong SAR",2009,sp,014,7,3,10
"China, Hong Kong SAR",2009,sp,1524,56,53,109
"China, Hong Kong SAR",2009,sp,2534,107,64,171
"China, Hong Kong SAR",2009,sp,3544,82,79,161
"China, Hong Kong SAR",2009,sp,4554,56,176,232
"China, Hong Kong SAR",2009,sp,5564,39,179,218
"China, Hong Kong SAR",2009,sp,65,130,413,543
"China, Hong Kong SAR",2010,ep,014,6,2,8
"China, Hong Kong SAR",2010,ep,1524,21,16,37
"China, Hong Kong SAR",2010,ep,2534,79,42,121
"China, Hong Kong SAR",2010,ep,3544,80,46,126
"China, Hong Kong SAR",2010,ep,4554,80,45,125
"China, Hong Kong SAR",2010,ep,5564,64,48,112
"China, Hong Kong SAR",2010,ep,65,112,151,263
"China, Hong Kong SAR",2010,sn,014,14,17,31
"China, Hong Kong SAR",2010,sn,1524,112,95,207
"China, Hong Kong SAR",2010,sn,2534,124,119,243
"China, Hong Kong SAR",2010,sn,3544,136,130,266
"China, Hong Kong SAR",2010,sn,4554,108,208,316
"China, Hong Kong SAR",2010,sn,5564,80,224,304
"China, Hong Kong SAR",2010,sn,65,274,711,985
"China, Hong Kong SAR",2010,sp,014,3,2,5
"China, Hong Kong SAR",2010,sp,1524,49,52,101
"China, Hong Kong SAR",2010,sp,2534,101,84,185
"China, Hong Kong SAR",2010,sp,3544,76,99,175
"China, Hong Kong SAR",2010,sp,4554,64,184,248
"China, Hong Kong SAR",2010,sp,5564,49,166,215
"China, Hong Kong SAR",2010,sp,65,133,413,546
"China, Hong Kong SAR",2011,ep,014,6,7,13
"China, Hong Kong SAR",2011,ep,1524,31,24,55
"China, Hong Kong SAR",2011,ep,2534,84,43,127
"China, Hong Kong SAR",2011,ep,3544,85,32,117
"China, Hong Kong SAR",2011,ep,4554,74,54,128
"China, Hong Kong SAR",2011,ep,5564,64,64,128
"China, Hong Kong SAR",2011,ep,65,110,137,247
"China, Hong Kong SAR",2011,sn,014,8,9,17
"China, Hong Kong SAR",2011,sn,1524,69,96,165
"China, Hong Kong SAR",2011,sn,2534,158,105,263
"China, Hong Kong SAR",2011,sn,3544,105,109,214
"China, Hong Kong SAR",2011,sn,4554,94,206,300
"China, Hong Kong SAR",2011,sn,5564,87,253,340
"China, Hong Kong SAR",2011,sn,65,230,715,945
"China, Hong Kong SAR",2011,sp,014,3,2,5
"China, Hong Kong SAR",2011,sp,1524,56,72,128
"China, Hong Kong SAR",2011,sp,2534,89,52,141
"China, Hong Kong SAR",2011,sp,3544,69,63,132
"China, Hong Kong SAR",2011,sp,4554,60,172,232
"China, Hong Kong SAR",2011,sp,5564,53,189,242
"China, Hong Kong SAR",2011,sp,65,116,384,500
"China, Hong Kong SAR",2012,ep,014,3,7,10
"China, Hong Kong SAR",2012,ep,1524,25,33,58
"China, Hong Kong SAR",2012,ep,2534,82,30,112
"China, Hong Kong SAR",2012,ep,3544,74,33,107
"China, Hong Kong SAR",2012,ep,4554,73,39,112
"China, Hong Kong SAR",2012,ep,5564,87,55,142
"China, Hong Kong SAR",2012,ep,65,131,145,276
"China, Hong Kong SAR",2012,sn,014,7,5,12
"China, Hong Kong SAR",2012,sn,1524,66,75,141
"China, Hong Kong SAR",2012,sn,2534,140,99,239
"China, Hong Kong SAR",2012,sn,3544,120,118,238
"China, Hong Kong SAR",2012,sn,4554,111,194,305
"China, Hong Kong SAR",2012,sn,5564,88,233,321
"China, Hong Kong SAR",2012,sn,65,241,709,950
"China, Hong Kong SAR",2012,sp,014,1,4,5
"China, Hong Kong SAR",2012,sp,1524,45,63,108
"China, Hong Kong SAR",2012,sp,2534,110,67,177
"China, Hong Kong SAR",2012,sp,3544,76,95,171
"China, Hong Kong SAR",2012,sp,4554,51,174,225
"China, Hong Kong SAR",2012,sp,5564,54,178,232
"China, Hong Kong SAR",2012,sp,65,115,430,545
"China, Hong Kong SAR",2013,rel,014,15,19,34
"China, Hong Kong SAR",2013,rel,1524,140,197,337
"China, Hong Kong SAR",2013,rel,2534,346,200,546
"China, Hong Kong SAR",2013,rel,3544,285,234,519
"China, Hong Kong SAR",2013,rel,4554,219,406,625
"China, Hong Kong SAR",2013,rel,5564,242,593,835
"China, Hong Kong SAR",2013,rel,65,549,1299,1848
"China, Macao SAR",1995,sp,014,0,0,0
"China, Macao SAR",1995,sp,1524,9,7,16
"China, Macao SAR",1995,sp,2534,18,19,37
"China, Macao SAR",1995,sp,3544,12,20,32
"China, Macao SAR",1995,sp,4554,4,13,17
"China, Macao SAR",1995,sp,5564,5,12,17
"China, Macao SAR",1995,sp,65,6,16,22
"China, Macao SAR",1996,sp,014,0,1,1
"China, Macao SAR",1996,sp,1524,10,16,26
"China, Macao SAR",1996,sp,2534,21,29,50
"China, Macao SAR",1996,sp,3544,14,34,48
"China, Macao SAR",1996,sp,4554,3,20,23
"China, Macao SAR",1996,sp,5564,3,16,19
"China, Macao SAR",1996,sp,65,11,26,37
"China, Macao SAR",1997,sp,014,4,1,5
"China, Macao SAR",1997,sp,1524,10,15,25
"China, Macao SAR",1997,sp,2534,16,38,54
"China, Macao SAR",1997,sp,3544,21,47,68
"China, Macao SAR",1997,sp,4554,5,37,42
"China, Macao SAR",1997,sp,5564,6,34,40
"China, Macao SAR",1997,sp,65,15,55,70
"China, Macao SAR",1998,sp,014,1,0,1
"China, Macao SAR",1998,sp,1524,9,11,20
"China, Macao SAR",1998,sp,2534,13,26,39
"China, Macao SAR",1998,sp,3544,22,42,64
"China, Macao SAR",1998,sp,4554,6,23,29
"China, Macao SAR",1998,sp,5564,3,28,31
"China, Macao SAR",1998,sp,65,21,56,77
"China, Macao SAR",2000,sp,014,0,0,0
"China, Macao SAR",2000,sp,1524,10,10,20
"China, Macao SAR",2000,sp,2534,4,8,12
"China, Macao SAR",2000,sp,3544,6,25,31
"China, Macao SAR",2000,sp,4554,6,22,28
"China, Macao SAR",2000,sp,5564,3,9,12
"China, Macao SAR",2000,sp,65,13,17,30
"China, Macao SAR",2001,sp,014,1,0,1
"China, Macao SAR",2001,sp,1524,5,9,14
"China, Macao SAR",2001,sp,2534,7,17,24
"China, Macao SAR",2001,sp,3544,11,26,37
"China, Macao SAR",2001,sp,4554,10,25,35
"China, Macao SAR",2001,sp,5564,1,11,12
"China, Macao SAR",2001,sp,65,11,23,34
"China, Macao SAR",2002,sp,014,1,1,2
"China, Macao SAR",2002,sp,1524,7,13,20
"China, Macao SAR",2002,sp,2534,10,8,18
"China, Macao SAR",2002,sp,3544,7,21,28
"China, Macao SAR",2002,sp,4554,9,20,29
"China, Macao SAR",2002,sp,5564,1,17,18
"China, Macao SAR",2002,sp,65,11,21,32
"China, Macao SAR",2003,sp,014,0,0,0
"China, Macao SAR",2003,sp,1524,7,9,16
"China, Macao SAR",2003,sp,2534,7,9,16
"China, Macao SAR",2003,sp,3544,11,16,27
"China, Macao SAR",2003,sp,4554,7,27,34
"China, Macao SAR",2003,sp,5564,4,9,13
"China, Macao SAR",2003,sp,65,5,27,32
"China, Macao SAR",2004,sp,014,0,0,0
"China, Macao SAR",2004,sp,1524,5,8,13
"China, Macao SAR",2004,sp,2534,7,7,14
"China, Macao SAR",2004,sp,3544,12,18,30
"China, Macao SAR",2004,sp,4554,3,31,34
"China, Macao SAR",2004,sp,5564,2,12,14
"China, Macao SAR",2004,sp,65,9,14,23
"China, Macao SAR",2005,sp,014,0,3,3
"China, Macao SAR",2005,sp,1524,5,6,11
"China, Macao SAR",2005,sp,2534,9,9,18
"China, Macao SAR",2005,sp,3544,7,21,28
"China, Macao SAR",2005,sp,4554,8,23,31
"China, Macao SAR",2005,sp,5564,1,17,18
"China, Macao SAR",2005,sp,65,5,22,27
"China, Macao SAR",2006,ep,014,1,0,1
"China, Macao SAR",2006,ep,1524,7,4,11
"China, Macao SAR",2006,ep,2534,5,5,10
"China, Macao SAR",2006,ep,3544,9,0,9
"China, Macao SAR",2006,ep,4554,3,6,9
"China, Macao SAR",2006,ep,5564,0,0,0
"China, Macao SAR",2006,ep,65,4,2,6
"China, Macao SAR",2006,sn,014,0,2,2
"China, Macao SAR",2006,sn,1524,20,22,42
"China, Macao SAR",2006,sn,2534,4,10,14
"China, Macao SAR",2006,sn,3544,22,26,48
"China, Macao SAR",2006,sn,4554,9,18,27
"China, Macao SAR",2006,sn,5564,4,15,19
"China, Macao SAR",2006,sn,65,7,16,23
"China, Macao SAR",2006,sp,014,1,0,1
"China, Macao SAR",2006,sp,1524,7,15,22
"China, Macao SAR",2006,sp,2534,8,6,14
"China, Macao SAR",2006,sp,3544,9,17,26
"China, Macao SAR",2006,sp,4554,4,32,36
"China, Macao SAR",2006,sp,5564,3,19,22
"China, Macao SAR",2006,sp,65,4,19,23
"China, Macao SAR",2007,ep,1524,1,4,5
"China, Macao SAR",2007,ep,2534,4,1,5
"China, Macao SAR",2007,ep,3544,3,2,5
"China, Macao SAR",2007,ep,4554,5,2,7
"China, Macao SAR",2007,ep,5564,1,2,3
"China, Macao SAR",2007,ep,65,1,3,4
"China, Macao SAR",2007,sn,014,1,0,1
"China, Macao SAR",2007,sn,1524,9,11,20
"China, Macao SAR",2007,sn,2534,13,13,26
"China, Macao SAR",2007,sn,3544,7,18,25
"China, Macao SAR",2007,sn,4554,4,25,29
"China, Macao SAR",2007,sn,5564,3,19,22
"China, Macao SAR",2007,sn,65,10,14,24
"China, Macao SAR",2007,sp,014,2,0,2
"China, Macao SAR",2007,sp,1524,10,14,24
"China, Macao SAR",2007,sp,2534,4,12,16
"China, Macao SAR",2007,sp,3544,6,14,20
"China, Macao SAR",2007,sp,4554,8,30,38
"China, Macao SAR",2007,sp,5564,3,16,19
"China, Macao SAR",2007,sp,65,6,13,19
"China, Macao SAR",2008,ep,014,0,0,0
"China, Macao SAR",2008,ep,1524,4,3,7
"China, Macao SAR",2008,ep,2534,8,3,11
"China, Macao SAR",2008,ep,3544,7,4,11
"China, Macao SAR",2008,ep,4554,8,4,12
"China, Macao SAR",2008,ep,5564,1,1,2
"China, Macao SAR",2008,ep,65,3,3,6
"China, Macao SAR",2008,sn,014,0,1,1
"China, Macao SAR",2008,sn,1524,12,21,33
"China, Macao SAR",2008,sn,2534,8,15,23
"China, Macao SAR",2008,sn,3544,9,11,20
"China, Macao SAR",2008,sn,4554,8,28,36
"China, Macao SAR",2008,sn,5564,5,16,21
"China, Macao SAR",2008,sn,65,2,14,16
"China, Macao SAR",2008,sp,014,2,1,3
"China, Macao SAR",2008,sp,1524,7,18,25
"China, Macao SAR",2008,sp,2534,6,12,18
"China, Macao SAR",2008,sp,3544,5,10,15
"China, Macao SAR",2008,sp,4554,6,29,35
"China, Macao SAR",2008,sp,5564,6,19,25
"China, Macao SAR",2008,sp,65,5,13,18
"China, Macao SAR",2009,ep,014,0,1,1
"China, Macao SAR",2009,ep,1524,4,3,7
"China, Macao SAR",2009,ep,2534,5,4,9
"China, Macao SAR",2009,ep,3544,4,3,7
"China, Macao SAR",2009,ep,4554,6,3,9
"China, Macao SAR",2009,ep,5564,1,3,4
"China, Macao SAR",2009,ep,65,1,7,8
"China, Macao SAR",2009,sn,014,1,0,1
"China, Macao SAR",2009,sn,1524,13,18,31
"China, Macao SAR",2009,sn,2534,11,9,20
"China, Macao SAR",2009,sn,3544,11,9,20
"China, Macao SAR",2009,sn,4554,5,27,32
"China, Macao SAR",2009,sn,5564,2,12,14
"China, Macao SAR",2009,sn,65,4,8,12
"China, Macao SAR",2009,sp,014,1,0,1
"China, Macao SAR",2009,sp,1524,5,12,17
"China, Macao SAR",2009,sp,2534,10,12,22
"China, Macao SAR",2009,sp,3544,5,8,13
"China, Macao SAR",2009,sp,4554,6,24,30
"China, Macao SAR",2009,sp,5564,3,15,18
"China, Macao SAR",2009,sp,65,5,10,15
"China, Macao SAR",2010,ep,014,0,1,1
"China, Macao SAR",2010,ep,1524,7,8,15
"China, Macao SAR",2010,ep,2534,4,4,8
"China, Macao SAR",2010,ep,3544,6,1,7
"China, Macao SAR",2010,ep,4554,6,2,8
"China, Macao SAR",2010,ep,5564,3,0,3
"China, Macao SAR",2010,ep,65,2,5,7
"China, Macao SAR",2010,sn,014,2,1,3
"China, Macao SAR",2010,sn,1524,22,29,51
"China, Macao SAR",2010,sn,2534,11,17,28
"China, Macao SAR",2010,sn,3544,8,10,18
"China, Macao SAR",2010,sn,4554,11,26,37
"China, Macao SAR",2010,sn,5564,3,12,15
"China, Macao SAR",2010,sn,65,9,14,23
"China, Macao SAR",2010,sp,014,0,0,0
"China, Macao SAR",2010,sp,1524,7,17,24
"China, Macao SAR",2010,sp,2534,6,5,11
"China, Macao SAR",2010,sp,3544,10,7,17
"China, Macao SAR",2010,sp,4554,5,22,27
"China, Macao SAR",2010,sp,5564,7,20,27
"China, Macao SAR",2010,sp,65,6,11,17
"China, Macao SAR",2011,ep,014,1,0,1
"China, Macao SAR",2011,ep,1524,3,3,6
"China, Macao SAR",2011,ep,2534,5,3,8
"China, Macao SAR",2011,ep,3544,2,0,2
"China, Macao SAR",2011,ep,4554,5,4,9
"China, Macao SAR",2011,ep,5564,6,2,8
"China, Macao SAR",2011,ep,65,6,6,12
"China, Macao SAR",2011,sn,014,0,0,0
"China, Macao SAR",2011,sn,1524,15,10,25
"China, Macao SAR",2011,sn,2534,12,8,20
"China, Macao SAR",2011,sn,3544,8,9,17
"China, Macao SAR",2011,sn,4554,9,24,33
"China, Macao SAR",2011,sn,5564,3,12,15
"China, Macao SAR",2011,sn,65,3,13,16
"China, Macao SAR",2011,sp,014,0,0,0
"China, Macao SAR",2011,sp,1524,28,20,48
"China, Macao SAR",2011,sp,2534,25,22,47
"China, Macao SAR",2011,sp,3544,17,22,39
"China, Macao SAR",2011,sp,4554,18,47,65
"China, Macao SAR",2011,sp,5564,6,39,45
"China, Macao SAR",2011,sp,65,6,24,30
"China, Macao SAR",2012,ep,014,0,1,1
"China, Macao SAR",2012,ep,1524,2,2,4
"China, Macao SAR",2012,ep,2534,4,2,6
"China, Macao SAR",2012,ep,3544,1,1,2
"China, Macao SAR",2012,ep,4554,3,1,4
"China, Macao SAR",2012,ep,5564,2,4,6
"China, Macao SAR",2012,ep,65,3,5,8
"China, Macao SAR",2012,sn,014,0,0,0
"China, Macao SAR",2012,sn,1524,10,12,22
"China, Macao SAR",2012,sn,2534,11,17,28
"China, Macao SAR",2012,sn,3544,7,7,14
"China, Macao SAR",2012,sn,4554,5,26,31
"China, Macao SAR",2012,sn,5564,4,23,27
"China, Macao SAR",2012,sn,65,6,11,17
"China, Macao SAR",2012,sp,014,1,0,1
"China, Macao SAR",2012,sp,1524,12,10,22
"China, Macao SAR",2012,sp,2534,11,12,23
"China, Macao SAR",2012,sp,3544,13,13,26
"China, Macao SAR",2012,sp,4554,3,22,25
"China, Macao SAR",2012,sp,5564,7,32,39
"China, Macao SAR",2012,sp,65,3,17,20
"China, Macao SAR",2013,rel,014,2,1,3
"China, Macao SAR",2013,rel,1524,25,31,56
"China, Macao SAR",2013,rel,2534,34,31,65
"China, Macao SAR",2013,rel,3544,27,37,64
"China, Macao SAR",2013,rel,4554,26,66,92
"China, Macao SAR",2013,rel,5564,20,53,73
"China, Macao SAR",2013,rel,65,15,65,80
Colombia,1999,sp,014,NA,270,NA
Colombia,1999,sp,1524,NA,1730,NA
Colombia,1999,sp,2534,NA,1473,NA
Colombia,1999,sp,3544,NA,1796,NA
Colombia,1999,sp,4554,NA,1500,NA
Colombia,1999,sp,5564,NA,350,NA
Colombia,1999,sp,65,NA,1210,NA
Colombia,2000,sp,014,194,246,440
Colombia,2000,sp,1524,587,763,1350
Colombia,2000,sp,2534,758,1030,1788
Colombia,2000,sp,3544,523,963,1486
Colombia,2000,sp,4554,381,743,1124
Colombia,2000,sp,5564,304,610,914
Colombia,2000,sp,65,510,746,1256
Colombia,2001,sp,014,186,223,409
Colombia,2001,sp,1524,865,1037,1902
Colombia,2001,sp,2534,544,703,1247
Colombia,2001,sp,3544,429,722,1151
Colombia,2001,sp,4554,436,869,1305
Colombia,2001,sp,5564,350,646,996
Colombia,2001,sp,65,359,653,1012
Colombia,2002,sp,014,167,209,376
Colombia,2002,sp,1524,524,614,1138
Colombia,2002,sp,2534,545,696,1241
Colombia,2002,sp,3544,402,688,1090
Colombia,2002,sp,4554,318,593,911
Colombia,2002,sp,5564,258,472,730
Colombia,2002,sp,65,371,662,1033
Colombia,2003,sp,014,174,237,411
Colombia,2003,sp,1524,662,684,1346
Colombia,2003,sp,2534,692,816,1508
Colombia,2003,sp,3544,512,844,1356
Colombia,2003,sp,4554,382,853,1235
Colombia,2003,sp,5564,292,642,934
Colombia,2003,sp,65,421,761,1182
Colombia,2004,sp,014,205,208,413
Colombia,2004,sp,1524,624,732,1356
Colombia,2004,sp,2534,647,824,1471
Colombia,2004,sp,3544,513,743,1256
Colombia,2004,sp,4554,361,725,1086
Colombia,2004,sp,5564,331,564,895
Colombia,2004,sp,65,426,737,1163
Colombia,2005,sp,014,179,178,357
Colombia,2005,sp,1524,581,623,1204
Colombia,2005,sp,2534,533,685,1218
Colombia,2005,sp,3544,457,666,1123
Colombia,2005,sp,4554,389,687,1076
Colombia,2005,sp,5564,292,510,802
Colombia,2005,sp,65,395,695,1090
Colombia,2006,ep,014,56,67,123
Colombia,2006,ep,1524,100,144,244
Colombia,2006,ep,2534,130,218,348
Colombia,2006,ep,3544,127,238,365
Colombia,2006,ep,4554,73,131,204
Colombia,2006,ep,5564,61,104,165
Colombia,2006,ep,65,96,155,251
Colombia,2006,sn,014,125,128,253
Colombia,2006,sn,1524,73,73,146
Colombia,2006,sn,2534,94,111,205
Colombia,2006,sn,3544,83,97,180
Colombia,2006,sn,4554,52,122,174
Colombia,2006,sn,5564,51,96,147
Colombia,2006,sn,65,104,139,243
Colombia,2006,sp,014,210,219,429
Colombia,2006,sp,1524,603,709,1312
Colombia,2006,sp,2534,653,713,1366
Colombia,2006,sp,3544,520,737,1257
Colombia,2006,sp,4554,377,785,1162
Colombia,2006,sp,5564,314,573,887
Colombia,2006,sp,65,469,766,1235
Colombia,2007,ep,014,47,58,105
Colombia,2007,ep,1524,94,134,228
Colombia,2007,ep,2534,157,218,375
Colombia,2007,ep,3544,132,220,352
Colombia,2007,ep,4554,82,149,231
Colombia,2007,ep,5564,42,122,164
Colombia,2007,ep,65,102,146,248
Colombia,2007,sn,014,109,120,229
Colombia,2007,sn,1524,78,93,171
Colombia,2007,sn,2534,104,123,227
Colombia,2007,sn,3544,117,143,260
Colombia,2007,sn,4554,97,133,230
Colombia,2007,sn,5564,102,133,235
Colombia,2007,sn,65,102,182,284
Colombia,2007,sp,014,138,144,282
Colombia,2007,sp,1524,599,618,1217
Colombia,2007,sp,2534,620,704,1324
Colombia,2007,sp,3544,459,694,1153
Colombia,2007,sp,4554,393,712,1105
Colombia,2007,sp,5564,286,574,860
Colombia,2007,sp,65,461,786,1247
Colombia,2008,ep,014,72,95,167
Colombia,2008,ep,1524,118,169,287
Colombia,2008,ep,2534,151,257,408
Colombia,2008,ep,3544,138,257,395
Colombia,2008,ep,4554,109,155,264
Colombia,2008,ep,5564,80,137,217
Colombia,2008,ep,65,103,185,288
Colombia,2008,sn,014,137,126,263
Colombia,2008,sn,1524,88,106,194
Colombia,2008,sn,2534,117,153,270
Colombia,2008,sn,3544,109,136,245
Colombia,2008,sn,4554,94,130,224
Colombia,2008,sn,5564,87,129,216
Colombia,2008,sn,65,143,154,297
Colombia,2008,sp,014,133,136,269
Colombia,2008,sp,1524,580,666,1246
Colombia,2008,sp,2534,608,736,1344
Colombia,2008,sp,3544,441,666,1107
Colombia,2008,sp,4554,384,749,1133
Colombia,2008,sp,5564,284,610,894
Colombia,2008,sp,65,406,797,1203
Colombia,2009,ep,014,69,123,192
Colombia,2009,ep,1524,136,182,318
Colombia,2009,ep,2534,185,286,471
Colombia,2009,ep,3544,127,246,373
Colombia,2009,ep,4554,107,193,300
Colombia,2009,ep,5564,78,139,217
Colombia,2009,ep,65,106,207,313
Colombia,2009,sn,014,139,141,280
Colombia,2009,sn,1524,94,116,210
Colombia,2009,sn,2534,120,143,263
Colombia,2009,sn,3544,86,105,191
Colombia,2009,sn,4554,105,129,234
Colombia,2009,sn,5564,56,116,172
Colombia,2009,sn,65,105,135,240
Colombia,2009,sp,014,121,124,245
Colombia,2009,sp,1524,575,697,1272
Colombia,2009,sp,2534,582,754,1336
Colombia,2009,sp,3544,434,651,1085
Colombia,2009,sp,4554,423,692,1115
Colombia,2009,sp,5564,304,569,873
Colombia,2009,sp,65,447,838,1285
Colombia,2010,ep,014,51,69,120
Colombia,2010,ep,1524,117,169,286
Colombia,2010,ep,2534,172,252,424
Colombia,2010,ep,3544,139,242,381
Colombia,2010,ep,4554,91,178,269
Colombia,2010,ep,5564,78,154,232
Colombia,2010,ep,65,89,184,273
Colombia,2010,sn,014,144,161,305
Colombia,2010,sn,1524,79,88,167
Colombia,2010,sn,2534,115,130,245
Colombia,2010,sn,3544,72,121,193
Colombia,2010,sn,4554,70,127,197
Colombia,2010,sn,5564,100,158,258
Colombia,2010,sn,65,115,216,331
Colombia,2010,sp,014,146,148,294
Colombia,2010,sp,1524,560,602,1162
Colombia,2010,sp,2534,576,765,1341
Colombia,2010,sp,3544,428,540,968
Colombia,2010,sp,4554,374,710,1084
Colombia,2010,sp,5564,284,610,894
Colombia,2010,sp,65,471,814,1285
Colombia,2011,ep,014,58,70,128
Colombia,2011,ep,1524,152,174,326
Colombia,2011,ep,2534,201,294,495
Colombia,2011,ep,3544,136,259,395
Colombia,2011,ep,4554,119,207,326
Colombia,2011,ep,5564,92,169,261
Colombia,2011,ep,65,122,222,344
Colombia,2011,sn,014,148,154,302
Colombia,2011,sn,1524,111,165,276
Colombia,2011,sn,2534,157,187,344
Colombia,2011,sn,3544,138,164,302
Colombia,2011,sn,4554,121,229,350
Colombia,2011,sn,5564,113,183,296
Colombia,2011,sn,65,203,282,485
Colombia,2011,sp,014,98,105,203
Colombia,2011,sp,1524,461,663,1124
Colombia,2011,sp,2534,535,714,1249
Colombia,2011,sp,3544,324,558,882
Colombia,2011,sp,4554,337,702,1039
Colombia,2011,sp,5564,278,594,872
Colombia,2011,sp,65,390,753,1143
Colombia,2012,ep,014,57,70,127
Colombia,2012,ep,1524,133,205,338
Colombia,2012,ep,2534,177,288,465
Colombia,2012,ep,3544,131,284,415
Colombia,2012,ep,4554,129,211,340
Colombia,2012,ep,5564,82,154,236
Colombia,2012,ep,65,134,209,343
Colombia,2012,sn,014,160,163,323
Colombia,2012,sn,1524,87,118,205
Colombia,2012,sn,2534,155,208,363
Colombia,2012,sn,3544,127,175,302
Colombia,2012,sn,4554,117,174,291
Colombia,2012,sn,5564,117,203,320
Colombia,2012,sn,65,211,264,475
Colombia,2012,sp,014,79,92,171
Colombia,2012,sp,1524,519,613,1132
Colombia,2012,sp,2534,555,744,1299
Colombia,2012,sp,3544,376,497,873
Colombia,2012,sp,4554,355,653,1008
Colombia,2012,sp,5564,252,616,868
Colombia,2012,sp,65,432,740,1172
Colombia,2013,rel,014,272,299,571
Colombia,2013,rel,1524,759,976,1735
Colombia,2013,rel,2534,907,1436,2343
Colombia,2013,rel,3544,651,990,1641
Colombia,2013,rel,4554,631,1138,1769
Colombia,2013,rel,5564,502,1081,1583
Colombia,2013,rel,65,755,1340,2095
Comoros,1995,sp,014,1,0,1
Comoros,1995,sp,1524,13,18,31
Comoros,1995,sp,2534,9,13,22
Comoros,1995,sp,3544,8,9,17
Comoros,1995,sp,4554,6,7,13
Comoros,1995,sp,5564,5,8,13
Comoros,1995,sp,65,2,4,6
Comoros,1996,sp,014,1,1,2
Comoros,1996,sp,1524,7,19,26
Comoros,1996,sp,2534,12,16,28
Comoros,1996,sp,3544,6,12,18
Comoros,1996,sp,4554,4,4,8
Comoros,1996,sp,5564,10,8,18
Comoros,1996,sp,65,3,8,11
Comoros,1998,sp,014,0,0,0
Comoros,1998,sp,1524,7,15,22
Comoros,1998,sp,2534,9,10,19
Comoros,1998,sp,3544,5,13,18
Comoros,1998,sp,4554,8,11,19
Comoros,1998,sp,5564,4,6,10
Comoros,1998,sp,65,4,0,4
Comoros,2000,sp,014,1,0,1
Comoros,2000,sp,1524,9,18,27
Comoros,2000,sp,2534,6,7,13
Comoros,2000,sp,3544,12,14,26
Comoros,2000,sp,4554,1,9,10
Comoros,2000,sp,5564,2,3,5
Comoros,2000,sp,65,1,4,5
Comoros,2001,sp,014,2,0,2
Comoros,2001,sp,1524,10,15,25
Comoros,2001,sp,2534,11,11,22
Comoros,2001,sp,3544,8,10,18
Comoros,2001,sp,4554,4,11,15
Comoros,2001,sp,5564,2,3,5
Comoros,2001,sp,65,0,5,5
Comoros,2002,sp,014,0,0,0
Comoros,2002,sp,1524,11,10,21
Comoros,2002,sp,2534,6,9,15
Comoros,2002,sp,3544,7,8,15
Comoros,2002,sp,4554,6,4,10
Comoros,2002,sp,5564,2,3,5
Comoros,2002,sp,65,3,3,6
Comoros,2003,sp,014,0,1,1
Comoros,2003,sp,1524,5,7,12
Comoros,2003,sp,2534,7,12,19
Comoros,2003,sp,3544,1,5,6
Comoros,2003,sp,4554,1,1,2
Comoros,2003,sp,5564,1,3,4
Comoros,2003,sp,65,1,3,4
Comoros,2005,sp,014,2,0,2
Comoros,2005,sp,1524,10,12,22
Comoros,2005,sp,2534,7,9,16
Comoros,2005,sp,3544,4,6,10
Comoros,2005,sp,4554,8,4,12
Comoros,2005,sp,5564,3,2,5
Comoros,2005,sp,65,8,4,12
Comoros,2006,ep,014,2,1,3
Comoros,2006,ep,1524,1,2,3
Comoros,2006,ep,2534,0,1,1
Comoros,2006,ep,3544,5,3,8
Comoros,2006,ep,4554,1,2,3
Comoros,2006,ep,5564,1,1,2
Comoros,2006,ep,65,0,0,0
Comoros,2006,sn,014,1,0,1
Comoros,2006,sn,1524,2,2,4
Comoros,2006,sn,2534,2,3,5
Comoros,2006,sn,3544,1,2,3
Comoros,2006,sn,4554,2,1,3
Comoros,2006,sn,5564,1,2,3
Comoros,2006,sn,65,1,2,3
Comoros,2006,sp,014,0,0,0
Comoros,2006,sp,1524,5,12,17
Comoros,2006,sp,2534,5,9,14
Comoros,2006,sp,3544,9,7,16
Comoros,2006,sp,4554,6,4,10
Comoros,2006,sp,5564,4,4,8
Comoros,2006,sp,65,1,1,2
Comoros,2008,ep,014,0,1,1
Comoros,2008,ep,1524,1,1,2
Comoros,2008,ep,2534,1,1,2
Comoros,2008,ep,3544,2,2,4
Comoros,2008,ep,4554,1,1,2
Comoros,2008,ep,5564,0,2,2
Comoros,2008,ep,65,5,1,6
Comoros,2008,sn,014,2,4,6
Comoros,2008,sn,1524,0,1,1
Comoros,2008,sn,2534,0,1,1
Comoros,2008,sn,3544,0,0,0
Comoros,2008,sn,4554,1,0,1
Comoros,2008,sn,5564,1,4,5
Comoros,2008,sn,65,2,0,2
Comoros,2008,sp,014,2,2,4
Comoros,2008,sp,1524,6,11,17
Comoros,2008,sp,2534,11,11,22
Comoros,2008,sp,3544,1,4,5
Comoros,2008,sp,4554,6,9,15
Comoros,2008,sp,5564,2,5,7
Comoros,2008,sp,65,2,5,7
Comoros,2009,ep,014,1,4,5
Comoros,2009,ep,1524,2,4,6
Comoros,2009,ep,2534,1,1,2
Comoros,2009,ep,3544,2,2,4
Comoros,2009,ep,4554,1,1,2
Comoros,2009,ep,5564,2,1,3
Comoros,2009,ep,65,4,1,5
Comoros,2009,sn,014,2,0,2
Comoros,2009,sn,1524,3,0,3
Comoros,2009,sn,2534,0,2,2
Comoros,2009,sn,3544,0,0,0
Comoros,2009,sn,4554,2,2,4
Comoros,2009,sn,5564,1,1,2
Comoros,2009,sn,65,1,1,2
Comoros,2009,sp,014,1,1,2
Comoros,2009,sp,1524,8,9,17
Comoros,2009,sp,2534,4,12,16
Comoros,2009,sp,3544,4,12,16
Comoros,2009,sp,4554,2,11,13
Comoros,2009,sp,5564,2,6,8
Comoros,2009,sp,65,1,3,4
Comoros,2011,ep,014,6,1,7
Comoros,2011,ep,1524,1,7,8
Comoros,2011,ep,2534,3,0,3
Comoros,2011,ep,3544,3,5,8
Comoros,2011,ep,4554,1,2,3
Comoros,2011,ep,5564,0,2,2
Comoros,2011,ep,65,1,0,1
Comoros,2011,sn,014,1,1,2
Comoros,2011,sn,1524,1,1,2
Comoros,2011,sn,2534,1,0,1
Comoros,2011,sn,3544,1,1,2
Comoros,2011,sn,4554,2,0,2
Comoros,2011,sn,5564,1,1,2
Comoros,2011,sn,65,1,0,1
Comoros,2011,sp,014,2,0,2
Comoros,2011,sp,1524,8,10,18
Comoros,2011,sp,2534,4,13,17
Comoros,2011,sp,3544,2,9,11
Comoros,2011,sp,4554,1,5,6
Comoros,2011,sp,5564,0,2,2
Comoros,2011,sp,65,1,5,6
Comoros,2012,ep,1524,1,3,4
Comoros,2012,ep,2534,3,2,5
Comoros,2012,ep,3544,1,4,5
Comoros,2012,ep,4554,NA,1,NA
Comoros,2012,ep,5564,2,NA,NA
Comoros,2012,ep,65,1,5,6
Comoros,2012,sn,014,NA,1,NA
Comoros,2012,sn,1524,NA,1,NA
Comoros,2012,sn,2534,1,4,5
Comoros,2012,sn,3544,1,4,5
Comoros,2012,sn,4554,2,3,5
Comoros,2012,sn,5564,NA,3,NA
Comoros,2012,sn,65,2,1,3
Comoros,2012,sp,014,1,NA,NA
Comoros,2012,sp,1524,5,9,14
Comoros,2012,sp,2534,7,15,22
Comoros,2012,sp,3544,5,8,13
Comoros,2012,sp,4554,1,4,5
Comoros,2012,sp,5564,1,6,7
Comoros,2012,sp,65,3,6,9
Comoros,2013,rel,014,0,0,0
Comoros,2013,rel,1524,13,7,20
Comoros,2013,rel,2534,2,14,16
Comoros,2013,rel,3544,2,10,12
Comoros,2013,rel,4554,4,8,12
Comoros,2013,rel,5564,2,6,8
Comoros,2013,rel,65,0,2,2
Congo,1995,sp,014,17,16,33
Congo,1995,sp,1524,296,265,561
Congo,1995,sp,2534,353,409,762
Congo,1995,sp,3544,167,221,388
Congo,1995,sp,4554,61,73,134
Congo,1995,sp,5564,38,44,82
Congo,1995,sp,65,11,15,26
Congo,1999,sp,014,25,17,42
Congo,1999,sp,1524,297,272,569
Congo,1999,sp,2534,348,407,755
Congo,1999,sp,3544,143,229,372
Congo,1999,sp,4554,83,99,182
Congo,1999,sp,5564,24,39,63
Congo,1999,sp,65,22,27,49
Congo,2001,sp,014,53,31,84
Congo,2001,sp,1524,554,557,1111
Congo,2001,sp,2534,706,756,1462
Congo,2001,sp,3544,377,437,814
Congo,2001,sp,4554,177,174,351
Congo,2001,sp,5564,85,85,170
Congo,2001,sp,65,107,65,172
Congo,2004,sp,014,38,9,47
Congo,2004,sp,1524,310,602,912
Congo,2004,sp,2534,800,887,1687
Congo,2004,sp,3544,373,451,824
Congo,2004,sp,4554,156,251,407
Congo,2004,sp,5564,88,78,166
Congo,2004,sp,65,44,32,76
Congo,2006,sp,014,44,32,76
Congo,2006,sp,1524,384,371,755
Congo,2006,sp,2534,500,656,1156
Congo,2006,sp,3544,247,392,639
Congo,2006,sp,4554,138,174,312
Congo,2006,sp,5564,79,69,148
Congo,2006,sp,65,54,51,105
Congo,2007,sp,014,45,28,73
Congo,2007,sp,1524,411,351,762
Congo,2007,sp,2534,608,635,1243
Congo,2007,sp,3544,334,482,816
Congo,2007,sp,4554,153,233,386
Congo,2007,sp,5564,71,78,149
Congo,2007,sp,65,60,63,123
Congo,2008,sp,014,56,31,87
Congo,2008,sp,1524,396,417,813
Congo,2008,sp,2534,505,606,1111
Congo,2008,sp,3544,308,469,777
Congo,2008,sp,4554,135,195,330
Congo,2008,sp,5564,85,68,153
Congo,2008,sp,65,51,49,100
Congo,2009,sp,014,65,50,115
Congo,2009,sp,1524,426,474,900
Congo,2009,sp,2534,493,644,1137
Congo,2009,sp,3544,292,376,668
Congo,2009,sp,4554,127,220,347
Congo,2009,sp,5564,76,87,163
Congo,2009,sp,65,47,56,103
Congo,2010,sp,014,49,41,90
Congo,2010,sp,1524,409,435,844
Congo,2010,sp,2534,510,672,1182
Congo,2010,sp,3544,296,424,720
Congo,2010,sp,4554,152,203,355
Congo,2010,sp,5564,70,77,147
Congo,2010,sp,65,56,55,111
Congo,2011,sp,014,72,58,130
Congo,2011,sp,1524,408,453,861
Congo,2011,sp,2534,463,705,1168
Congo,2011,sp,3544,332,462,794
Congo,2011,sp,4554,200,222,422
Congo,2011,sp,5564,88,80,168
Congo,2011,sp,65,97,76,173
Congo,2012,sp,014,63,46,109
Congo,2012,sp,1524,438,563,1001
Congo,2012,sp,2534,482,716,1198
Congo,2012,sp,3544,349,519,868
Congo,2012,sp,4554,171,276,447
Congo,2012,sp,5564,68,113,181
Congo,2012,sp,65,108,72,180
Congo,2013,rel,014,46,35,81
Congo,2013,rel,1524,452,502,954
Congo,2013,rel,2534,475,803,1278
Congo,2013,rel,3544,300,572,872
Congo,2013,rel,4554,156,246,402
Congo,2013,rel,5564,84,101,185
Congo,2013,rel,65,71,60,131
Cook Islands,1980,sp,014,0,0,0
Cook Islands,1980,sp,1524,3,2,5
Cook Islands,1980,sp,2534,0,0,0
Cook Islands,1980,sp,3544,0,1,1
Cook Islands,1980,sp,4554,1,1,2
Cook Islands,1980,sp,5564,0,0,0
Cook Islands,1980,sp,65,0,0,0
Cook Islands,1981,sp,014,0,0,0
Cook Islands,1981,sp,1524,0,0,0
Cook Islands,1981,sp,2534,0,1,1
Cook Islands,1981,sp,3544,0,0,0
Cook Islands,1981,sp,4554,0,0,0
Cook Islands,1981,sp,5564,1,0,1
Cook Islands,1981,sp,65,0,0,0
Cook Islands,1982,sp,014,0,0,0
Cook Islands,1982,sp,1524,2,0,2
Cook Islands,1982,sp,2534,0,0,0
Cook Islands,1982,sp,3544,3,1,4
Cook Islands,1982,sp,4554,0,2,2
Cook Islands,1982,sp,5564,0,3,3
Cook Islands,1982,sp,65,0,1,1
Cook Islands,1983,sp,014,0,0,0
Cook Islands,1983,sp,1524,4,2,6
Cook Islands,1983,sp,2534,0,1,1
Cook Islands,1983,sp,3544,3,0,3
Cook Islands,1983,sp,4554,1,0,1
Cook Islands,1983,sp,5564,2,1,3
Cook Islands,1983,sp,65,0,1,1
Cook Islands,1984,sp,014,0,0,0
Cook Islands,1984,sp,1524,0,0,0
Cook Islands,1984,sp,2534,0,1,1
Cook Islands,1984,sp,3544,0,0,0
Cook Islands,1984,sp,4554,0,1,1
Cook Islands,1984,sp,5564,0,0,0
Cook Islands,1984,sp,65,0,1,1
Cook Islands,1985,sp,014,0,1,1
Cook Islands,1985,sp,1524,1,0,1
Cook Islands,1985,sp,2534,1,0,1
Cook Islands,1985,sp,3544,0,1,1
Cook Islands,1985,sp,4554,0,2,2
Cook Islands,1985,sp,5564,1,1,2
Cook Islands,1985,sp,65,0,0,0
Cook Islands,1986,sp,014,1,0,1
Cook Islands,1986,sp,1524,0,1,1
Cook Islands,1986,sp,2534,0,0,0
Cook Islands,1986,sp,3544,0,0,0
Cook Islands,1986,sp,4554,0,0,0
Cook Islands,1986,sp,5564,0,0,0
Cook Islands,1986,sp,65,0,0,0
Cook Islands,1987,sp,014,1,0,1
Cook Islands,1987,sp,1524,0,0,0
Cook Islands,1987,sp,2534,0,0,0
Cook Islands,1987,sp,3544,0,1,1
Cook Islands,1987,sp,4554,0,0,0
Cook Islands,1987,sp,5564,0,0,0
Cook Islands,1987,sp,65,0,0,0
Cook Islands,1989,sp,014,1,0,1
Cook Islands,1989,sp,1524,0,0,0
Cook Islands,1989,sp,2534,0,0,0
Cook Islands,1989,sp,3544,0,0,0
Cook Islands,1989,sp,4554,0,0,0
Cook Islands,1989,sp,5564,0,0,0
Cook Islands,1989,sp,65,0,1,1
Cook Islands,1991,sp,014,0,0,0
Cook Islands,1991,sp,1524,1,0,1
Cook Islands,1991,sp,2534,0,0,0
Cook Islands,1991,sp,3544,0,0,0
Cook Islands,1991,sp,4554,0,0,0
Cook Islands,1991,sp,5564,0,0,0
Cook Islands,1991,sp,65,0,0,0
Cook Islands,1992,sp,014,0,0,0
Cook Islands,1992,sp,1524,0,0,0
Cook Islands,1992,sp,2534,0,0,0
Cook Islands,1992,sp,3544,1,0,1
Cook Islands,1992,sp,4554,0,1,1
Cook Islands,1992,sp,5564,1,2,3
Cook Islands,1992,sp,65,1,0,1
Cook Islands,1993,sp,014,0,0,0
Cook Islands,1993,sp,1524,0,0,0
Cook Islands,1993,sp,2534,1,0,1
Cook Islands,1993,sp,3544,0,0,0
Cook Islands,1993,sp,4554,0,2,2
Cook Islands,1993,sp,5564,1,0,1
Cook Islands,1993,sp,65,0,0,0
Cook Islands,1994,sp,014,1,0,1
Cook Islands,1994,sp,1524,0,0,0
Cook Islands,1994,sp,2534,0,0,0
Cook Islands,1994,sp,3544,0,0,0
Cook Islands,1994,sp,4554,0,0,0
Cook Islands,1994,sp,5564,0,3,3
Cook Islands,1994,sp,65,0,1,1
Cook Islands,1995,sp,014,0,0,0
Cook Islands,1995,sp,1524,0,0,0
Cook Islands,1995,sp,2534,0,0,0
Cook Islands,1995,sp,3544,0,0,0
Cook Islands,1995,sp,4554,1,0,1
Cook Islands,1995,sp,5564,0,1,1
Cook Islands,1995,sp,65,0,0,0
Cook Islands,1996,sp,014,0,0,0
Cook Islands,1996,sp,1524,0,0,0
Cook Islands,1996,sp,2534,0,0,0
Cook Islands,1996,sp,3544,0,0,0
Cook Islands,1996,sp,4554,0,0,0
Cook Islands,1996,sp,5564,1,0,1
Cook Islands,1996,sp,65,0,0,0
Cook Islands,1997,sp,014,0,0,0
Cook Islands,1997,sp,1524,0,0,0
Cook Islands,1997,sp,2534,0,0,0
Cook Islands,1997,sp,3544,1,0,1
Cook Islands,1997,sp,4554,0,0,0
Cook Islands,1997,sp,5564,0,1,1
Cook Islands,1997,sp,65,0,0,0
Cook Islands,1998,sp,014,0,0,0
Cook Islands,1998,sp,1524,0,0,0
Cook Islands,1998,sp,2534,0,0,0
Cook Islands,1998,sp,3544,0,0,0
Cook Islands,1998,sp,4554,0,0,0
Cook Islands,1998,sp,5564,0,0,0
Cook Islands,1998,sp,65,0,0,0
Cook Islands,2000,sp,014,0,0,0
Cook Islands,2000,sp,1524,0,0,0
Cook Islands,2000,sp,2534,0,0,0
Cook Islands,2000,sp,3544,0,0,0
Cook Islands,2000,sp,4554,0,0,0
Cook Islands,2000,sp,5564,0,0,0
Cook Islands,2000,sp,65,0,0,0
Cook Islands,2001,sp,014,0,0,0
Cook Islands,2001,sp,1524,0,0,0
Cook Islands,2001,sp,2534,0,0,0
Cook Islands,2001,sp,3544,0,0,0
Cook Islands,2001,sp,4554,0,0,0
Cook Islands,2001,sp,5564,0,1,1
Cook Islands,2001,sp,65,0,1,1
Cook Islands,2002,sp,014,0,0,0
Cook Islands,2002,sp,1524,0,0,0
Cook Islands,2002,sp,2534,0,0,0
Cook Islands,2002,sp,3544,0,0,0
Cook Islands,2002,sp,4554,0,0,0
Cook Islands,2002,sp,5564,0,1,1
Cook Islands,2002,sp,65,0,0,0
Cook Islands,2003,sp,014,0,0,0
Cook Islands,2003,sp,1524,0,0,0
Cook Islands,2003,sp,2534,0,0,0
Cook Islands,2003,sp,3544,0,0,0
Cook Islands,2003,sp,4554,0,0,0
Cook Islands,2003,sp,5564,0,0,0
Cook Islands,2003,sp,65,0,0,0
Cook Islands,2004,sp,014,0,0,0
Cook Islands,2004,sp,1524,0,0,0
Cook Islands,2004,sp,2534,0,0,0
Cook Islands,2004,sp,3544,0,0,0
Cook Islands,2004,sp,4554,0,0,0
Cook Islands,2004,sp,5564,0,0,0
Cook Islands,2004,sp,65,0,1,1
Cook Islands,2005,sp,014,0,0,0
Cook Islands,2005,sp,1524,0,1,1
Cook Islands,2005,sp,2534,0,0,0
Cook Islands,2005,sp,3544,0,0,0
Cook Islands,2005,sp,4554,0,0,0
Cook Islands,2005,sp,5564,0,0,0
Cook Islands,2005,sp,65,0,0,0
Cook Islands,2006,ep,014,0,0,0
Cook Islands,2006,ep,1524,0,0,0
Cook Islands,2006,ep,2534,0,0,0
Cook Islands,2006,ep,3544,0,0,0
Cook Islands,2006,ep,4554,0,0,0
Cook Islands,2006,ep,5564,0,0,0
Cook Islands,2006,ep,65,0,0,0
Cook Islands,2006,sn,014,0,0,0
Cook Islands,2006,sn,1524,0,0,0
Cook Islands,2006,sn,2534,0,0,0
Cook Islands,2006,sn,3544,0,0,0
Cook Islands,2006,sn,4554,0,0,0
Cook Islands,2006,sn,5564,0,0,0
Cook Islands,2006,sn,65,0,0,0
Cook Islands,2006,sp,014,0,0,0
Cook Islands,2006,sp,1524,0,0,0
Cook Islands,2006,sp,2534,0,0,0
Cook Islands,2006,sp,3544,0,0,0
Cook Islands,2006,sp,4554,0,0,0
Cook Islands,2006,sp,5564,0,0,0
Cook Islands,2006,sp,65,0,0,0
Cook Islands,2008,ep,014,0,0,0
Cook Islands,2008,ep,1524,0,0,0
Cook Islands,2008,ep,2534,0,0,0
Cook Islands,2008,ep,3544,0,0,0
Cook Islands,2008,ep,4554,0,0,0
Cook Islands,2008,ep,5564,0,0,0
Cook Islands,2008,ep,65,0,0,0
Cook Islands,2008,sn,014,0,0,0
Cook Islands,2008,sn,1524,0,0,0
Cook Islands,2008,sn,2534,0,0,0
Cook Islands,2008,sn,3544,0,0,0
Cook Islands,2008,sn,4554,0,0,0
Cook Islands,2008,sn,5564,0,0,0
Cook Islands,2008,sn,65,0,0,0
Cook Islands,2008,sp,3544,NA,1,NA
Cook Islands,2008,sp,5564,NA,1,NA
Cook Islands,2009,ep,014,0,0,0
Cook Islands,2009,ep,1524,0,0,0
Cook Islands,2009,ep,2534,0,0,0
Cook Islands,2009,ep,3544,0,0,0
Cook Islands,2009,ep,4554,0,0,0
Cook Islands,2009,ep,5564,0,0,0
Cook Islands,2009,ep,65,0,0,0
Cook Islands,2009,sn,014,0,0,0
Cook Islands,2009,sn,1524,0,0,0
Cook Islands,2009,sn,2534,0,0,0
Cook Islands,2009,sn,3544,0,0,0
Cook Islands,2009,sn,4554,0,0,0
Cook Islands,2009,sn,5564,0,1,1
Cook Islands,2009,sn,65,0,0,0
Cook Islands,2009,sp,014,0,0,0
Cook Islands,2009,sp,1524,0,0,0
Cook Islands,2009,sp,2534,0,0,0
Cook Islands,2009,sp,3544,0,0,0
Cook Islands,2009,sp,4554,0,0,0
Cook Islands,2009,sp,5564,0,1,1
Cook Islands,2009,sp,65,0,0,0
Cook Islands,2010,ep,014,0,0,0
Cook Islands,2010,ep,1524,0,0,0
Cook Islands,2010,ep,2534,0,0,0
Cook Islands,2010,ep,3544,0,0,0
Cook Islands,2010,ep,4554,0,0,0
Cook Islands,2010,ep,5564,0,0,0
Cook Islands,2010,ep,65,0,0,0
Cook Islands,2010,sn,014,0,0,0
Cook Islands,2010,sn,1524,0,0,0
Cook Islands,2010,sn,2534,0,0,0
Cook Islands,2010,sn,3544,0,0,0
Cook Islands,2010,sn,4554,0,0,0
Cook Islands,2010,sn,5564,0,0,0
Cook Islands,2010,sn,65,0,0,0
Cook Islands,2010,sp,014,0,0,0
Cook Islands,2010,sp,1524,0,0,0
Cook Islands,2010,sp,2534,0,0,0
Cook Islands,2010,sp,3544,0,0,0
Cook Islands,2010,sp,4554,0,0,0
Cook Islands,2010,sp,5564,0,0,0
Cook Islands,2010,sp,65,0,0,0
Cook Islands,2011,ep,014,0,0,0
Cook Islands,2011,ep,1524,0,0,0
Cook Islands,2011,ep,2534,0,0,0
Cook Islands,2011,ep,3544,0,0,0
Cook Islands,2011,ep,4554,0,0,0
Cook Islands,2011,ep,5564,0,0,0
Cook Islands,2011,ep,65,0,0,0
Cook Islands,2011,sn,014,0,0,0
Cook Islands,2011,sn,1524,0,0,0
Cook Islands,2011,sn,2534,0,0,0
Cook Islands,2011,sn,3544,0,0,0
Cook Islands,2011,sn,4554,0,0,0
Cook Islands,2011,sn,5564,0,0,0
Cook Islands,2011,sn,65,0,0,0
Cook Islands,2011,sp,014,0,0,0
Cook Islands,2011,sp,1524,1,0,1
Cook Islands,2011,sp,2534,0,0,0
Cook Islands,2011,sp,3544,0,0,0
Cook Islands,2011,sp,4554,0,0,0
Cook Islands,2011,sp,5564,0,0,0
Cook Islands,2011,sp,65,0,0,0
Cook Islands,2012,ep,014,0,0,0
Cook Islands,2012,ep,1524,0,0,0
Cook Islands,2012,ep,2534,0,0,0
Cook Islands,2012,ep,3544,0,0,0
Cook Islands,2012,ep,4554,0,0,0
Cook Islands,2012,ep,5564,0,0,0
Cook Islands,2012,ep,65,0,0,0
Cook Islands,2012,sn,014,0,0,0
Cook Islands,2012,sn,1524,0,0,0
Cook Islands,2012,sn,2534,0,0,0
Cook Islands,2012,sn,3544,0,0,0
Cook Islands,2012,sn,4554,0,0,0
Cook Islands,2012,sn,5564,0,0,0
Cook Islands,2012,sn,65,0,0,0
Cook Islands,2012,sp,014,0,0,0
Cook Islands,2012,sp,1524,0,0,0
Cook Islands,2012,sp,2534,0,0,0
Cook Islands,2012,sp,3544,0,0,0
Cook Islands,2012,sp,4554,0,0,0
Cook Islands,2012,sp,5564,0,0,0
Cook Islands,2012,sp,65,0,0,0
Cook Islands,2013,rel,014,0,0,0
Cook Islands,2013,rel,1524,0,0,0
Cook Islands,2013,rel,2534,0,0,0
Cook Islands,2013,rel,3544,0,0,0
Cook Islands,2013,rel,4554,0,0,0
Cook Islands,2013,rel,5564,0,1,1
Cook Islands,2013,rel,65,0,1,1
Costa Rica,1995,sp,014,2,1,3
Costa Rica,1995,sp,1524,17,17,34
Costa Rica,1995,sp,2534,15,38,53
Costa Rica,1995,sp,3544,11,24,35
Costa Rica,1995,sp,4554,7,19,26
Costa Rica,1995,sp,5564,9,23,32
Costa Rica,1995,sp,65,14,22,36
Costa Rica,1996,sp,014,0,0,0
Costa Rica,1996,sp,1524,4,11,15
Costa Rica,1996,sp,2534,9,11,20
Costa Rica,1996,sp,3544,7,19,26
Costa Rica,1996,sp,4554,3,15,18
Costa Rica,1996,sp,5564,4,19,23
Costa Rica,1996,sp,65,5,15,20
Costa Rica,1997,sp,014,31,37,68
Costa Rica,1997,sp,1524,28,30,58
Costa Rica,1997,sp,2534,45,82,127
Costa Rica,1997,sp,3544,40,69,109
Costa Rica,1997,sp,4554,30,52,82
Costa Rica,1997,sp,5564,24,35,59
Costa Rica,1997,sp,65,30,45,75
Costa Rica,1998,sp,014,23,30,53
Costa Rica,1998,sp,1524,19,53,72
Costa Rica,1998,sp,2534,43,78,121
Costa Rica,1998,sp,3544,47,67,114
Costa Rica,1998,sp,4554,27,53,80
Costa Rica,1998,sp,5564,17,43,60
Costa Rica,1998,sp,65,26,36,62
Costa Rica,1999,sp,014,10,4,14
Costa Rica,1999,sp,1524,23,28,51
Costa Rica,1999,sp,2534,42,63,105
Costa Rica,1999,sp,3544,37,89,126
Costa Rica,1999,sp,4554,32,70,102
Costa Rica,1999,sp,5564,33,51,84
Costa Rica,1999,sp,65,36,73,109
Costa Rica,2000,sp,014,13,14,27
Costa Rica,2000,sp,1524,21,31,52
Costa Rica,2000,sp,2534,33,53,86
Costa Rica,2000,sp,3544,24,62,86
Costa Rica,2000,sp,4554,20,39,59
Costa Rica,2000,sp,5564,23,28,51
Costa Rica,2000,sp,65,24,49,73
Costa Rica,2001,sp,014,1,2,3
Costa Rica,2001,sp,1524,18,26,44
Costa Rica,2001,sp,2534,31,53,84
Costa Rica,2001,sp,3544,20,72,92
Costa Rica,2001,sp,4554,16,50,66
Costa Rica,2001,sp,5564,16,29,45
Costa Rica,2001,sp,65,15,36,51
Costa Rica,2002,sp,014,6,3,9
Costa Rica,2002,sp,1524,13,26,39
Costa Rica,2002,sp,2534,24,45,69
Costa Rica,2002,sp,3544,19,44,63
Costa Rica,2002,sp,4554,14,43,57
Costa Rica,2002,sp,5564,15,19,34
Costa Rica,2002,sp,65,19,38,57
Costa Rica,2003,sp,014,4,3,7
Costa Rica,2003,sp,1524,25,33,58
Costa Rica,2003,sp,2534,24,47,71
Costa Rica,2003,sp,3544,21,32,53
Costa Rica,2003,sp,4554,30,39,69
Costa Rica,2003,sp,5564,11,28,39
Costa Rica,2003,sp,65,16,33,49
Costa Rica,2004,sp,014,5,1,6
Costa Rica,2004,sp,1524,35,49,84
Costa Rica,2004,sp,2534,29,62,91
Costa Rica,2004,sp,3544,34,45,79
Costa Rica,2004,sp,4554,11,36,47
Costa Rica,2004,sp,5564,18,29,47
Costa Rica,2004,sp,65,22,43,65
Costa Rica,2005,sp,014,1,1,2
Costa Rica,2005,sp,1524,21,43,64
Costa Rica,2005,sp,2534,31,38,69
Costa Rica,2005,sp,3544,18,53,71
Costa Rica,2005,sp,4554,16,34,50
Costa Rica,2005,sp,5564,6,20,26
Costa Rica,2005,sp,65,14,34,48
Costa Rica,2006,ep,014,3,2,5
Costa Rica,2006,ep,1524,4,10,14
Costa Rica,2006,ep,2534,7,16,23
Costa Rica,2006,ep,3544,7,13,20
Costa Rica,2006,ep,4554,5,5,10
Costa Rica,2006,ep,5564,6,8,14
Costa Rica,2006,ep,65,4,5,9
Costa Rica,2006,sn,014,9,12,21
Costa Rica,2006,sn,1524,5,1,6
Costa Rica,2006,sn,2534,5,10,15
Costa Rica,2006,sn,3544,8,6,14
Costa Rica,2006,sn,4554,8,7,15
Costa Rica,2006,sn,5564,3,7,10
Costa Rica,2006,sn,65,2,9,11
Costa Rica,2006,sp,014,4,1,5
Costa Rica,2006,sp,1524,27,27,54
Costa Rica,2006,sp,2534,24,36,60
Costa Rica,2006,sp,3544,20,29,49
Costa Rica,2006,sp,4554,15,34,49
Costa Rica,2006,sp,5564,8,25,33
Costa Rica,2006,sp,65,11,24,35
Costa Rica,2007,ep,014,3,4,7
Costa Rica,2007,ep,1524,4,5,9
Costa Rica,2007,ep,2534,1,11,12
Costa Rica,2007,ep,3544,4,10,14
Costa Rica,2007,ep,4554,5,9,14
Costa Rica,2007,ep,5564,6,13,19
Costa Rica,2007,ep,65,8,8,16
Costa Rica,2007,sn,014,7,10,17
Costa Rica,2007,sn,1524,3,12,15
Costa Rica,2007,sn,2534,5,10,15
Costa Rica,2007,sn,3544,4,6,10
Costa Rica,2007,sn,4554,5,23,28
Costa Rica,2007,sn,5564,6,8,14
Costa Rica,2007,sn,65,3,8,11
Costa Rica,2007,sp,014,3,4,7
Costa Rica,2007,sp,1524,16,44,60
Costa Rica,2007,sp,2534,24,57,81
Costa Rica,2007,sp,3544,19,28,47
Costa Rica,2007,sp,4554,16,32,48
Costa Rica,2007,sp,5564,16,17,33
Costa Rica,2007,sp,65,15,31,46
Costa Rica,2008,ep,014,4,2,6
Costa Rica,2008,ep,1524,9,12,21
Costa Rica,2008,ep,2534,3,12,15
Costa Rica,2008,ep,3544,10,8,18
Costa Rica,2008,ep,4554,8,10,18
Costa Rica,2008,ep,5564,5,9,14
Costa Rica,2008,ep,65,2,13,15
Costa Rica,2008,sn,014,20,12,32
Costa Rica,2008,sn,1524,3,4,7
Costa Rica,2008,sn,2534,NA,6,NA
Costa Rica,2008,sn,3544,4,8,12
Costa Rica,2008,sn,4554,5,9,14
Costa Rica,2008,sn,5564,3,4,7
Costa Rica,2008,sn,65,4,11,15
Costa Rica,2008,sp,014,2,3,5
Costa Rica,2008,sp,1524,19,24,43
Costa Rica,2008,sp,2534,31,39,70
Costa Rica,2008,sp,3544,20,31,51
Costa Rica,2008,sp,4554,14,38,52
Costa Rica,2008,sp,5564,6,17,23
Costa Rica,2008,sp,65,14,29,43
Costa Rica,2009,ep,014,4,3,7
Costa Rica,2009,ep,1524,4,8,12
Costa Rica,2009,ep,2534,8,11,19
Costa Rica,2009,ep,3544,4,16,20
Costa Rica,2009,ep,4554,3,12,15
Costa Rica,2009,ep,5564,5,1,6
Costa Rica,2009,ep,65,2,8,10
Costa Rica,2009,sn,014,20,16,36
Costa Rica,2009,sn,1524,3,6,9
Costa Rica,2009,sn,2534,7,4,11
Costa Rica,2009,sn,3544,4,15,19
Costa Rica,2009,sn,4554,6,6,12
Costa Rica,2009,sn,5564,2,6,8
Costa Rica,2009,sn,65,2,15,17
Costa Rica,2009,sp,1524,27,26,53
Costa Rica,2009,sp,2534,22,49,71
Costa Rica,2009,sp,3544,12,27,39
Costa Rica,2009,sp,4554,10,26,36
Costa Rica,2009,sp,5564,8,24,32
Costa Rica,2009,sp,65,11,29,40
Costa Rica,2010,ep,014,1,2,3
Costa Rica,2010,ep,1524,0,8,8
Costa Rica,2010,ep,2534,9,12,21
Costa Rica,2010,ep,3544,6,13,19
Costa Rica,2010,ep,4554,3,15,18
Costa Rica,2010,ep,5564,6,8,14
Costa Rica,2010,ep,65,7,18,25
Costa Rica,2010,sn,014,13,12,25
Costa Rica,2010,sn,1524,4,7,11
Costa Rica,2010,sn,2534,1,4,5
Costa Rica,2010,sn,3544,2,8,10
Costa Rica,2010,sn,4554,3,5,8
Costa Rica,2010,sn,5564,2,9,11
Costa Rica,2010,sn,65,7,12,19
Costa Rica,2010,sp,014,0,2,2
Costa Rica,2010,sp,1524,18,18,36
Costa Rica,2010,sp,2534,20,48,68
Costa Rica,2010,sp,3544,12,33,45
Costa Rica,2010,sp,4554,14,27,41
Costa Rica,2010,sp,5564,15,22,37
Costa Rica,2010,sp,65,8,28,36
Costa Rica,2011,ep,014,3,4,7
Costa Rica,2011,ep,1524,3,4,7
Costa Rica,2011,ep,2534,6,6,12
Costa Rica,2011,ep,3544,5,11,16
Costa Rica,2011,ep,4554,7,11,18
Costa Rica,2011,ep,5564,4,4,8
Costa Rica,2011,ep,65,6,11,17
Costa Rica,2011,sn,014,15,18,33
Costa Rica,2011,sn,1524,10,7,17
Costa Rica,2011,sn,2534,5,2,7
Costa Rica,2011,sn,3544,4,9,13
Costa Rica,2011,sn,4554,9,8,17
Costa Rica,2011,sn,5564,1,9,10
Costa Rica,2011,sn,65,6,25,31
Costa Rica,2011,sp,014,2,0,2
Costa Rica,2011,sp,1524,18,23,41
Costa Rica,2011,sp,2534,27,24,51
Costa Rica,2011,sp,3544,23,29,52
Costa Rica,2011,sp,4554,19,33,52
Costa Rica,2011,sp,5564,12,22,34
Costa Rica,2011,sp,65,17,36,53
Costa Rica,2012,ep,014,3,4,7
Costa Rica,2012,ep,1524,5,3,8
Costa Rica,2012,ep,2534,8,19,27
Costa Rica,2012,ep,3544,3,22,25
Costa Rica,2012,ep,4554,4,9,13
Costa Rica,2012,ep,5564,2,8,10
Costa Rica,2012,ep,65,2,10,12
Costa Rica,2012,sn,014,9,13,22
Costa Rica,2012,sn,1524,2,5,7
Costa Rica,2012,sn,2534,5,6,11
Costa Rica,2012,sn,3544,12,9,21
Costa Rica,2012,sn,4554,6,6,12
Costa Rica,2012,sn,5564,5,7,12
Costa Rica,2012,sn,65,3,9,12
Costa Rica,2012,sp,014,2,2,4
Costa Rica,2012,sp,1524,11,18,29
Costa Rica,2012,sp,2534,24,33,57
Costa Rica,2012,sp,3544,11,28,39
Costa Rica,2012,sp,4554,12,34,46
Costa Rica,2012,sp,5564,8,41,49
Costa Rica,2012,sp,65,5,23,28
Costa Rica,2013,rel,014,9,23,32
Costa Rica,2013,rel,1524,15,28,43
Costa Rica,2013,rel,2534,35,41,76
Costa Rica,2013,rel,3544,23,37,60
Costa Rica,2013,rel,4554,13,37,50
Costa Rica,2013,rel,5564,11,47,58
Costa Rica,2013,rel,65,42,46,88
Cote d'Ivoire,1995,sp,014,99,41,140
Cote d'Ivoire,1995,sp,1524,810,989,1799
Cote d'Ivoire,1995,sp,2534,813,2092,2905
Cote d'Ivoire,1995,sp,3544,497,1344,1841
Cote d'Ivoire,1995,sp,4554,273,759,1032
Cote d'Ivoire,1995,sp,5564,105,283,388
Cote d'Ivoire,1995,sp,65,19,130,149
Cote d'Ivoire,1996,sp,014,139,118,257
Cote d'Ivoire,1996,sp,1524,803,903,1706
Cote d'Ivoire,1996,sp,2534,836,1670,2506
Cote d'Ivoire,1996,sp,3544,409,1107,1516
Cote d'Ivoire,1996,sp,4554,194,535,729
Cote d'Ivoire,1996,sp,5564,158,262,420
Cote d'Ivoire,1996,sp,65,75,178,253
Cote d'Ivoire,1997,sp,014,118,87,205
Cote d'Ivoire,1997,sp,1524,955,1140,2095
Cote d'Ivoire,1997,sp,2534,1123,1850,2973
Cote d'Ivoire,1997,sp,3544,548,1326,1874
Cote d'Ivoire,1997,sp,4554,291,662,953
Cote d'Ivoire,1997,sp,5564,184,398,582
Cote d'Ivoire,1997,sp,65,99,260,359
Cote d'Ivoire,1998,sp,014,104,72,176
Cote d'Ivoire,1998,sp,1524,955,1173,2128
Cote d'Ivoire,1998,sp,2534,1087,1747,2834
Cote d'Ivoire,1998,sp,3544,703,1471,2174
Cote d'Ivoire,1998,sp,4554,347,795,1142
Cote d'Ivoire,1998,sp,5564,126,433,559
Cote d'Ivoire,1998,sp,65,105,273,378
Cote d'Ivoire,1999,sp,014,132,98,230
Cote d'Ivoire,1999,sp,1524,1022,1069,2091
Cote d'Ivoire,1999,sp,2534,1137,1794,2931
Cote d'Ivoire,1999,sp,3544,644,1240,1884
Cote d'Ivoire,1999,sp,4554,260,629,889
Cote d'Ivoire,1999,sp,5564,186,378,564
Cote d'Ivoire,1999,sp,65,112,251,363
Cote d'Ivoire,2001,sp,014,127,108,235
Cote d'Ivoire,2001,sp,1524,1111,1205,2316
Cote d'Ivoire,2001,sp,2534,1345,1818,3163
Cote d'Ivoire,2001,sp,3544,735,1378,2113
Cote d'Ivoire,2001,sp,4554,342,686,1028
Cote d'Ivoire,2001,sp,5564,239,393,632
Cote d'Ivoire,2001,sp,65,112,302,414
Cote d'Ivoire,2002,sp,014,135,102,237
Cote d'Ivoire,2002,sp,1524,1151,1271,2422
Cote d'Ivoire,2002,sp,2534,1620,2194,3814
Cote d'Ivoire,2002,sp,3544,827,1490,2317
Cote d'Ivoire,2002,sp,4554,358,833,1191
Cote d'Ivoire,2002,sp,5564,210,385,595
Cote d'Ivoire,2002,sp,65,142,307,449
Cote d'Ivoire,2003,sp,014,154,116,270
Cote d'Ivoire,2003,sp,1524,1193,1232,2425
Cote d'Ivoire,2003,sp,2534,1617,2075,3692
Cote d'Ivoire,2003,sp,3544,878,1517,2395
Cote d'Ivoire,2003,sp,4554,443,818,1261
Cote d'Ivoire,2003,sp,5564,222,416,638
Cote d'Ivoire,2003,sp,65,151,366,517
Cote d'Ivoire,2004,sp,014,160,114,274
Cote d'Ivoire,2004,sp,1524,1266,1418,2684
Cote d'Ivoire,2004,sp,2534,1734,2323,4057
Cote d'Ivoire,2004,sp,3544,916,1530,2446
Cote d'Ivoire,2004,sp,4554,472,875,1347
Cote d'Ivoire,2004,sp,5564,273,474,747
Cote d'Ivoire,2004,sp,65,194,387,581
Cote d'Ivoire,2005,sp,014,193,128,321
Cote d'Ivoire,2005,sp,1524,1280,1346,2626
Cote d'Ivoire,2005,sp,2534,1756,2449,4205
Cote d'Ivoire,2005,sp,3544,989,1606,2595
Cote d'Ivoire,2005,sp,4554,528,888,1416
Cote d'Ivoire,2005,sp,5564,232,422,654
Cote d'Ivoire,2005,sp,65,201,385,586
Cote d'Ivoire,2006,sp,014,191,171,362
Cote d'Ivoire,2006,sp,1524,1327,1467,2794
Cote d'Ivoire,2006,sp,2534,1776,2476,4252
Cote d'Ivoire,2006,sp,3544,1069,1614,2683
Cote d'Ivoire,2006,sp,4554,445,915,1360
Cote d'Ivoire,2006,sp,5564,275,564,839
Cote d'Ivoire,2006,sp,65,209,368,577
Cote d'Ivoire,2007,sp,014,225,173,398
Cote d'Ivoire,2007,sp,1524,1349,1576,2925
Cote d'Ivoire,2007,sp,2534,1973,2705,4678
Cote d'Ivoire,2007,sp,3544,1126,1817,2943
Cote d'Ivoire,2007,sp,4554,596,981,1577
Cote d'Ivoire,2007,sp,5564,354,532,886
Cote d'Ivoire,2007,sp,65,235,429,664
Cote d'Ivoire,2008,sp,014,277,261,538
Cote d'Ivoire,2008,sp,1524,1477,1764,3241
Cote d'Ivoire,2008,sp,2534,2085,2944,5029
Cote d'Ivoire,2008,sp,3544,1171,1842,3013
Cote d'Ivoire,2008,sp,4554,641,1121,1762
Cote d'Ivoire,2008,sp,5564,326,649,975
Cote d'Ivoire,2008,sp,65,254,482,736
Cote d'Ivoire,2009,sp,014,237,199,436
Cote d'Ivoire,2009,sp,1524,1473,1758,3231
Cote d'Ivoire,2009,sp,2534,1913,2886,4799
Cote d'Ivoire,2009,sp,3544,1073,1762,2835
Cote d'Ivoire,2009,sp,4554,559,1048,1607
Cote d'Ivoire,2009,sp,5564,301,527,828
Cote d'Ivoire,2009,sp,65,210,354,564
Cote d'Ivoire,2010,sp,014,246,159,405
Cote d'Ivoire,2010,sp,1524,1431,1751,3182
Cote d'Ivoire,2010,sp,2534,1819,2858,4677
Cote d'Ivoire,2010,sp,3544,1051,1882,2933
Cote d'Ivoire,2010,sp,4554,531,1010,1541
Cote d'Ivoire,2010,sp,5564,304,505,809
Cote d'Ivoire,2010,sp,65,209,375,584
Cote d'Ivoire,2011,sp,014,244,189,433
Cote d'Ivoire,2011,sp,1524,1358,1743,3101
Cote d'Ivoire,2011,sp,2534,1838,3043,4881
Cote d'Ivoire,2011,sp,3544,1044,1852,2896
Cote d'Ivoire,2011,sp,4554,560,1072,1632
Cote d'Ivoire,2011,sp,5564,301,601,902
Cote d'Ivoire,2011,sp,65,223,348,571
Cote d'Ivoire,2012,sp,014,204,163,367
Cote d'Ivoire,2012,sp,1524,1306,1743,3049
Cote d'Ivoire,2012,sp,2534,1870,3087,4957
Cote d'Ivoire,2012,sp,3544,1120,2017,3137
Cote d'Ivoire,2012,sp,4554,536,1032,1568
Cote d'Ivoire,2012,sp,5564,337,552,889
Cote d'Ivoire,2012,sp,65,263,430,693
Cote d'Ivoire,2013,rel,014,242,148,390
Cote d'Ivoire,2013,rel,1524,1416,1770,3186
Cote d'Ivoire,2013,rel,2534,1827,3270,5097
Cote d'Ivoire,2013,rel,3544,1111,2161,3272
Cote d'Ivoire,2013,rel,4554,560,1134,1694
Cote d'Ivoire,2013,rel,5564,314,588,902
Cote d'Ivoire,2013,rel,65,280,420,700
Croatia,1995,sp,014,10,6,16
Croatia,1995,sp,1524,50,38,88
Croatia,1995,sp,2534,57,97,154
Croatia,1995,sp,3544,57,210,267
Croatia,1995,sp,4554,38,132,170
Croatia,1995,sp,5564,60,178,238
Croatia,1995,sp,65,130,141,271
Croatia,1997,sp,014,13,12,25
Croatia,1997,sp,1524,43,65,108
Croatia,1997,sp,2534,43,88,131
Croatia,1997,sp,3544,54,180,234
Croatia,1997,sp,4554,28,124,152
Croatia,1997,sp,5564,52,118,170
Croatia,1997,sp,65,136,117,253
Croatia,1998,sp,014,19,14,33
Croatia,1998,sp,1524,44,48,92
Croatia,1998,sp,2534,64,81,145
Croatia,1998,sp,3544,54,177,231
Croatia,1998,sp,4554,38,176,214
Croatia,1998,sp,5564,48,106,154
Croatia,1998,sp,65,131,129,260
Croatia,1999,sp,014,2,1,3
Croatia,1999,sp,1524,14,29,43
Croatia,1999,sp,2534,18,45,63
Croatia,1999,sp,3544,15,83,98
Croatia,1999,sp,4554,15,93,108
Croatia,1999,sp,5564,16,46,62
Croatia,1999,sp,65,53,45,98
Croatia,2001,sp,014,2,0,2
Croatia,2001,sp,1524,32,32,64
Croatia,2001,sp,2534,36,64,100
Croatia,2001,sp,3544,54,186,240
Croatia,2001,sp,4554,34,126,160
Croatia,2001,sp,5564,28,88,116
Croatia,2001,sp,65,92,64,156
Croatia,2002,sp,014,0,1,1
Croatia,2002,sp,1524,18,18,36
Croatia,2002,sp,2534,18,40,58
Croatia,2002,sp,3544,20,75,95
Croatia,2002,sp,4554,19,77,96
Croatia,2002,sp,5564,16,32,48
Croatia,2002,sp,65,54,43,97
Croatia,2003,sp,014,1,0,1
Croatia,2003,sp,1524,14,15,29
Croatia,2003,sp,2534,19,27,46
Croatia,2003,sp,3544,18,68,86
Croatia,2003,sp,4554,10,80,90
Croatia,2003,sp,5564,15,42,57
Croatia,2003,sp,65,69,60,129
Croatia,2004,sp,014,3,1,4
Croatia,2004,sp,1524,18,18,36
Croatia,2004,sp,2534,17,32,49
Croatia,2004,sp,3544,11,68,79
Croatia,2004,sp,4554,12,81,93
Croatia,2004,sp,5564,7,39,46
Croatia,2004,sp,65,56,53,109
Croatia,2005,sp,014,1,1,2
Croatia,2005,sp,1524,12,24,36
Croatia,2005,sp,2534,18,27,45
Croatia,2005,sp,3544,15,48,63
Croatia,2005,sp,4554,11,72,83
Croatia,2005,sp,5564,6,47,53
Croatia,2005,sp,65,56,34,90
Croatia,2006,ep,014,2,2,4
Croatia,2006,ep,1524,5,7,12
Croatia,2006,ep,2534,1,3,4
Croatia,2006,ep,3544,7,5,12
Croatia,2006,ep,4554,12,18,30
Croatia,2006,ep,5564,9,6,15
Croatia,2006,ep,65,21,15,36
Croatia,2006,sn,014,12,10,22
Croatia,2006,sn,1524,9,21,30
Croatia,2006,sn,2534,19,23,42
Croatia,2006,sn,3544,31,41,72
Croatia,2006,sn,4554,15,75,90
Croatia,2006,sn,5564,21,54,75
Croatia,2006,sn,65,89,99,188
Croatia,2006,sp,014,2,0,2
Croatia,2006,sp,1524,16,20,36
Croatia,2006,sp,2534,26,23,49
Croatia,2006,sp,3544,16,58,74
Croatia,2006,sp,4554,22,69,91
Croatia,2006,sp,5564,7,30,37
Croatia,2006,sp,65,59,48,107
Croatia,2007,ep,014,0,0,0
Croatia,2007,ep,1524,0,0,0
Croatia,2007,ep,2534,0,0,0
Croatia,2007,ep,3544,0,2,2
Croatia,2007,ep,4554,0,1,1
Croatia,2007,ep,5564,0,0,0
Croatia,2007,ep,65,2,2,4
Croatia,2007,sn,014,0,0,0
Croatia,2007,sn,1524,2,1,3
Croatia,2007,sn,2534,3,2,5
Croatia,2007,sn,3544,2,7,9
Croatia,2007,sn,4554,4,13,17
Croatia,2007,sn,5564,1,8,9
Croatia,2007,sn,65,11,15,26
Croatia,2008,ep,014,1,2,3
Croatia,2008,ep,1524,1,4,5
Croatia,2008,ep,2534,3,4,7
Croatia,2008,ep,3544,3,10,13
Croatia,2008,ep,4554,13,7,20
Croatia,2008,ep,5564,3,6,9
Croatia,2008,ep,65,25,19,44
Croatia,2008,sn,014,10,13,23
Croatia,2008,sn,1524,16,17,33
Croatia,2008,sn,2534,23,18,41
Croatia,2008,sn,3544,17,40,57
Croatia,2008,sn,4554,21,62,83
Croatia,2008,sn,5564,26,50,76
Croatia,2008,sn,65,101,88,189
Croatia,2008,sp,014,1,0,1
Croatia,2008,sp,1524,11,15,26
Croatia,2008,sp,2534,16,25,41
Croatia,2008,sp,3544,13,34,47
Croatia,2008,sp,4554,15,63,78
Croatia,2008,sp,5564,12,32,44
Croatia,2008,sp,65,44,47,91
Croatia,2009,ep,014,0,1,1
Croatia,2009,ep,1524,1,0,1
Croatia,2009,ep,2534,1,6,7
Croatia,2009,ep,3544,4,5,9
Croatia,2009,ep,4554,6,7,13
Croatia,2009,ep,5564,5,8,13
Croatia,2009,ep,65,21,16,37
Croatia,2009,sn,014,11,13,24
Croatia,2009,sn,1524,13,21,34
Croatia,2009,sn,2534,18,17,35
Croatia,2009,sn,3544,12,28,40
Croatia,2009,sn,4554,16,54,70
Croatia,2009,sn,5564,18,40,58
Croatia,2009,sn,65,73,76,149
Croatia,2009,sp,014,0,0,0
Croatia,2009,sp,1524,12,14,26
Croatia,2009,sp,2534,8,25,33
Croatia,2009,sp,3544,14,41,55
Croatia,2009,sp,4554,5,61,66
Croatia,2009,sp,5564,10,34,44
Croatia,2009,sp,65,40,38,78
Croatia,2010,ep,014,0,0,0
Croatia,2010,ep,1524,0,3,3
Croatia,2010,ep,2534,4,5,9
Croatia,2010,ep,3544,6,5,11
Croatia,2010,ep,4554,9,6,15
Croatia,2010,ep,5564,6,7,13
Croatia,2010,ep,65,24,12,36
Croatia,2010,sn,014,10,7,17
Croatia,2010,sn,1524,13,8,21
Croatia,2010,sn,2534,15,14,29
Croatia,2010,sn,3544,21,22,43
Croatia,2010,sn,4554,15,47,62
Croatia,2010,sn,5564,14,56,70
Croatia,2010,sn,65,60,80,140
Croatia,2010,sp,014,1,0,1
Croatia,2010,sp,1524,3,10,13
Croatia,2010,sp,2534,8,19,27
Croatia,2010,sp,3544,4,18,22
Croatia,2010,sp,4554,2,38,40
Croatia,2010,sp,5564,1,25,26
Croatia,2010,sp,65,30,24,54
Croatia,2011,ep,014,2,0,2
Croatia,2011,ep,1524,2,0,2
Croatia,2011,ep,2534,5,1,6
Croatia,2011,ep,3544,2,0,2
Croatia,2011,ep,4554,7,6,13
Croatia,2011,ep,5564,9,5,14
Croatia,2011,ep,65,22,14,36
Croatia,2011,sn,014,7,4,11
Croatia,2011,sn,1524,10,12,22
Croatia,2011,sn,2534,10,15,25
Croatia,2011,sn,3544,16,30,46
Croatia,2011,sn,4554,14,40,54
Croatia,2011,sn,5564,24,53,77
Croatia,2011,sn,65,63,45,108
Croatia,2011,sp,014,0,0,0
Croatia,2011,sp,1524,12,12,24
Croatia,2011,sp,2534,14,5,19
Croatia,2011,sp,3544,14,20,34
Croatia,2011,sp,4554,8,31,39
Croatia,2011,sp,5564,7,31,38
Croatia,2011,sp,65,26,21,47
Croatia,2012,ep,014,0,2,2
Croatia,2012,ep,1524,2,2,4
Croatia,2012,ep,2534,1,3,4
Croatia,2012,ep,3544,3,7,10
Croatia,2012,ep,4554,4,5,9
Croatia,2012,ep,5564,6,5,11
Croatia,2012,ep,65,12,11,23
Croatia,2012,sn,014,5,5,10
Croatia,2012,sn,1524,4,9,13
Croatia,2012,sn,2534,16,15,31
Croatia,2012,sn,3544,19,19,38
Croatia,2012,sn,4554,14,41,55
Croatia,2012,sn,5564,23,57,80
Croatia,2012,sn,65,60,49,109
Croatia,2012,sp,014,0,0,0
Croatia,2012,sp,1524,0,7,7
Croatia,2012,sp,2534,10,10,20
Croatia,2012,sp,3544,2,18,20
Croatia,2012,sp,4554,2,24,26
Croatia,2012,sp,5564,3,29,32
Croatia,2012,sp,65,21,14,35
Croatia,2013,rel,014,3,1,4
Croatia,2013,rel,1524,11,19,30
Croatia,2013,rel,2534,18,29,47
Croatia,2013,rel,3544,17,32,49
Croatia,2013,rel,4554,32,66,98
Croatia,2013,rel,5564,25,74,99
Croatia,2013,rel,65,91,93,184
Cuba,1995,sp,014,1,2,3
Cuba,1995,sp,1524,17,59,76
Cuba,1995,sp,2534,52,118,170
Cuba,1995,sp,3544,29,83,112
Cuba,1995,sp,4554,39,75,114
Cuba,1995,sp,5564,48,75,123
Cuba,1995,sp,65,80,156,236
Cuba,1996,sp,014,1,0,1
Cuba,1996,sp,1524,29,54,83
Cuba,1996,sp,2534,44,136,180
Cuba,1996,sp,3544,20,86,106
Cuba,1996,sp,4554,45,93,138
Cuba,1996,sp,5564,42,84,126
Cuba,1996,sp,65,63,138,201
Cuba,1997,sp,014,2,0,2
Cuba,1997,sp,1524,16,69,85
Cuba,1997,sp,2534,49,151,200
Cuba,1997,sp,3544,33,83,116
Cuba,1997,sp,4554,32,63,95
Cuba,1997,sp,5564,28,77,105
Cuba,1997,sp,65,46,116,162
Cuba,1998,sp,014,1,0,1
Cuba,1998,sp,1524,17,60,77
Cuba,1998,sp,2534,48,140,188
Cuba,1998,sp,3544,23,109,132
Cuba,1998,sp,4554,30,75,105
Cuba,1998,sp,5564,31,53,84
Cuba,1998,sp,65,55,102,157
Cuba,1999,sp,014,2,1,3
Cuba,1999,sp,1524,15,55,70
Cuba,1999,sp,2534,37,163,200
Cuba,1999,sp,3544,27,97,124
Cuba,1999,sp,4554,20,68,88
Cuba,1999,sp,5564,28,72,100
Cuba,1999,sp,65,35,100,135
Cuba,2000,sp,014,2,0,2
Cuba,2000,sp,1524,9,71,80
Cuba,2000,sp,2534,22,167,189
Cuba,2000,sp,3544,26,90,116
Cuba,2000,sp,4554,22,74,96
Cuba,2000,sp,5564,23,55,78
Cuba,2000,sp,65,39,75,114
Cuba,2001,sp,014,1,0,1
Cuba,2001,sp,1524,24,36,60
Cuba,2001,sp,2534,17,136,153
Cuba,2001,sp,3544,22,87,109
Cuba,2001,sp,4554,17,39,56
Cuba,2001,sp,5564,20,54,74
Cuba,2001,sp,65,39,67,106
Cuba,2002,sp,014,3,0,3
Cuba,2002,sp,1524,15,21,36
Cuba,2002,sp,2534,28,104,132
Cuba,2002,sp,3544,22,83,105
Cuba,2002,sp,4554,21,67,88
Cuba,2002,sp,5564,20,45,65
Cuba,2002,sp,65,34,77,111
Cuba,2003,sp,014,0,2,2
Cuba,2003,sp,1524,11,23,34
Cuba,2003,sp,2534,14,90,104
Cuba,2003,sp,3544,20,91,111
Cuba,2003,sp,4554,23,62,85
Cuba,2003,sp,5564,13,51,64
Cuba,2003,sp,65,29,78,107
Cuba,2004,sp,014,0,0,0
Cuba,2004,sp,1524,16,17,33
Cuba,2004,sp,2534,20,68,88
Cuba,2004,sp,3544,15,95,110
Cuba,2004,sp,4554,16,63,79
Cuba,2004,sp,5564,20,45,65
Cuba,2004,sp,65,29,50,79
Cuba,2005,sp,014,2,2,4
Cuba,2005,sp,1524,14,20,34
Cuba,2005,sp,2534,17,73,90
Cuba,2005,sp,3544,26,90,116
Cuba,2005,sp,4554,13,50,63
Cuba,2005,sp,5564,22,58,80
Cuba,2005,sp,65,29,51,80
Cuba,2006,ep,014,2,1,3
Cuba,2006,ep,1524,4,6,10
Cuba,2006,ep,2534,3,24,27
Cuba,2006,ep,3544,5,23,28
Cuba,2006,ep,4554,4,10,14
Cuba,2006,ep,5564,NA,7,NA
Cuba,2006,ep,65,4,3,7
Cuba,2006,sn,014,2,2,4
Cuba,2006,sn,1524,4,4,8
Cuba,2006,sn,2534,4,20,24
Cuba,2006,sn,3544,8,31,39
Cuba,2006,sn,4554,6,27,33
Cuba,2006,sn,5564,14,32,46
Cuba,2006,sn,65,10,24,34
Cuba,2006,sp,1524,8,22,30
Cuba,2006,sp,2534,18,73,91
Cuba,2006,sp,3544,22,93,115
Cuba,2006,sp,4554,12,50,62
Cuba,2006,sp,5564,14,47,61
Cuba,2006,sp,65,23,50,73
Cuba,2008,ep,014,0,1,1
Cuba,2008,ep,1524,3,11,14
Cuba,2008,ep,2534,2,20,22
Cuba,2008,ep,3544,6,23,29
Cuba,2008,ep,4554,3,14,17
Cuba,2008,ep,5564,4,9,13
Cuba,2008,ep,65,4,6,10
Cuba,2008,sn,014,4,9,13
Cuba,2008,sn,1524,5,8,13
Cuba,2008,sn,2534,4,18,22
Cuba,2008,sn,3544,8,30,38
Cuba,2008,sn,4554,10,15,25
Cuba,2008,sn,5564,7,17,24
Cuba,2008,sn,65,13,19,32
Cuba,2008,sp,014,3,2,5
Cuba,2008,sp,1524,11,30,41
Cuba,2008,sp,2534,14,66,80
Cuba,2008,sp,3544,22,108,130
Cuba,2008,sp,4554,18,67,85
Cuba,2008,sp,5564,11,59,70
Cuba,2008,sp,65,34,53,87
Cuba,2009,ep,014,NA,1,NA
Cuba,2009,ep,1524,2,13,15
Cuba,2009,ep,2534,5,18,23
Cuba,2009,ep,3544,5,14,19
Cuba,2009,ep,4554,5,9,14
Cuba,2009,ep,5564,3,4,7
Cuba,2009,ep,65,2,10,12
Cuba,2009,sn,014,5,7,12
Cuba,2009,sn,1524,3,9,12
Cuba,2009,sn,2534,2,14,16
Cuba,2009,sn,3544,6,21,27
Cuba,2009,sn,4554,7,23,30
Cuba,2009,sn,5564,8,17,25
Cuba,2009,sn,65,9,19,28
Cuba,2009,sp,1524,10,16,26
Cuba,2009,sp,2534,13,57,70
Cuba,2009,sp,3544,16,72,88
Cuba,2009,sp,4554,13,70,83
Cuba,2009,sp,5564,14,42,56
Cuba,2009,sp,65,30,65,95
Cuba,2010,ep,014,1,0,1
Cuba,2010,ep,1524,6,5,11
Cuba,2010,ep,2534,2,16,18
Cuba,2010,ep,3544,8,19,27
Cuba,2010,ep,4554,3,11,14
Cuba,2010,ep,5564,4,15,19
Cuba,2010,ep,65,4,4,8
Cuba,2010,sn,014,5,11,16
Cuba,2010,sn,1524,2,5,7
Cuba,2010,sn,2534,2,17,19
Cuba,2010,sn,3544,6,29,35
Cuba,2010,sn,4554,11,30,41
Cuba,2010,sn,5564,10,29,39
Cuba,2010,sn,65,16,39,55
Cuba,2010,sp,014,1,3,4
Cuba,2010,sp,1524,15,17,32
Cuba,2010,sp,2534,15,61,76
Cuba,2010,sp,3544,14,89,103
Cuba,2010,sp,4554,16,78,94
Cuba,2010,sp,5564,17,53,70
Cuba,2010,sp,65,26,57,83
Cuba,2011,ep,014,0,1,1
Cuba,2011,ep,1524,4,5,9
Cuba,2011,ep,2534,4,13,17
Cuba,2011,ep,3544,4,18,22
Cuba,2011,ep,4554,9,11,20
Cuba,2011,ep,5564,5,3,8
Cuba,2011,ep,65,3,6,9
Cuba,2011,sn,014,4,5,9
Cuba,2011,sn,1524,3,5,8
Cuba,2011,sn,2534,6,19,25
Cuba,2011,sn,3544,10,20,30
Cuba,2011,sn,4554,6,37,43
Cuba,2011,sn,5564,5,25,30
Cuba,2011,sn,65,25,49,74
Cuba,2011,sp,014,1,2,3
Cuba,2011,sp,1524,6,14,20
Cuba,2011,sp,2534,18,51,69
Cuba,2011,sp,3544,18,83,101
Cuba,2011,sp,4554,17,86,103
Cuba,2011,sp,5564,17,50,67
Cuba,2011,sp,65,26,48,74
Cuba,2012,ep,014,3,0,3
Cuba,2012,ep,1524,3,13,16
Cuba,2012,ep,2534,6,18,24
Cuba,2012,ep,3544,4,13,17
Cuba,2012,ep,4554,6,14,20
Cuba,2012,ep,5564,2,10,12
Cuba,2012,ep,65,8,12,20
Cuba,2012,sn,014,8,6,14
Cuba,2012,sn,1524,4,4,8
Cuba,2012,sn,2534,4,18,22
Cuba,2012,sn,3544,9,30,39
Cuba,2012,sn,4554,7,32,39
Cuba,2012,sn,5564,14,23,37
Cuba,2012,sn,65,15,26,41
Cuba,2012,sp,014,0,1,1
Cuba,2012,sp,1524,13,15,28
Cuba,2012,sp,2534,12,45,57
Cuba,2012,sp,3544,16,83,99
Cuba,2012,sp,4554,12,70,82
Cuba,2012,sp,5564,13,45,58
Cuba,2012,sp,65,13,36,49
Cuba,2013,rel,014,4,5,9
Cuba,2013,rel,1524,15,23,38
Cuba,2013,rel,2534,31,82,113
Cuba,2013,rel,3544,30,136,166
Cuba,2013,rel,4554,31,145,176
Cuba,2013,rel,5564,28,89,117
Cuba,2013,rel,65,44,94,138
Curacao,2010,ep,014,0,0,0
Curacao,2010,ep,1524,0,0,0
Curacao,2010,ep,2534,0,0,0
Curacao,2010,ep,3544,0,0,0
Curacao,2010,ep,4554,0,0,0
Curacao,2010,ep,5564,0,0,0
Curacao,2010,ep,65,0,0,0
Curacao,2010,sn,014,0,0,0
Curacao,2010,sn,1524,0,0,0
Curacao,2010,sn,2534,0,0,0
Curacao,2010,sn,3544,0,0,0
Curacao,2010,sn,4554,0,0,0
Curacao,2010,sn,5564,0,0,0
Curacao,2010,sn,65,0,0,0
Curacao,2010,sp,014,0,0,0
Curacao,2010,sp,1524,1,0,1
Curacao,2010,sp,2534,1,0,1
Curacao,2010,sp,3544,0,2,2
Curacao,2010,sp,4554,0,1,1
Curacao,2010,sp,5564,0,0,0
Curacao,2010,sp,65,0,0,0
Curacao,2011,ep,014,0,0,0
Curacao,2011,ep,1524,0,0,0
Curacao,2011,ep,2534,0,0,0
Curacao,2011,ep,3544,0,0,0
Curacao,2011,ep,4554,0,0,0
Curacao,2011,ep,5564,0,0,0
Curacao,2011,ep,65,0,0,0
Curacao,2011,sn,014,1,0,1
Curacao,2011,sn,1524,0,0,0
Curacao,2011,sn,2534,0,0,0
Curacao,2011,sn,3544,0,0,0
Curacao,2011,sn,4554,0,0,0
Curacao,2011,sn,5564,0,0,0
Curacao,2011,sn,65,0,0,0
Curacao,2011,sp,014,0,0,0
Curacao,2011,sp,1524,0,0,0
Curacao,2011,sp,2534,0,0,0
Curacao,2011,sp,3544,0,0,0
Curacao,2011,sp,4554,0,0,0
Curacao,2011,sp,5564,0,0,0
Curacao,2011,sp,65,0,0,0
Curacao,2012,ep,014,0,0,0
Curacao,2012,ep,1524,0,0,0
Curacao,2012,ep,2534,0,0,0
Curacao,2012,ep,3544,0,0,0
Curacao,2012,ep,4554,0,0,0
Curacao,2012,ep,5564,0,0,0
Curacao,2012,ep,65,0,0,0
Curacao,2012,sn,014,0,0,0
Curacao,2012,sn,1524,0,0,0
Curacao,2012,sn,2534,0,0,0
Curacao,2012,sn,3544,0,0,0
Curacao,2012,sn,4554,0,0,0
Curacao,2012,sn,5564,0,0,0
Curacao,2012,sn,65,0,0,0
Curacao,2012,sp,014,0,0,0
Curacao,2012,sp,1524,1,0,1
Curacao,2012,sp,2534,0,0,0
Curacao,2012,sp,3544,0,0,0
Curacao,2012,sp,4554,0,0,0
Curacao,2012,sp,5564,0,0,0
Curacao,2012,sp,65,0,0,0
Curacao,2013,rel,014,0,0,0
Curacao,2013,rel,1524,0,0,0
Curacao,2013,rel,2534,0,0,0
Curacao,2013,rel,3544,1,0,1
Curacao,2013,rel,4554,0,0,0
Curacao,2013,rel,5564,0,1,1
Curacao,2013,rel,65,0,0,0
Cyprus,1995,sp,014,0,0,0
Cyprus,1995,sp,1524,1,1,2
Cyprus,1995,sp,2534,1,1,2
Cyprus,1995,sp,3544,1,0,1
Cyprus,1995,sp,4554,2,1,3
Cyprus,1995,sp,5564,0,1,1
Cyprus,1995,sp,65,1,2,3
Cyprus,1996,sp,014,0,0,0
Cyprus,1996,sp,1524,2,0,2
Cyprus,1996,sp,2534,0,0,0
Cyprus,1996,sp,3544,0,0,0
Cyprus,1996,sp,4554,0,0,0
Cyprus,1996,sp,5564,0,1,1
Cyprus,1996,sp,65,0,0,0
Cyprus,1998,sp,014,0,0,0
Cyprus,1998,sp,1524,1,0,1
Cyprus,1998,sp,2534,3,1,4
Cyprus,1998,sp,3544,0,0,0
Cyprus,1998,sp,4554,0,0,0
Cyprus,1998,sp,5564,0,0,0
Cyprus,1998,sp,65,0,1,1
Cyprus,1999,sp,014,4,5,9
Cyprus,1999,sp,1524,1,1,2
Cyprus,1999,sp,2534,2,6,8
Cyprus,1999,sp,3544,3,2,5
Cyprus,1999,sp,4554,1,2,3
Cyprus,1999,sp,5564,2,10,12
Cyprus,1999,sp,65,0,0,0
Cyprus,2002,sp,014,0,0,0
Cyprus,2002,sp,1524,1,2,3
Cyprus,2002,sp,2534,0,1,1
Cyprus,2002,sp,3544,0,1,1
Cyprus,2002,sp,4554,0,1,1
Cyprus,2002,sp,5564,0,0,0
Cyprus,2002,sp,65,0,2,2
Cyprus,2003,sp,014,0,0,0
Cyprus,2003,sp,1524,0,1,1
Cyprus,2003,sp,2534,2,4,6
Cyprus,2003,sp,3544,2,3,5
Cyprus,2003,sp,4554,1,0,1
Cyprus,2003,sp,5564,0,0,0
Cyprus,2003,sp,65,0,1,1
Cyprus,2004,sp,014,0,0,0
Cyprus,2004,sp,1524,1,3,4
Cyprus,2004,sp,2534,0,3,3
Cyprus,2004,sp,3544,0,0,0
Cyprus,2004,sp,4554,0,1,1
Cyprus,2004,sp,5564,0,1,1
Cyprus,2004,sp,65,0,1,1
Cyprus,2005,sp,014,0,0,0
Cyprus,2005,sp,1524,1,3,4
Cyprus,2005,sp,2534,0,1,1
Cyprus,2005,sp,3544,0,1,1
Cyprus,2005,sp,4554,0,1,1
Cyprus,2005,sp,5564,0,0,0
Cyprus,2005,sp,65,0,1,1
Cyprus,2006,ep,014,0,1,1
Cyprus,2006,ep,1524,0,0,0
Cyprus,2006,ep,2534,2,0,2
Cyprus,2006,ep,3544,1,0,1
Cyprus,2006,ep,4554,0,0,0
Cyprus,2006,ep,5564,0,0,0
Cyprus,2006,ep,65,1,1,2
Cyprus,2006,sn,014,2,0,2
Cyprus,2006,sn,1524,4,0,4
Cyprus,2006,sn,2534,5,0,5
Cyprus,2006,sn,3544,6,0,6
Cyprus,2006,sn,4554,1,0,1
Cyprus,2006,sn,5564,0,2,2
Cyprus,2006,sn,65,0,2,2
Cyprus,2006,sp,014,0,0,0
Cyprus,2006,sp,1524,2,0,2
Cyprus,2006,sp,2534,3,1,4
Cyprus,2006,sp,3544,0,1,1
Cyprus,2006,sp,4554,0,0,0
Cyprus,2006,sp,5564,0,1,1
Cyprus,2006,sp,65,0,0,0
Cyprus,2007,ep,014,1,0,1
Cyprus,2007,ep,1524,0,0,0
Cyprus,2007,ep,2534,3,1,4
Cyprus,2007,ep,3544,0,0,0
Cyprus,2007,ep,4554,1,0,1
Cyprus,2007,ep,5564,0,0,0
Cyprus,2007,ep,65,0,0,0
Cyprus,2007,sn,014,0,0,0
Cyprus,2007,sn,1524,3,6,9
Cyprus,2007,sn,2534,5,6,11
Cyprus,2007,sn,3544,1,1,2
Cyprus,2007,sn,4554,0,1,1
Cyprus,2007,sn,5564,NA,2,NA
Cyprus,2007,sp,014,0,0,0
Cyprus,2007,sp,1524,1,2,3
Cyprus,2007,sp,2534,3,1,4
Cyprus,2007,sp,3544,1,0,1
Cyprus,2007,sp,4554,0,0,0
Cyprus,2007,sp,5564,0,0,0
Cyprus,2007,sp,65,0,0,0
Cyprus,2008,ep,014,1,1,2
Cyprus,2008,ep,1524,0,0,0
Cyprus,2008,ep,2534,2,1,3
Cyprus,2008,ep,3544,1,0,1
Cyprus,2008,ep,4554,0,0,0
Cyprus,2008,ep,5564,0,0,0
Cyprus,2008,ep,65,0,1,1
Cyprus,2008,sn,014,0,1,1
Cyprus,2008,sn,1524,3,2,5
Cyprus,2008,sn,2534,6,7,13
Cyprus,2008,sn,3544,2,3,5
Cyprus,2008,sn,4554,1,2,3
Cyprus,2008,sn,5564,0,0,0
Cyprus,2008,sn,65,1,0,1
Cyprus,2008,sp,014,0,0,0
Cyprus,2008,sp,1524,1,1,2
Cyprus,2008,sp,2534,2,0,2
Cyprus,2008,sp,3544,1,0,1
Cyprus,2008,sp,4554,0,1,1
Cyprus,2008,sp,5564,0,0,0
Cyprus,2008,sp,65,0,0,0
Cyprus,2009,ep,014,0,1,1
Cyprus,2009,ep,1524,0,1,1
Cyprus,2009,ep,2534,3,2,5
Cyprus,2009,ep,3544,3,0,3
Cyprus,2009,ep,4554,1,0,1
Cyprus,2009,ep,5564,0,0,0
Cyprus,2009,ep,65,0,1,1
Cyprus,2009,sn,014,0,0,0
Cyprus,2009,sn,1524,2,2,4
Cyprus,2009,sn,2534,1,3,4
Cyprus,2009,sn,3544,2,1,3
Cyprus,2009,sn,4554,0,0,0
Cyprus,2009,sn,5564,0,1,1
Cyprus,2009,sn,65,1,2,3
Cyprus,2009,sp,014,0,0,0
Cyprus,2009,sp,1524,1,1,2
Cyprus,2009,sp,2534,2,4,6
Cyprus,2009,sp,3544,2,0,2
Cyprus,2009,sp,4554,0,1,1
Cyprus,2009,sp,5564,0,1,1
Cyprus,2009,sp,65,0,1,1
Cyprus,2010,ep,014,0,0,0
Cyprus,2010,ep,1524,0,0,0
Cyprus,2010,ep,2534,5,3,8
Cyprus,2010,ep,3544,2,0,2
Cyprus,2010,ep,4554,0,1,1
Cyprus,2010,ep,5564,0,1,1
Cyprus,2010,ep,65,1,0,1
Cyprus,2010,sn,014,0,2,2
Cyprus,2010,sn,1524,0,4,4
Cyprus,2010,sn,2534,2,2,4
Cyprus,2010,sn,3544,0,0,0
Cyprus,2010,sn,4554,1,0,1
Cyprus,2010,sn,5564,0,1,1
Cyprus,2010,sn,65,0,0,0
Cyprus,2010,sp,014,0,0,0
Cyprus,2010,sp,1524,0,2,2
Cyprus,2010,sp,2534,3,1,4
Cyprus,2010,sp,3544,1,0,1
Cyprus,2010,sp,4554,0,0,0
Cyprus,2010,sp,5564,0,0,0
Cyprus,2010,sp,65,0,0,0
Cyprus,2011,ep,014,0,0,0
Cyprus,2011,ep,1524,0,1,1
Cyprus,2011,ep,2534,1,0,1
Cyprus,2011,ep,3544,1,1,2
Cyprus,2011,ep,4554,0,0,0
Cyprus,2011,ep,5564,0,0,0
Cyprus,2011,ep,65,1,0,1
Cyprus,2011,sn,014,0,0,0
Cyprus,2011,sn,1524,2,1,3
Cyprus,2011,sn,2534,3,1,4
Cyprus,2011,sn,3544,2,0,2
Cyprus,2011,sn,4554,0,0,0
Cyprus,2011,sn,5564,0,1,1
Cyprus,2011,sn,65,1,3,4
Cyprus,2011,sp,014,0,0,0
Cyprus,2011,sp,1524,1,0,1
Cyprus,2011,sp,2534,0,3,3
Cyprus,2011,sp,3544,2,4,6
Cyprus,2011,sp,4554,0,0,0
Cyprus,2011,sp,5564,0,0,0
Cyprus,2011,sp,65,0,1,1
Cyprus,2012,ep,014,0,0,0
Cyprus,2012,ep,1524,0,0,0
Cyprus,2012,ep,2534,4,1,5
Cyprus,2012,ep,3544,0,0,0
Cyprus,2012,ep,4554,0,2,2
Cyprus,2012,ep,5564,0,1,1
Cyprus,2012,ep,65,2,1,3
Cyprus,2012,sn,014,0,1,1
Cyprus,2012,sn,1524,2,2,4
Cyprus,2012,sn,2534,4,6,10
Cyprus,2012,sn,3544,1,0,1
Cyprus,2012,sn,4554,2,5,7
Cyprus,2012,sn,5564,0,4,4
Cyprus,2012,sn,65,1,0,1
Cyprus,2012,sp,014,0,0,0
Cyprus,2012,sp,1524,3,0,3
Cyprus,2012,sp,2534,2,4,6
Cyprus,2012,sp,3544,1,2,3
Cyprus,2012,sp,4554,0,1,1
Cyprus,2012,sp,5564,0,1,1
Cyprus,2012,sp,65,1,0,1
Cyprus,2013,rel,014,0,0,0
Cyprus,2013,rel,1524,1,3,4
Cyprus,2013,rel,2534,9,6,15
Cyprus,2013,rel,3544,6,4,10
Cyprus,2013,rel,4554,1,2,3
Cyprus,2013,rel,5564,0,4,4
Cyprus,2013,rel,65,2,3,5
Czech Republic,1995,sp,014,0,2,2
Czech Republic,1995,sp,1524,9,10,19
Czech Republic,1995,sp,2534,11,22,33
Czech Republic,1995,sp,3544,20,83,103
Czech Republic,1995,sp,4554,13,88,101
Czech Republic,1995,sp,5564,19,53,72
Czech Republic,1995,sp,65,88,90,178
Czech Republic,1996,sp,014,1,1,2
Czech Republic,1996,sp,1524,10,10,20
Czech Republic,1996,sp,2534,17,40,57
Czech Republic,1996,sp,3544,11,77,88
Czech Republic,1996,sp,4554,21,121,142
Czech Republic,1996,sp,5564,20,66,86
Czech Republic,1996,sp,65,89,90,179
Czech Republic,1997,sp,014,0,0,0
Czech Republic,1997,sp,1524,12,5,17
Czech Republic,1997,sp,2534,8,25,33
Czech Republic,1997,sp,3544,12,71,83
Czech Republic,1997,sp,4554,17,94,111
Czech Republic,1997,sp,5564,18,64,82
Czech Republic,1997,sp,65,72,83,155
Czech Republic,1998,sp,014,1,0,1
Czech Republic,1998,sp,1524,6,7,13
Czech Republic,1998,sp,2534,17,37,54
Czech Republic,1998,sp,3544,12,88,100
Czech Republic,1998,sp,4554,18,104,122
Czech Republic,1998,sp,5564,11,67,78
Czech Republic,1998,sp,65,82,95,177
Czech Republic,1999,sp,014,1,2,3
Czech Republic,1999,sp,1524,5,13,18
Czech Republic,1999,sp,2534,14,27,41
Czech Republic,1999,sp,3544,18,62,80
Czech Republic,1999,sp,4554,15,98,113
Czech Republic,1999,sp,5564,3,45,48
Czech Republic,1999,sp,65,71,75,146
Czech Republic,2000,sp,014,0,0,0
Czech Republic,2000,sp,1524,15,7,22
Czech Republic,2000,sp,2534,13,31,44
Czech Republic,2000,sp,3544,9,52,61
Czech Republic,2000,sp,4554,10,89,99
Czech Republic,2000,sp,5564,7,61,68
Czech Republic,2000,sp,65,57,59,116
Czech Republic,2001,sp,014,0,0,0
Czech Republic,2001,sp,1524,10,18,28
Czech Republic,2001,sp,2534,17,39,56
Czech Republic,2001,sp,3544,8,47,55
Czech Republic,2001,sp,4554,11,85,96
Czech Republic,2001,sp,5564,9,43,52
Czech Republic,2001,sp,65,54,50,104
Czech Republic,2002,sp,014,0,0,0
Czech Republic,2002,sp,1524,6,14,20
Czech Republic,2002,sp,2534,10,28,38
Czech Republic,2002,sp,3544,8,39,47
Czech Republic,2002,sp,4554,8,89,97
Czech Republic,2002,sp,5564,6,38,44
Czech Republic,2002,sp,65,43,40,83
Czech Republic,2003,sp,014,0,0,0
Czech Republic,2003,sp,1524,9,11,20
Czech Republic,2003,sp,2534,15,28,43
Czech Republic,2003,sp,3544,15,42,57
Czech Republic,2003,sp,4554,12,67,79
Czech Republic,2003,sp,5564,7,48,55
Czech Republic,2003,sp,65,34,50,84
Czech Republic,2004,sp,014,0,0,0
Czech Republic,2004,sp,1524,11,10,21
Czech Republic,2004,sp,2534,17,28,45
Czech Republic,2004,sp,3544,9,36,45
Czech Republic,2004,sp,4554,13,71,84
Czech Republic,2004,sp,5564,13,30,43
Czech Republic,2004,sp,65,29,35,64
Czech Republic,2005,sp,014,0,0,0
Czech Republic,2005,sp,1524,3,8,11
Czech Republic,2005,sp,2534,14,24,38
Czech Republic,2005,sp,3544,16,57,73
Czech Republic,2005,sp,4554,7,55,62
Czech Republic,2005,sp,5564,5,45,50
Czech Republic,2005,sp,65,28,46,74
Czech Republic,2006,ep,014,1,1,2
Czech Republic,2006,ep,1524,6,4,10
Czech Republic,2006,ep,2534,2,9,11
Czech Republic,2006,ep,3544,6,10,16
Czech Republic,2006,ep,4554,14,13,27
Czech Republic,2006,ep,5564,14,23,37
Czech Republic,2006,ep,65,50,51,101
Czech Republic,2006,sn,014,2,0,2
Czech Republic,2006,sn,1524,7,3,10
Czech Republic,2006,sn,2534,18,31,49
Czech Republic,2006,sn,3544,13,36,49
Czech Republic,2006,sn,4554,25,59,84
Czech Republic,2006,sn,5564,25,73,98
Czech Republic,2006,sn,65,99,89,188
Czech Republic,2006,sp,014,0,0,0
Czech Republic,2006,sp,1524,4,6,10
Czech Republic,2006,sp,2534,12,19,31
Czech Republic,2006,sp,3544,12,39,51
Czech Republic,2006,sp,4554,10,56,66
Czech Republic,2006,sp,5564,6,38,44
Czech Republic,2006,sp,65,30,25,55
Czech Republic,2007,ep,014,1,1,2
Czech Republic,2007,ep,1524,3,3,6
Czech Republic,2007,ep,2534,6,6,12
Czech Republic,2007,ep,3544,3,4,7
Czech Republic,2007,ep,4554,2,7,9
Czech Republic,2007,ep,5564,11,14,25
Czech Republic,2007,ep,65,27,28,55
Czech Republic,2007,sn,014,2,0,2
Czech Republic,2007,sn,1524,3,11,14
Czech Republic,2007,sn,2534,16,32,48
Czech Republic,2007,sn,3544,13,38,51
Czech Republic,2007,sn,4554,16,58,74
Czech Republic,2007,sn,5564,20,57,77
Czech Republic,2007,sn,65,59,82,141
Czech Republic,2007,sp,014,0,0,0
Czech Republic,2007,sp,1524,6,14,20
Czech Republic,2007,sp,2534,8,26,34
Czech Republic,2007,sp,3544,5,35,40
Czech Republic,2007,sp,4554,9,63,72
Czech Republic,2007,sp,5564,5,39,44
Czech Republic,2007,sp,65,28,29,57
Czech Republic,2008,ep,014,2,2,4
Czech Republic,2008,ep,1524,1,4,5
Czech Republic,2008,ep,2534,5,13,18
Czech Republic,2008,ep,3544,6,7,13
Czech Republic,2008,ep,4554,2,6,8
Czech Republic,2008,ep,5564,10,14,24
Czech Republic,2008,ep,65,34,20,54
Czech Republic,2008,sn,014,0,0,0
Czech Republic,2008,sn,1524,14,21,35
Czech Republic,2008,sn,2534,18,34,52
Czech Republic,2008,sn,3544,21,36,57
Czech Republic,2008,sn,4554,22,48,70
Czech Republic,2008,sn,5564,17,57,74
Czech Republic,2008,sn,65,77,67,144
Czech Republic,2008,sp,014,0,0,0
Czech Republic,2008,sp,1524,4,7,11
Czech Republic,2008,sp,2534,14,29,43
Czech Republic,2008,sp,3544,8,39,47
Czech Republic,2008,sp,4554,5,44,49
Czech Republic,2008,sp,5564,10,35,45
Czech Republic,2008,sp,65,23,31,54
Czech Republic,2009,ep,014,2,2,4
Czech Republic,2009,ep,1524,3,2,5
Czech Republic,2009,ep,2534,8,3,11
Czech Republic,2009,ep,3544,5,4,9
Czech Republic,2009,ep,4554,6,7,13
Czech Republic,2009,ep,5564,6,7,13
Czech Republic,2009,ep,65,22,20,42
Czech Republic,2009,sn,014,1,2,3
Czech Republic,2009,sn,1524,7,12,19
Czech Republic,2009,sn,2534,18,19,37
Czech Republic,2009,sn,3544,10,17,27
Czech Republic,2009,sn,4554,17,38,55
Czech Republic,2009,sn,5564,10,40,50
Czech Republic,2009,sn,65,51,76,127
Czech Republic,2009,sp,014,0,0,0
Czech Republic,2009,sp,1524,3,11,14
Czech Republic,2009,sp,2534,6,29,35
Czech Republic,2009,sp,3544,7,25,32
Czech Republic,2009,sp,4554,5,39,44
Czech Republic,2009,sp,5564,4,44,48
Czech Republic,2009,sp,65,15,29,44
Czech Republic,2010,ep,014,0,0,0
Czech Republic,2010,ep,1524,4,1,5
Czech Republic,2010,ep,2534,3,5,8
Czech Republic,2010,ep,3544,2,6,8
Czech Republic,2010,ep,4554,1,11,12
Czech Republic,2010,ep,5564,4,9,13
Czech Republic,2010,ep,65,30,18,48
Czech Republic,2010,sn,014,0,3,3
Czech Republic,2010,sn,1524,3,5,8
Czech Republic,2010,sn,2534,17,32,49
Czech Republic,2010,sn,3544,12,28,40
Czech Republic,2010,sn,4554,8,54,62
Czech Republic,2010,sn,5564,21,40,61
Czech Republic,2010,sn,65,48,54,102
Czech Republic,2010,sp,014,0,0,0
Czech Republic,2010,sp,1524,6,12,18
Czech Republic,2010,sp,2534,10,19,29
Czech Republic,2010,sp,3544,11,36,47
Czech Republic,2010,sp,4554,7,29,36
Czech Republic,2010,sp,5564,2,29,31
Czech Republic,2010,sp,65,20,19,39
Czech Republic,2011,ep,014,0,1,1
Czech Republic,2011,ep,1524,0,6,6
Czech Republic,2011,ep,2534,0,7,7
Czech Republic,2011,ep,3544,3,2,5
Czech Republic,2011,ep,4554,3,6,9
Czech Republic,2011,ep,5564,7,9,16
Czech Republic,2011,ep,65,17,13,30
Czech Republic,2011,sn,014,2,3,5
Czech Republic,2011,sn,1524,6,7,13
Czech Republic,2011,sn,2534,7,23,30
Czech Republic,2011,sn,3544,11,33,44
Czech Republic,2011,sn,4554,18,38,56
Czech Republic,2011,sn,5564,9,49,58
Czech Republic,2011,sn,65,44,56,100
Czech Republic,2011,sp,014,0,0,0
Czech Republic,2011,sp,1524,4,10,14
Czech Republic,2011,sp,2534,9,29,38
Czech Republic,2011,sp,3544,4,20,24
Czech Republic,2011,sp,4554,4,38,42
Czech Republic,2011,sp,5564,3,28,31
Czech Republic,2011,sp,65,15,24,39
Czech Republic,2012,ep,014,0,1,1
Czech Republic,2012,ep,1524,2,0,2
Czech Republic,2012,ep,2534,10,6,16
Czech Republic,2012,ep,3544,3,3,6
Czech Republic,2012,ep,4554,4,10,14
Czech Republic,2012,ep,5564,4,9,13
Czech Republic,2012,ep,65,14,23,37
Czech Republic,2012,sn,014,2,1,3
Czech Republic,2012,sn,1524,5,6,11
Czech Republic,2012,sn,2534,12,13,25
Czech Republic,2012,sn,3544,7,26,33
Czech Republic,2012,sn,4554,11,26,37
Czech Republic,2012,sn,5564,13,47,60
Czech Republic,2012,sn,65,51,48,99
Czech Republic,2012,sp,014,1,0,1
Czech Republic,2012,sp,1524,3,7,10
Czech Republic,2012,sp,2534,11,21,32
Czech Republic,2012,sp,3544,8,24,32
Czech Republic,2012,sp,4554,3,42,45
Czech Republic,2012,sp,5564,7,33,40
Czech Republic,2012,sp,65,26,22,48
Czech Republic,2013,rel,014,2,3,5
Czech Republic,2013,rel,1524,17,13,30
Czech Republic,2013,rel,2534,19,37,56
Czech Republic,2013,rel,3544,19,47,66
Czech Republic,2013,rel,4554,16,59,75
Czech Republic,2013,rel,5564,16,75,91
Czech Republic,2013,rel,65,65,83,148
Democratic People's Republic of Korea,1997,sp,014,2,5,7
Democratic People's Republic of Korea,1997,sp,1524,205,375,580
Democratic People's Republic of Korea,1997,sp,2534,295,430,725
Democratic People's Republic of Korea,1997,sp,3544,210,640,850
Democratic People's Republic of Korea,1997,sp,4554,205,620,825
Democratic People's Republic of Korea,1997,sp,5564,175,430,605
Democratic People's Republic of Korea,1997,sp,65,148,240,388
Democratic People's Republic of Korea,1998,sp,014,0,0,0
Democratic People's Republic of Korea,1998,sp,1524,11,21,32
Democratic People's Republic of Korea,1998,sp,2534,24,36,60
Democratic People's Republic of Korea,1998,sp,3544,24,34,58
Democratic People's Republic of Korea,1998,sp,4554,25,36,61
Democratic People's Republic of Korea,1998,sp,5564,20,31,51
Democratic People's Republic of Korea,1998,sp,65,15,25,40
Democratic People's Republic of Korea,1999,sp,014,10,14,24
Democratic People's Republic of Korea,1999,sp,1524,162,294,456
Democratic People's Republic of Korea,1999,sp,2534,235,438,673
Democratic People's Republic of Korea,1999,sp,3544,327,401,728
Democratic People's Republic of Korea,1999,sp,4554,237,294,531
Democratic People's Republic of Korea,1999,sp,5564,68,151,219
Democratic People's Republic of Korea,1999,sp,65,12,30,42
Democratic People's Republic of Korea,2000,sp,014,167,293,460
Democratic People's Republic of Korea,2000,sp,1524,683,928,1611
Democratic People's Republic of Korea,2000,sp,2534,1121,1508,2629
Democratic People's Republic of Korea,2000,sp,3544,2004,2927,4931
Democratic People's Republic of Korea,2000,sp,4554,1524,2519,4043
Democratic People's Republic of Korea,2000,sp,5564,591,1167,1758
Democratic People's Republic of Korea,2000,sp,65,357,651,1008
Democratic People's Republic of Korea,2001,sp,014,123,207,330
Democratic People's Republic of Korea,2001,sp,1524,690,1081,1771
Democratic People's Republic of Korea,2001,sp,2534,1132,1593,2725
Democratic People's Republic of Korea,2001,sp,3544,1354,2276,3630
Democratic People's Republic of Korea,2001,sp,4554,1120,2208,3328
Democratic People's Republic of Korea,2001,sp,5564,553,1149,1702
Democratic People's Republic of Korea,2001,sp,65,336,606,942
Democratic People's Republic of Korea,2002,sp,014,140,199,339
Democratic People's Republic of Korea,2002,sp,1524,1049,1444,2493
Democratic People's Republic of Korea,2002,sp,2534,1720,2282,4002
Democratic People's Republic of Korea,2002,sp,3544,1642,2584,4226
Democratic People's Republic of Korea,2002,sp,4554,1505,2618,4123
Democratic People's Republic of Korea,2002,sp,5564,892,1235,2127
Democratic People's Republic of Korea,2002,sp,65,521,745,1266
Democratic People's Republic of Korea,2003,sp,014,93,86,179
Democratic People's Republic of Korea,2003,sp,1524,823,1154,1977
Democratic People's Republic of Korea,2003,sp,2534,1623,2279,3902
Democratic People's Republic of Korea,2003,sp,3544,1607,2678,4285
Democratic People's Republic of Korea,2003,sp,4554,1395,2469,3864
Democratic People's Republic of Korea,2003,sp,5564,769,1412,2181
Democratic People's Republic of Korea,2003,sp,65,370,634,1004
Democratic People's Republic of Korea,2004,sp,014,118,175,293
Democratic People's Republic of Korea,2004,sp,1524,887,1284,2171
Democratic People's Republic of Korea,2004,sp,2534,1577,2559,4136
Democratic People's Republic of Korea,2004,sp,3544,1640,2991,4631
Democratic People's Republic of Korea,2004,sp,4554,1473,2858,4331
Democratic People's Republic of Korea,2004,sp,5564,724,1464,2188
Democratic People's Republic of Korea,2004,sp,65,269,460,729
Democratic People's Republic of Korea,2005,sp,014,166,167,333
Democratic People's Republic of Korea,2005,sp,1524,1127,1409,2536
Democratic People's Republic of Korea,2005,sp,2534,1756,2422,4178
Democratic People's Republic of Korea,2005,sp,3544,1890,2688,4578
Democratic People's Republic of Korea,2005,sp,4554,1381,2040,3421
Democratic People's Republic of Korea,2005,sp,5564,764,1185,1949
Democratic People's Republic of Korea,2005,sp,65,336,485,821
Democratic People's Republic of Korea,2006,sp,014,87,157,244
Democratic People's Republic of Korea,2006,sp,1524,725,1498,2223
Democratic People's Republic of Korea,2006,sp,2534,1373,2393,3766
Democratic People's Republic of Korea,2006,sp,3544,2051,3219,5270
Democratic People's Republic of Korea,2006,sp,4554,1373,2301,3674
Democratic People's Republic of Korea,2006,sp,5564,791,1479,2270
Democratic People's Republic of Korea,2006,sp,65,397,591,988
Democratic People's Republic of Korea,2007,sp,014,406,353,759
Democratic People's Republic of Korea,2007,sp,1524,1233,1947,3180
Democratic People's Republic of Korea,2007,sp,2534,1682,2748,4430
Democratic People's Republic of Korea,2007,sp,3544,2672,3717,6389
Democratic People's Republic of Korea,2007,sp,4554,1723,2831,4554
Democratic People's Republic of Korea,2007,sp,5564,1056,2093,3149
Democratic People's Republic of Korea,2007,sp,65,440,674,1114
Democratic People's Republic of Korea,2008,ep,014,319,387,706
Democratic People's Republic of Korea,2008,ep,1524,786,889,1675
Democratic People's Republic of Korea,2008,ep,2534,1048,1386,2434
Democratic People's Republic of Korea,2008,ep,3544,1027,1485,2512
Democratic People's Republic of Korea,2008,ep,4554,846,1218,2064
Democratic People's Republic of Korea,2008,ep,5564,513,674,1187
Democratic People's Republic of Korea,2008,ep,65,132,204,336
Democratic People's Republic of Korea,2008,sn,014,1102,1188,2290
Democratic People's Republic of Korea,2008,sn,1524,1737,2506,4243
Democratic People's Republic of Korea,2008,sn,2534,2089,3858,5947
Democratic People's Republic of Korea,2008,sn,3544,3067,4566,7633
Democratic People's Republic of Korea,2008,sn,4554,2058,3800,5858
Democratic People's Republic of Korea,2008,sn,5564,1334,2533,3867
Democratic People's Republic of Korea,2008,sn,65,569,1037,1606
Democratic People's Republic of Korea,2008,sp,014,479,441,920
Democratic People's Republic of Korea,2008,sp,1524,1259,2341,3600
Democratic People's Republic of Korea,2008,sp,2534,1792,3320,5112
Democratic People's Republic of Korea,2008,sp,3544,2428,4263,6691
Democratic People's Republic of Korea,2008,sp,4554,2282,3988,6270
Democratic People's Republic of Korea,2008,sp,5564,1177,2704,3881
Democratic People's Republic of Korea,2008,sp,65,604,948,1552
Democratic People's Republic of Korea,2009,ep,014,381,417,798
Democratic People's Republic of Korea,2009,ep,1524,902,1143,2045
Democratic People's Republic of Korea,2009,ep,2534,1100,1476,2576
Democratic People's Republic of Korea,2009,ep,3544,1205,1580,2785
Democratic People's Republic of Korea,2009,ep,4554,942,1304,2246
Democratic People's Republic of Korea,2009,ep,5564,475,686,1161
Democratic People's Republic of Korea,2009,ep,65,273,348,621
Democratic People's Republic of Korea,2009,sn,014,1006,1277,2283
Democratic People's Republic of Korea,2009,sn,1524,1796,2358,4154
Democratic People's Republic of Korea,2009,sn,2534,2370,3734,6104
Democratic People's Republic of Korea,2009,sn,3544,2951,4324,7275
Democratic People's Republic of Korea,2009,sn,4554,2438,3931,6369
Democratic People's Republic of Korea,2009,sn,5564,1542,2756,4298
Democratic People's Republic of Korea,2009,sn,65,731,1277,2008
Democratic People's Republic of Korea,2009,sp,014,474,364,838
Democratic People's Republic of Korea,2009,sp,1524,1408,2359,3767
Democratic People's Republic of Korea,2009,sp,2534,2067,3607,5674
Democratic People's Republic of Korea,2009,sp,3544,2660,4211,6871
Democratic People's Republic of Korea,2009,sp,4554,2370,3927,6297
Democratic People's Republic of Korea,2009,sp,5564,1479,2879,4358
Democratic People's Republic of Korea,2009,sp,65,500,1061,1561
Democratic People's Republic of Korea,2010,ep,014,598,695,1293
Democratic People's Republic of Korea,2010,ep,1524,776,1096,1872
Democratic People's Republic of Korea,2010,ep,2534,1089,1618,2707
Democratic People's Republic of Korea,2010,ep,3544,1324,1857,3181
Democratic People's Republic of Korea,2010,ep,4554,992,1533,2525
Democratic People's Republic of Korea,2010,ep,5564,571,867,1438
Democratic People's Republic of Korea,2010,ep,65,298,401,699
Democratic People's Republic of Korea,2010,sn,014,787,970,1757
Democratic People's Republic of Korea,2010,sn,1524,1643,2712,4355
Democratic People's Republic of Korea,2010,sn,2534,2774,4412,7186
Democratic People's Republic of Korea,2010,sn,3544,3487,5382,8869
Democratic People's Republic of Korea,2010,sn,4554,2838,4811,7649
Democratic People's Republic of Korea,2010,sn,5564,1725,2785,4510
Democratic People's Republic of Korea,2010,sn,65,710,1249,1959
Democratic People's Republic of Korea,2010,sp,014,407,447,854
Democratic People's Republic of Korea,2010,sp,1524,1493,2524,4017
Democratic People's Republic of Korea,2010,sp,2534,2461,4046,6507
Democratic People's Republic of Korea,2010,sp,3544,2910,4849,7759
Democratic People's Republic of Korea,2010,sp,4554,2276,4061,6337
Democratic People's Republic of Korea,2010,sp,5564,1347,2629,3976
Democratic People's Republic of Korea,2010,sp,65,637,1153,1790
Democratic People's Republic of Korea,2011,ep,014,935,949,1884
Democratic People's Republic of Korea,2011,ep,1524,1049,1381,2430
Democratic People's Republic of Korea,2011,ep,2534,1347,2017,3364
Democratic People's Republic of Korea,2011,ep,3544,1514,2314,3828
Democratic People's Republic of Korea,2011,ep,4554,1203,1775,2978
Democratic People's Republic of Korea,2011,ep,5564,631,975,1606
Democratic People's Republic of Korea,2011,ep,65,286,452,738
Democratic People's Republic of Korea,2011,sn,014,876,1138,2014
Democratic People's Republic of Korea,2011,sn,1524,1818,2843,4661
Democratic People's Republic of Korea,2011,sn,2534,2856,4535,7391
Democratic People's Republic of Korea,2011,sn,3544,3528,5944,9472
Democratic People's Republic of Korea,2011,sn,4554,2727,4968,7695
Democratic People's Republic of Korea,2011,sn,5564,1481,2899,4380
Democratic People's Republic of Korea,2011,sn,65,627,1217,1844
Democratic People's Republic of Korea,2011,sp,014,227,314,541
Democratic People's Republic of Korea,2011,sp,1524,1390,2218,3608
Democratic People's Republic of Korea,2011,sp,2534,2264,4066,6330
Democratic People's Republic of Korea,2011,sp,3544,3093,5493,8586
Democratic People's Republic of Korea,2011,sp,4554,2409,4542,6951
Democratic People's Republic of Korea,2011,sp,5564,1271,2474,3745
Democratic People's Republic of Korea,2011,sp,65,494,1024,1518
Democratic People's Republic of Korea,2012,ep,014,980,1020,2000
Democratic People's Republic of Korea,2012,ep,1524,1043,1473,2516
Democratic People's Republic of Korea,2012,ep,2534,1452,2187,3639
Democratic People's Republic of Korea,2012,ep,3544,1513,2357,3870
Democratic People's Republic of Korea,2012,ep,4554,1135,1765,2900
Democratic People's Republic of Korea,2012,ep,5564,614,985,1599
Democratic People's Republic of Korea,2012,ep,65,315,482,797
Democratic People's Republic of Korea,2012,sn,014,821,988,1809
Democratic People's Republic of Korea,2012,sn,1524,1790,2880,4670
Democratic People's Republic of Korea,2012,sn,2534,2792,4531,7323
Democratic People's Republic of Korea,2012,sn,3544,3343,5484,8827
Democratic People's Republic of Korea,2012,sn,4554,2724,4498,7222
Democratic People's Republic of Korea,2012,sn,5564,1587,2726,4313
Democratic People's Republic of Korea,2012,sn,65,691,1104,1795
Democratic People's Republic of Korea,2012,sp,014,227,293,520
Democratic People's Republic of Korea,2012,sp,1524,1447,2439,3886
Democratic People's Republic of Korea,2012,sp,2534,2475,4015,6490
Democratic People's Republic of Korea,2012,sp,3544,3005,5055,8060
Democratic People's Republic of Korea,2012,sp,4554,2623,4373,6996
Democratic People's Republic of Korea,2012,sp,5564,1527,2699,4226
Democratic People's Republic of Korea,2012,sp,65,576,1150,1726
Democratic People's Republic of Korea,2013,rel,014,2365,2874,5239
Democratic People's Republic of Korea,2013,rel,1524,4717,7057,11774
Democratic People's Republic of Korea,2013,rel,2534,7094,11239,18333
Democratic People's Republic of Korea,2013,rel,3544,8611,13618,22229
Democratic People's Republic of Korea,2013,rel,4554,6916,11382,18298
Democratic People's Republic of Korea,2013,rel,5564,3762,6674,10436
Democratic People's Republic of Korea,2013,rel,65,1629,2653,4282
Democratic Republic of the Congo,1995,sp,014,331,373,704
Democratic Republic of the Congo,1995,sp,1524,1223,1572,2795
Democratic Republic of the Congo,1995,sp,2534,1532,2382,3914
Democratic Republic of the Congo,1995,sp,3544,1232,1890,3122
Democratic Republic of the Congo,1995,sp,4554,863,1184,2047
Democratic Republic of the Congo,1995,sp,5564,427,634,1061
Democratic Republic of the Congo,1995,sp,65,137,289,426
Democratic Republic of the Congo,1996,sp,014,292,228,520
Democratic Republic of the Congo,1996,sp,1524,1153,1040,2193
Democratic Republic of the Congo,1996,sp,2534,1528,1627,3155
Democratic Republic of the Congo,1996,sp,3544,1142,1492,2634
Democratic Republic of the Congo,1996,sp,4554,728,998,1726
Democratic Republic of the Congo,1996,sp,5564,377,548,925
Democratic Republic of the Congo,1996,sp,65,149,285,434
Democratic Republic of the Congo,1997,sp,014,321,259,580
Democratic Republic of the Congo,1997,sp,1524,1376,1401,2777
Democratic Republic of the Congo,1997,sp,2534,1874,1996,3870
Democratic Republic of the Congo,1997,sp,3544,1271,1599,2870
Democratic Republic of the Congo,1997,sp,4554,723,996,1719
Democratic Republic of the Congo,1997,sp,5564,386,614,1000
Democratic Republic of the Congo,1997,sp,65,150,276,426
Democratic Republic of the Congo,1998,sp,014,651,455,1106
Democratic Republic of the Congo,1998,sp,1524,4074,3684,7758
Democratic Republic of the Congo,1998,sp,2534,4536,5073,9609
Democratic Republic of the Congo,1998,sp,3544,2716,3578,6294
Democratic Republic of the Congo,1998,sp,4554,1295,2002,3297
Democratic Republic of the Congo,1998,sp,5564,722,997,1719
Democratic Republic of the Congo,1998,sp,65,272,518,790
Democratic Republic of the Congo,1999,sp,014,708,474,1182
Democratic Republic of the Congo,1999,sp,1524,4472,4061,8533
Democratic Republic of the Congo,1999,sp,2534,4991,5886,10877
Democratic Republic of the Congo,1999,sp,3544,3117,4191,7308
Democratic Republic of the Congo,1999,sp,4554,1725,2250,3975
Democratic Republic of the Congo,1999,sp,5564,836,1279,2115
Democratic Republic of the Congo,1999,sp,65,305,626,931
Democratic Republic of the Congo,2000,sp,014,718,485,1203
Democratic Republic of the Congo,2000,sp,1524,4422,4048,8470
Democratic Republic of the Congo,2000,sp,2534,5146,5833,10979
Democratic Republic of the Congo,2000,sp,3544,3309,4151,7460
Democratic Republic of the Congo,2000,sp,4554,1724,2549,4273
Democratic Republic of the Congo,2000,sp,5564,855,1295,2150
Democratic Republic of the Congo,2000,sp,65,351,602,953
Democratic Republic of the Congo,2001,sp,014,842,581,1423
Democratic Republic of the Congo,2001,sp,1524,4922,4651,9573
Democratic Republic of the Congo,2001,sp,2534,5586,6794,12380
Democratic Republic of the Congo,2001,sp,3544,3704,4817,8521
Democratic Republic of the Congo,2001,sp,4554,2057,2876,4933
Democratic Republic of the Congo,2001,sp,5564,1042,1384,2426
Democratic Republic of the Congo,2001,sp,65,470,724,1194
Democratic Republic of the Congo,2002,sp,014,874,649,1523
Democratic Republic of the Congo,2002,sp,1524,5378,4965,10343
Democratic Republic of the Congo,2002,sp,2534,6230,7414,13644
Democratic Republic of the Congo,2002,sp,3544,3939,4994,8933
Democratic Republic of the Congo,2002,sp,4554,2262,3065,5327
Democratic Republic of the Congo,2002,sp,5564,1055,1388,2443
Democratic Republic of the Congo,2002,sp,65,476,791,1267
Democratic Republic of the Congo,2003,sp,014,1233,854,2087
Democratic Republic of the Congo,2003,sp,1524,6630,5885,12515
Democratic Republic of the Congo,2003,sp,2534,7711,8427,16138
Democratic Republic of the Congo,2003,sp,3544,4826,6193,11019
Democratic Republic of the Congo,2003,sp,4554,2866,3776,6642
Democratic Republic of the Congo,2003,sp,5564,1457,1836,3293
Democratic Republic of the Congo,2003,sp,65,592,1047,1639
Democratic Republic of the Congo,2004,sp,014,1679,1195,2874
Democratic Republic of the Congo,2004,sp,1524,7630,7007,14637
Democratic Republic of the Congo,2004,sp,2534,8540,9467,18007
Democratic Republic of the Congo,2004,sp,3544,5529,7114,12643
Democratic Republic of the Congo,2004,sp,4554,3413,4442,7855
Democratic Republic of the Congo,2004,sp,5564,1850,2376,4226
Democratic Republic of the Congo,2004,sp,65,721,1229,1950
Democratic Republic of the Congo,2005,sp,014,1695,1321,3016
Democratic Republic of the Congo,2005,sp,1524,7570,6675,14245
Democratic Republic of the Congo,2005,sp,2534,8501,9808,18309
Democratic Republic of the Congo,2005,sp,3544,5832,7577,13409
Democratic Republic of the Congo,2005,sp,4554,3898,5022,8920
Democratic Republic of the Congo,2005,sp,5564,2054,2637,4691
Democratic Republic of the Congo,2005,sp,65,951,1499,2450
Democratic Republic of the Congo,2006,sp,014,1517,1122,2639
Democratic Republic of the Congo,2006,sp,1524,7236,6391,13627
Democratic Republic of the Congo,2006,sp,2534,8522,9486,18008
Democratic Republic of the Congo,2006,sp,3544,5621,7321,12942
Democratic Republic of the Congo,2006,sp,4554,3762,5011,8773
Democratic Republic of the Congo,2006,sp,5564,2019,2657,4676
Democratic Republic of the Congo,2006,sp,65,975,1504,2479
Democratic Republic of the Congo,2007,sp,014,1842,1343,3185
Democratic Republic of the Congo,2007,sp,1524,7130,6485,13615
Democratic Republic of the Congo,2007,sp,2534,8415,9548,17963
Democratic Republic of the Congo,2007,sp,3544,5939,7925,13864
Democratic Republic of the Congo,2007,sp,4554,4127,5341,9468
Democratic Republic of the Congo,2007,sp,5564,2352,2801,5153
Democratic Republic of the Congo,2007,sp,65,1099,1752,2851
Democratic Republic of the Congo,2008,sp,014,1828,1515,3343
Democratic Republic of the Congo,2008,sp,1524,7304,6497,13801
Democratic Republic of the Congo,2008,sp,2534,8995,9988,18983
Democratic Republic of the Congo,2008,sp,3544,6393,8552,14945
Democratic Republic of the Congo,2008,sp,4554,4104,5756,9860
Democratic Republic of the Congo,2008,sp,5564,2516,3131,5647
Democratic Republic of the Congo,2008,sp,65,1212,1686,2898
Democratic Republic of the Congo,2009,sp,014,1773,1453,3226
Democratic Republic of the Congo,2009,sp,1524,7091,6587,13678
Democratic Republic of the Congo,2009,sp,2534,8753,9964,18717
Democratic Republic of the Congo,2009,sp,3544,6477,8475,14952
Democratic Republic of the Congo,2009,sp,4554,4556,6155,10711
Democratic Republic of the Congo,2009,sp,5564,2655,3393,6048
Democratic Republic of the Congo,2009,sp,65,1336,1821,3157
Democratic Republic of the Congo,2010,sp,014,1987,1707,3694
Democratic Republic of the Congo,2010,sp,1524,7199,6859,14058
Democratic Republic of the Congo,2010,sp,2534,9120,10412,19532
Democratic Republic of the Congo,2010,sp,3544,6721,9134,15855
Democratic Republic of the Congo,2010,sp,4554,4579,6464,11043
Democratic Republic of the Congo,2010,sp,5564,2612,3641,6253
Democratic Republic of the Congo,2010,sp,65,1311,1907,3218
Democratic Republic of the Congo,2011,sp,014,1800,1579,3379
Democratic Republic of the Congo,2011,sp,1524,6802,6640,13442
Democratic Republic of the Congo,2011,sp,2534,8742,9872,18614
Democratic Republic of the Congo,2011,sp,3544,6541,8932,15473
Democratic Republic of the Congo,2011,sp,4554,4537,6415,10952
Democratic Republic of the Congo,2011,sp,5564,2671,3584,6255
Democratic Republic of the Congo,2011,sp,65,1295,1911,3206
Democratic Republic of the Congo,2012,sp,014,1699,1439,3138
Democratic Republic of the Congo,2012,sp,1524,6598,6612,13210
Democratic Republic of the Congo,2012,sp,2534,8406,10274,18680
Democratic Republic of the Congo,2012,sp,3544,6471,9361,15832
Democratic Republic of the Congo,2012,sp,4554,4131,6612,10743
Democratic Republic of the Congo,2012,sp,5564,2625,3698,6323
Democratic Republic of the Congo,2012,sp,65,1257,1941,3198
Democratic Republic of the Congo,2013,rel,014,1706,1380,3086
Democratic Republic of the Congo,2013,rel,1524,6376,6776,13152
Democratic Republic of the Congo,2013,rel,2534,8352,10218,18570
Democratic Republic of the Congo,2013,rel,3544,6472,9280,15752
Democratic Republic of the Congo,2013,rel,4554,4402,6587,10989
Democratic Republic of the Congo,2013,rel,5564,2551,3841,6392
Democratic Republic of the Congo,2013,rel,65,1263,2016,3279
Denmark,1995,sp,014,2,0,2
Denmark,1995,sp,1524,7,7,14
Denmark,1995,sp,2534,13,16,29
Denmark,1995,sp,3544,8,28,36
Denmark,1995,sp,4554,4,18,22
Denmark,1995,sp,5564,3,9,12
Denmark,1995,sp,65,2,11,13
Denmark,1996,sp,014,0,0,0
Denmark,1996,sp,1524,5,4,9
Denmark,1996,sp,2534,9,16,25
Denmark,1996,sp,3544,8,13,21
Denmark,1996,sp,4554,4,13,17
Denmark,1996,sp,5564,3,8,11
Denmark,1996,sp,65,8,6,14
Denmark,1997,sp,014,1,1,2
Denmark,1997,sp,1524,6,11,17
Denmark,1997,sp,2534,8,19,27
Denmark,1997,sp,3544,2,23,25
Denmark,1997,sp,4554,5,16,21
Denmark,1997,sp,5564,2,6,8
Denmark,1997,sp,65,8,6,14
Denmark,1998,sp,014,1,0,1
Denmark,1998,sp,1524,6,7,13
Denmark,1998,sp,2534,16,20,36
Denmark,1998,sp,3544,8,21,29
Denmark,1998,sp,4554,7,18,25
Denmark,1998,sp,5564,6,7,13
Denmark,1998,sp,65,6,9,15
Denmark,1999,sp,014,1,4,5
Denmark,1999,sp,1524,11,9,20
Denmark,1999,sp,2534,18,29,47
Denmark,1999,sp,3544,11,23,34
Denmark,1999,sp,4554,7,21,28
Denmark,1999,sp,5564,8,8,16
Denmark,1999,sp,65,11,9,20
Denmark,2000,sp,014,5,5,10
Denmark,2000,sp,1524,16,10,26
Denmark,2000,sp,2534,15,20,35
Denmark,2000,sp,3544,14,24,38
Denmark,2000,sp,4554,6,16,22
Denmark,2000,sp,5564,7,11,18
Denmark,2000,sp,65,8,14,22
Denmark,2001,sp,014,5,1,6
Denmark,2001,sp,1524,5,10,15
Denmark,2001,sp,2534,12,15,27
Denmark,2001,sp,3544,13,20,33
Denmark,2001,sp,4554,7,15,22
Denmark,2001,sp,5564,5,4,9
Denmark,2001,sp,65,3,9,12
Denmark,2002,sp,014,1,2,3
Denmark,2002,sp,1524,14,11,25
Denmark,2002,sp,2534,17,8,25
Denmark,2002,sp,3544,11,25,36
Denmark,2002,sp,4554,10,14,24
Denmark,2002,sp,5564,2,6,8
Denmark,2002,sp,65,5,9,14
Denmark,2003,sp,014,0,3,3
Denmark,2003,sp,1524,6,11,17
Denmark,2003,sp,2534,13,20,33
Denmark,2003,sp,3544,12,23,35
Denmark,2003,sp,4554,6,22,28
Denmark,2003,sp,5564,2,12,14
Denmark,2003,sp,65,4,9,13
Denmark,2004,sp,014,2,1,3
Denmark,2004,sp,1524,10,6,16
Denmark,2004,sp,2534,16,12,28
Denmark,2004,sp,3544,10,17,27
Denmark,2004,sp,4554,9,27,36
Denmark,2004,sp,5564,7,15,22
Denmark,2004,sp,65,2,12,14
Denmark,2005,sp,014,2,0,2
Denmark,2005,sp,1524,11,12,23
Denmark,2005,sp,2534,5,12,17
Denmark,2005,sp,3544,13,18,31
Denmark,2005,sp,4554,9,23,32
Denmark,2005,sp,5564,3,9,12
Denmark,2005,sp,65,5,7,12
Denmark,2006,ep,014,5,3,8
Denmark,2006,ep,1524,8,12,20
Denmark,2006,ep,2534,7,9,16
Denmark,2006,ep,3544,10,10,20
Denmark,2006,ep,4554,6,6,12
Denmark,2006,ep,5564,2,1,3
Denmark,2006,ep,65,9,7,16
Denmark,2006,sn,014,4,9,13
Denmark,2006,sn,1524,9,14,23
Denmark,2006,sn,2534,7,8,15
Denmark,2006,sn,3544,13,17,30
Denmark,2006,sn,4554,7,13,20
Denmark,2006,sn,5564,4,6,10
Denmark,2006,sn,65,4,8,12
Denmark,2006,sp,014,1,0,1
Denmark,2006,sp,1524,6,8,14
Denmark,2006,sp,2534,12,13,25
Denmark,2006,sp,3544,9,15,24
Denmark,2006,sp,4554,5,27,32
Denmark,2006,sp,5564,5,10,15
Denmark,2006,sp,65,4,8,12
Denmark,2007,ep,014,6,1,7
Denmark,2007,ep,1524,6,10,16
Denmark,2007,ep,2534,16,10,26
Denmark,2007,ep,3544,4,10,14
Denmark,2007,ep,4554,4,5,9
Denmark,2007,ep,5564,2,3,5
Denmark,2007,ep,65,4,2,6
Denmark,2007,sn,014,8,9,17
Denmark,2007,sn,1524,10,13,23
Denmark,2007,sn,2534,13,14,27
Denmark,2007,sn,3544,6,10,16
Denmark,2007,sn,4554,7,17,24
Denmark,2007,sn,5564,10,6,16
Denmark,2007,sn,65,6,8,14
Denmark,2007,sp,014,1,0,1
Denmark,2007,sp,1524,8,6,14
Denmark,2007,sp,2534,12,12,24
Denmark,2007,sp,3544,8,20,28
Denmark,2007,sp,4554,4,29,33
Denmark,2007,sp,5564,5,16,21
Denmark,2007,sp,65,8,6,14
Denmark,2008,ep,014,1,2,3
Denmark,2008,ep,1524,3,7,10
Denmark,2008,ep,2534,13,12,25
Denmark,2008,ep,3544,12,9,21
Denmark,2008,ep,4554,4,5,9
Denmark,2008,ep,5564,2,4,6
Denmark,2008,ep,65,4,5,9
Denmark,2008,sn,014,9,7,16
Denmark,2008,sn,1524,7,12,19
Denmark,2008,sn,2534,4,13,17
Denmark,2008,sn,3544,9,16,25
Denmark,2008,sn,4554,13,12,25
Denmark,2008,sn,5564,6,9,15
Denmark,2008,sn,65,12,11,23
Denmark,2008,sp,014,2,0,2
Denmark,2008,sp,1524,5,8,13
Denmark,2008,sp,2534,7,15,22
Denmark,2008,sp,3544,5,9,14
Denmark,2008,sp,4554,8,24,32
Denmark,2008,sp,5564,4,10,14
Denmark,2008,sp,65,1,8,9
Denmark,2009,ep,014,4,0,4
Denmark,2009,ep,1524,8,6,14
Denmark,2009,ep,2534,5,13,18
Denmark,2009,ep,3544,8,4,12
Denmark,2009,ep,4554,3,5,8
Denmark,2009,ep,5564,2,1,3
Denmark,2009,ep,65,1,3,4
Denmark,2009,sn,014,5,10,15
Denmark,2009,sn,1524,8,7,15
Denmark,2009,sn,2534,12,9,21
Denmark,2009,sn,3544,4,17,21
Denmark,2009,sn,4554,9,18,27
Denmark,2009,sn,5564,3,6,9
Denmark,2009,sn,65,6,11,17
Denmark,2009,sp,014,2,0,2
Denmark,2009,sp,1524,7,7,14
Denmark,2009,sp,2534,16,7,23
Denmark,2009,sp,3544,7,13,20
Denmark,2009,sp,4554,8,15,23
Denmark,2009,sp,5564,2,12,14
Denmark,2009,sp,65,1,5,6
Denmark,2010,ep,014,1,0,1
Denmark,2010,ep,1524,0,2,2
Denmark,2010,ep,2534,5,9,14
Denmark,2010,ep,3544,5,5,10
Denmark,2010,ep,4554,2,2,4
Denmark,2010,ep,5564,2,1,3
Denmark,2010,ep,65,4,3,7
Denmark,2010,sn,014,3,5,8
Denmark,2010,sn,1524,3,5,8
Denmark,2010,sn,2534,9,14,23
Denmark,2010,sn,3544,11,12,23
Denmark,2010,sn,4554,14,11,25
Denmark,2010,sn,5564,3,6,9
Denmark,2010,sn,65,5,5,10
Denmark,2010,sp,014,0,0,0
Denmark,2010,sp,1524,4,8,12
Denmark,2010,sp,2534,6,22,28
Denmark,2010,sp,3544,15,10,25
Denmark,2010,sp,4554,8,13,21
Denmark,2010,sp,5564,9,16,25
Denmark,2010,sp,65,4,2,6
Denmark,2011,ep,014,1,2,3
Denmark,2011,ep,1524,4,3,7
Denmark,2011,ep,2534,7,6,13
Denmark,2011,ep,3544,6,8,14
Denmark,2011,ep,4554,1,3,4
Denmark,2011,ep,5564,0,2,2
Denmark,2011,ep,65,2,0,2
Denmark,2011,sn,014,5,2,7
Denmark,2011,sn,1524,4,4,8
Denmark,2011,sn,2534,4,11,15
Denmark,2011,sn,3544,7,9,16
Denmark,2011,sn,4554,11,13,24
Denmark,2011,sn,5564,8,5,13
Denmark,2011,sn,65,7,10,17
Denmark,2011,sp,014,0,0,0
Denmark,2011,sp,1524,5,5,10
Denmark,2011,sp,2534,5,14,19
Denmark,2011,sp,3544,9,18,27
Denmark,2011,sp,4554,7,32,39
Denmark,2011,sp,5564,2,16,18
Denmark,2011,sp,65,7,4,11
Denmark,2012,ep,014,1,0,1
Denmark,2012,ep,1524,6,4,10
Denmark,2012,ep,2534,13,12,25
Denmark,2012,ep,3544,7,8,15
Denmark,2012,ep,4554,4,4,8
Denmark,2012,ep,5564,5,8,13
Denmark,2012,ep,65,1,1,2
Denmark,2012,sn,014,7,6,13
Denmark,2012,sn,1524,7,10,17
Denmark,2012,sn,2534,11,17,28
Denmark,2012,sn,3544,5,10,15
Denmark,2012,sn,4554,10,27,37
Denmark,2012,sn,5564,11,17,28
Denmark,2012,sn,65,7,11,18
Denmark,2012,sp,014,3,0,3
Denmark,2012,sp,1524,2,7,9
Denmark,2012,sp,2534,7,9,16
Denmark,2012,sp,3544,3,25,28
Denmark,2012,sp,4554,7,19,26
Denmark,2012,sp,5564,3,15,18
Denmark,2012,sp,65,1,6,7
Denmark,2013,rel,014,8,14,22
Denmark,2013,rel,1524,9,30,39
Denmark,2013,rel,2534,27,42,69
Denmark,2013,rel,3544,17,37,54
Denmark,2013,rel,4554,26,51,77
Denmark,2013,rel,5564,20,26,46
Denmark,2013,rel,65,6,17,23
Djibouti,1996,sp,014,31,30,61
Djibouti,1996,sp,1524,247,421,668
Djibouti,1996,sp,2534,212,429,641
Djibouti,1996,sp,3544,67,139,206
Djibouti,1996,sp,4554,38,77,115
Djibouti,1996,sp,5564,21,52,73
Djibouti,1996,sp,65,5,27,32
Djibouti,1997,sp,014,51,52,103
Djibouti,1997,sp,1524,202,428,630
Djibouti,1997,sp,2534,225,442,667
Djibouti,1997,sp,3544,75,167,242
Djibouti,1997,sp,4554,38,115,153
Djibouti,1997,sp,5564,17,66,83
Djibouti,1997,sp,65,4,23,27
Djibouti,1998,sp,014,28,23,51
Djibouti,1998,sp,1524,208,348,556
Djibouti,1998,sp,2534,197,396,593
Djibouti,1998,sp,3544,76,191,267
Djibouti,1998,sp,4554,43,81,124
Djibouti,1998,sp,5564,17,57,74
Djibouti,1998,sp,65,9,23,32
Djibouti,1999,sp,014,20,25,45
Djibouti,1999,sp,1524,158,348,506
Djibouti,1999,sp,2534,168,371,539
Djibouti,1999,sp,3544,84,159,243
Djibouti,1999,sp,4554,38,87,125
Djibouti,1999,sp,5564,20,67,87
Djibouti,1999,sp,65,3,22,25
Djibouti,2000,sp,014,12,17,29
Djibouti,2000,sp,1524,147,302,449
Djibouti,2000,sp,2534,156,347,503
Djibouti,2000,sp,3544,47,139,186
Djibouti,2000,sp,4554,31,67,98
Djibouti,2000,sp,5564,17,60,77
Djibouti,2000,sp,65,10,42,52
Djibouti,2001,sp,014,17,17,34
Djibouti,2001,sp,1524,156,267,423
Djibouti,2001,sp,2534,134,331,465
Djibouti,2001,sp,3544,59,125,184
Djibouti,2001,sp,4554,44,65,109
Djibouti,2001,sp,5564,15,51,66
Djibouti,2001,sp,65,8,23,31
Djibouti,2002,sp,014,18,20,38
Djibouti,2002,sp,1524,142,256,398
Djibouti,2002,sp,2534,136,320,456
Djibouti,2002,sp,3544,48,124,172
Djibouti,2002,sp,4554,28,58,86
Djibouti,2002,sp,5564,19,55,74
Djibouti,2002,sp,65,4,25,29
Djibouti,2003,sp,014,19,10,29
Djibouti,2003,sp,1524,127,222,349
Djibouti,2003,sp,2534,123,288,411
Djibouti,2003,sp,3544,55,132,187
Djibouti,2003,sp,4554,38,76,114
Djibouti,2003,sp,5564,28,42,70
Djibouti,2003,sp,65,8,24,32
Djibouti,2004,sp,014,16,19,35
Djibouti,2004,sp,1524,111,217,328
Djibouti,2004,sp,2534,115,225,340
Djibouti,2004,sp,3544,49,142,191
Djibouti,2004,sp,4554,23,68,91
Djibouti,2004,sp,5564,25,38,63
Djibouti,2004,sp,65,10,28,38
Djibouti,2005,sp,014,23,18,41
Djibouti,2005,sp,1524,123,220,343
Djibouti,2005,sp,2534,117,252,369
Djibouti,2005,sp,3544,66,119,185
Djibouti,2005,sp,4554,23,62,85
Djibouti,2005,sp,5564,13,47,60
Djibouti,2005,sp,65,8,29,37
Djibouti,2006,sp,014,24,14,38
Djibouti,2006,sp,1524,117,225,342
Djibouti,2006,sp,2534,129,246,375
Djibouti,2006,sp,3544,59,165,224
Djibouti,2006,sp,4554,35,63,98
Djibouti,2006,sp,5564,18,33,51
Djibouti,2006,sp,65,5,20,25
Djibouti,2007,ep,014,229,260,489
Djibouti,2007,ep,1524,124,143,267
Djibouti,2007,ep,2534,130,134,264
Djibouti,2007,ep,3544,72,80,152
Djibouti,2007,ep,4554,52,33,85
Djibouti,2007,ep,5564,24,20,44
Djibouti,2007,ep,65,16,12,28
Djibouti,2007,sn,014,6,5,11
Djibouti,2007,sn,1524,42,49,91
Djibouti,2007,sn,2534,44,31,75
Djibouti,2007,sn,3544,36,18,54
Djibouti,2007,sn,4554,11,11,22
Djibouti,2007,sn,5564,13,5,18
Djibouti,2007,sn,65,8,10,18
Djibouti,2007,sp,014,8,14,22
Djibouti,2007,sp,1524,129,241,370
Djibouti,2007,sp,2534,131,264,395
Djibouti,2007,sp,3544,62,142,204
Djibouti,2007,sp,4554,35,83,118
Djibouti,2007,sp,5564,14,44,58
Djibouti,2007,sp,65,18,23,41
Djibouti,2008,sp,014,22,17,39
Djibouti,2008,sp,1524,138,232,370
Djibouti,2008,sp,2534,159,275,434
Djibouti,2008,sp,3544,79,180,259
Djibouti,2008,sp,4554,53,93,146
Djibouti,2008,sp,5564,15,56,71
Djibouti,2008,sp,65,10,46,56
Djibouti,2009,sp,014,18,18,36
Djibouti,2009,sp,1524,139,230,369
Djibouti,2009,sp,2534,154,295,449
Djibouti,2009,sp,3544,85,183,268
Djibouti,2009,sp,4554,52,90,142
Djibouti,2009,sp,5564,29,49,78
Djibouti,2009,sp,65,11,24,35
Djibouti,2010,sp,014,20,28,48
Djibouti,2010,sp,1524,104,211,315
Djibouti,2010,sp,2534,120,243,363
Djibouti,2010,sp,3544,89,151,240
Djibouti,2010,sp,4554,36,67,103
Djibouti,2010,sp,5564,24,49,73
Djibouti,2010,sp,65,19,20,39
Djibouti,2011,sp,014,31,35,66
Djibouti,2011,sp,1524,139,212,351
Djibouti,2011,sp,2534,118,265,383
Djibouti,2011,sp,3544,104,149,253
Djibouti,2011,sp,4554,57,97,154
Djibouti,2011,sp,5564,30,45,75
Djibouti,2011,sp,65,21,33,54
Djibouti,2012,sp,014,20,22,42
Djibouti,2012,sp,1524,132,208,340
Djibouti,2012,sp,2534,94,240,334
Djibouti,2012,sp,3544,73,147,220
Djibouti,2012,sp,4554,36,81,117
Djibouti,2012,sp,5564,26,47,73
Djibouti,2012,sp,65,18,26,44
Djibouti,2013,rel,014,21,24,45
Djibouti,2013,rel,1524,130,202,332
Djibouti,2013,rel,2534,113,215,328
Djibouti,2013,rel,3544,55,137,192
Djibouti,2013,rel,4554,59,73,132
Djibouti,2013,rel,5564,23,46,69
Djibouti,2013,rel,65,17,35,52
Dominica,1996,sp,014,0,0,0
Dominica,1996,sp,1524,0,0,0
Dominica,1996,sp,2534,1,1,2
Dominica,1996,sp,3544,0,2,2
Dominica,1996,sp,4554,1,1,2
Dominica,1996,sp,5564,0,1,1
Dominica,1996,sp,65,0,0,0
Dominica,1997,sp,014,0,0,0
Dominica,1997,sp,1524,0,0,0
Dominica,1997,sp,2534,0,0,0
Dominica,1997,sp,3544,0,0,0
Dominica,1997,sp,4554,1,1,2
Dominica,1997,sp,5564,1,1,2
Dominica,1997,sp,65,0,1,1
Dominica,1998,sp,014,0,0,0
Dominica,1998,sp,1524,2,0,2
Dominica,1998,sp,2534,0,0,0
Dominica,1998,sp,3544,1,0,1
Dominica,1998,sp,4554,0,1,1
Dominica,1998,sp,5564,1,0,1
Dominica,1998,sp,65,0,0,0
Dominica,2002,sp,3544,1,NA,NA
Dominica,2002,sp,5564,NA,1,NA
Dominica,2006,ep,014,0,0,0
Dominica,2006,ep,1524,0,0,0
Dominica,2006,ep,2534,0,0,0
Dominica,2006,ep,3544,0,0,0
Dominica,2006,ep,4554,0,0,0
Dominica,2006,ep,5564,0,0,0
Dominica,2006,ep,65,0,0,0
Dominica,2006,sn,014,0,0,0
Dominica,2006,sn,1524,0,0,0
Dominica,2006,sn,2534,0,0,0
Dominica,2006,sn,3544,3,2,5
Dominica,2006,sn,4554,0,0,0
Dominica,2006,sn,5564,1,0,1
Dominica,2006,sn,65,3,2,5
Dominica,2006,sp,014,0,0,0
Dominica,2006,sp,1524,1,0,1
Dominica,2006,sp,2534,0,1,1
Dominica,2006,sp,3544,1,1,2
Dominica,2006,sp,4554,1,0,1
Dominica,2006,sp,5564,1,1,2
Dominica,2006,sp,65,0,1,1
Dominica,2007,ep,014,0,0,0
Dominica,2007,ep,1524,0,0,0
Dominica,2007,ep,2534,0,0,0
Dominica,2007,ep,3544,0,0,0
Dominica,2007,ep,4554,0,0,0
Dominica,2007,ep,5564,0,0,0
Dominica,2007,ep,65,0,0,0
Dominica,2007,sn,014,0,0,0
Dominica,2007,sn,1524,0,0,0
Dominica,2007,sn,2534,0,0,0
Dominica,2007,sn,3544,0,0,0
Dominica,2007,sn,4554,0,0,0
Dominica,2007,sn,5564,0,0,0
Dominica,2007,sn,65,0,0,0
Dominica,2007,sp,014,0,0,0
Dominica,2007,sp,1524,0,0,0
Dominica,2007,sp,2534,0,0,0
Dominica,2007,sp,3544,0,1,1
Dominica,2007,sp,4554,0,0,0
Dominica,2007,sp,5564,1,1,2
Dominica,2007,sp,65,0,0,0
Dominica,2008,ep,014,0,0,0
Dominica,2008,ep,1524,0,0,0
Dominica,2008,ep,2534,0,0,0
Dominica,2008,ep,3544,0,0,0
Dominica,2008,ep,4554,0,0,0
Dominica,2008,ep,5564,0,0,0
Dominica,2008,ep,65,0,0,0
Dominica,2008,sn,014,0,0,0
Dominica,2008,sn,1524,0,0,0
Dominica,2008,sn,2534,0,1,1
Dominica,2008,sn,3544,0,1,1
Dominica,2008,sn,4554,0,5,5
Dominica,2008,sn,5564,0,1,1
Dominica,2008,sn,65,0,1,1
Dominica,2008,sp,014,0,0,0
Dominica,2008,sp,1524,0,0,0
Dominica,2008,sp,2534,0,0,0
Dominica,2008,sp,3544,0,1,1
Dominica,2008,sp,4554,0,2,2
Dominica,2008,sp,5564,0,0,0
Dominica,2008,sp,65,0,0,0
Dominica,2009,ep,014,0,0,0
Dominica,2009,ep,1524,0,0,0
Dominica,2009,ep,2534,0,0,0
Dominica,2009,ep,3544,0,0,0
Dominica,2009,ep,4554,0,0,0
Dominica,2009,ep,5564,0,0,0
Dominica,2009,ep,65,0,0,0
Dominica,2009,sn,014,0,0,0
Dominica,2009,sn,1524,0,0,0
Dominica,2009,sn,2534,0,0,0
Dominica,2009,sn,3544,0,0,0
Dominica,2009,sn,4554,0,0,0
Dominica,2009,sn,5564,0,0,0
Dominica,2009,sn,65,0,0,0
Dominica,2009,sp,014,0,0,0
Dominica,2009,sp,1524,0,0,0
Dominica,2009,sp,2534,0,1,1
Dominica,2009,sp,3544,0,1,1
Dominica,2009,sp,4554,0,0,0
Dominica,2009,sp,5564,0,0,0
Dominica,2009,sp,65,1,1,2
Dominica,2010,ep,014,0,0,0
Dominica,2010,ep,1524,0,0,0
Dominica,2010,ep,2534,0,0,0
Dominica,2010,ep,3544,0,0,0
Dominica,2010,ep,4554,0,0,0
Dominica,2010,ep,5564,0,0,0
Dominica,2010,ep,65,0,0,0
Dominica,2010,sn,014,0,0,0
Dominica,2010,sn,1524,0,0,0
Dominica,2010,sn,2534,0,0,0
Dominica,2010,sn,3544,0,0,0
Dominica,2010,sn,4554,0,0,0
Dominica,2010,sn,5564,0,0,0
Dominica,2010,sn,65,0,0,0
Dominica,2010,sp,014,0,0,0
Dominica,2010,sp,1524,0,0,0
Dominica,2010,sp,2534,0,0,0
Dominica,2010,sp,3544,1,0,1
Dominica,2010,sp,4554,2,0,2
Dominica,2010,sp,5564,1,3,4
Dominica,2010,sp,65,0,1,1
Dominica,2011,ep,014,0,0,0
Dominica,2011,ep,1524,0,0,0
Dominica,2011,ep,2534,0,0,0
Dominica,2011,ep,3544,0,0,0
Dominica,2011,ep,4554,0,0,0
Dominica,2011,ep,5564,0,0,0
Dominica,2011,ep,65,0,0,0
Dominica,2011,sn,014,0,0,0
Dominica,2011,sn,1524,0,0,0
Dominica,2011,sn,2534,0,0,0
Dominica,2011,sn,3544,0,0,0
Dominica,2011,sn,4554,0,0,0
Dominica,2011,sn,5564,0,0,0
Dominica,2011,sn,65,0,0,0
Dominica,2011,sp,014,0,0,0
Dominica,2011,sp,1524,0,0,0
Dominica,2011,sp,2534,0,NA,NA
Dominica,2011,sp,3544,0,2,2
Dominica,2011,sp,4554,0,0,0
Dominica,2011,sp,5564,0,0,0
Dominica,2011,sp,65,0,0,0
Dominica,2012,ep,014,0,0,0
Dominica,2012,ep,1524,0,0,0
Dominica,2012,ep,2534,0,0,0
Dominica,2012,ep,3544,0,0,0
Dominica,2012,ep,4554,0,0,0
Dominica,2012,ep,5564,0,0,0
Dominica,2012,ep,65,0,0,0
Dominica,2012,sn,014,0,0,0
Dominica,2012,sn,1524,0,0,0
Dominica,2012,sn,2534,0,0,0
Dominica,2012,sn,3544,0,0,0
Dominica,2012,sn,4554,0,1,1
Dominica,2012,sn,5564,0,0,0
Dominica,2012,sn,65,0,0,0
Dominica,2012,sp,014,0,0,0
Dominica,2012,sp,1524,0,2,2
Dominica,2012,sp,2534,0,0,0
Dominica,2012,sp,3544,0,0,0
Dominica,2012,sp,4554,0,1,1
Dominica,2012,sp,5564,0,2,2
Dominica,2012,sp,65,0,0,0
Dominica,2013,rel,014,0,0,0
Dominica,2013,rel,1524,0,0,0
Dominica,2013,rel,2534,0,0,0
Dominica,2013,rel,3544,0,2,2
Dominica,2013,rel,4554,0,1,1
Dominica,2013,rel,5564,0,0,0
Dominica,2013,rel,65,0,0,0
Dominican Republic,1996,sp,014,21,17,38
Dominican Republic,1996,sp,1524,178,231,409
Dominican Republic,1996,sp,2534,147,262,409
Dominican Republic,1996,sp,3544,61,128,189
Dominican Republic,1996,sp,4554,44,79,123
Dominican Republic,1996,sp,5564,23,45,68
Dominican Republic,1996,sp,65,22,42,64
Dominican Republic,1997,sp,014,53,76,129
Dominican Republic,1997,sp,1524,314,450,764
Dominican Republic,1997,sp,2534,329,471,800
Dominican Republic,1997,sp,3544,171,246,417
Dominican Republic,1997,sp,4554,102,145,247
Dominican Republic,1997,sp,5564,77,111,188
Dominican Republic,1997,sp,65,56,81,137
Dominican Republic,1998,sp,014,60,62,122
Dominican Republic,1998,sp,1524,265,340,605
Dominican Republic,1998,sp,2534,247,416,663
Dominican Republic,1998,sp,3544,141,184,325
Dominican Republic,1998,sp,4554,79,130,209
Dominican Republic,1998,sp,5564,73,114,187
Dominican Republic,1998,sp,65,33,50,83
Dominican Republic,1999,sp,014,99,90,189
Dominican Republic,1999,sp,1524,363,507,870
Dominican Republic,1999,sp,2534,359,485,844
Dominican Republic,1999,sp,3544,226,356,582
Dominican Republic,1999,sp,4554,160,238,398
Dominican Republic,1999,sp,5564,121,166,287
Dominican Republic,1999,sp,65,136,183,319
Dominican Republic,2000,sp,014,65,73,138
Dominican Republic,2000,sp,1524,317,410,727
Dominican Republic,2000,sp,2534,325,481,806
Dominican Republic,2000,sp,3544,212,344,556
Dominican Republic,2000,sp,4554,115,173,288
Dominican Republic,2000,sp,5564,79,125,204
Dominican Republic,2000,sp,65,75,113,188
Dominican Republic,2002,sp,014,35,39,74
Dominican Republic,2002,sp,1524,251,295,546
Dominican Republic,2002,sp,2534,241,417,658
Dominican Republic,2002,sp,3544,137,270,407
Dominican Republic,2002,sp,4554,81,145,226
Dominican Republic,2002,sp,5564,49,86,135
Dominican Republic,2002,sp,65,62,71,133
Dominican Republic,2003,sp,014,48,52,100
Dominican Republic,2003,sp,1524,301,364,665
Dominican Republic,2003,sp,2534,288,518,806
Dominican Republic,2003,sp,3544,211,331,542
Dominican Republic,2003,sp,4554,116,194,310
Dominican Republic,2003,sp,5564,82,116,198
Dominican Republic,2003,sp,65,73,112,185
Dominican Republic,2004,sp,014,39,45,84
Dominican Republic,2004,sp,1524,301,391,692
Dominican Republic,2004,sp,2534,288,502,790
Dominican Republic,2004,sp,3544,177,363,540
Dominican Republic,2004,sp,4554,104,180,284
Dominican Republic,2004,sp,5564,60,122,182
Dominican Republic,2004,sp,65,44,104,148
Dominican Republic,2005,sp,014,57,43,100
Dominican Republic,2005,sp,1524,339,399,738
Dominican Republic,2005,sp,2534,332,483,815
Dominican Republic,2005,sp,3544,209,386,595
Dominican Republic,2005,sp,4554,119,228,347
Dominican Republic,2005,sp,5564,72,123,195
Dominican Republic,2005,sp,65,54,105,159
Dominican Republic,2006,sp,014,38,25,63
Dominican Republic,2006,sp,1524,287,342,629
Dominican Republic,2006,sp,2534,320,480,800
Dominican Republic,2006,sp,3544,189,340,529
Dominican Republic,2006,sp,4554,106,207,313
Dominican Republic,2006,sp,5564,63,111,174
Dominican Republic,2006,sp,65,58,92,150
Dominican Republic,2007,ep,014,0,0,0
Dominican Republic,2007,ep,1524,0,0,0
Dominican Republic,2007,ep,2534,0,0,0
Dominican Republic,2007,ep,3544,0,0,0
Dominican Republic,2007,ep,4554,0,0,0
Dominican Republic,2007,ep,5564,0,0,0
Dominican Republic,2007,ep,65,0,0,0
Dominican Republic,2007,sn,014,0,0,0
Dominican Republic,2007,sn,1524,0,0,0
Dominican Republic,2007,sn,2534,0,0,0
Dominican Republic,2007,sn,3544,0,0,0
Dominican Republic,2007,sn,4554,0,0,0
Dominican Republic,2007,sn,5564,0,0,0
Dominican Republic,2007,sn,65,0,0,0
Dominican Republic,2007,sp,014,29,23,52
Dominican Republic,2007,sp,1524,249,290,539
Dominican Republic,2007,sp,2534,242,403,645
Dominican Republic,2007,sp,3544,174,362,536
Dominican Republic,2007,sp,4554,103,209,312
Dominican Republic,2007,sp,5564,53,108,161
Dominican Republic,2007,sp,65,43,85,128
Dominican Republic,2008,sp,014,34,16,50
Dominican Republic,2008,sp,1524,288,322,610
Dominican Republic,2008,sp,2534,272,398,670
Dominican Republic,2008,sp,3544,163,337,500
Dominican Republic,2008,sp,4554,96,198,294
Dominican Republic,2008,sp,5564,55,122,177
Dominican Republic,2008,sp,65,52,105,157
Dominican Republic,2009,ep,014,0,0,0
Dominican Republic,2009,ep,1524,0,0,0
Dominican Republic,2009,ep,2534,0,0,0
Dominican Republic,2009,ep,3544,0,0,0
Dominican Republic,2009,ep,4554,0,0,0
Dominican Republic,2009,ep,5564,0,0,0
Dominican Republic,2009,ep,65,0,0,0
Dominican Republic,2009,sn,014,0,0,0
Dominican Republic,2009,sn,1524,0,0,0
Dominican Republic,2009,sn,2534,0,0,0
Dominican Republic,2009,sn,3544,0,0,0
Dominican Republic,2009,sn,4554,0,0,0
Dominican Republic,2009,sn,5564,0,0,0
Dominican Republic,2009,sn,65,0,0,0
Dominican Republic,2009,sp,014,28,30,58
Dominican Republic,2009,sp,1524,278,344,622
Dominican Republic,2009,sp,2534,271,428,699
Dominican Republic,2009,sp,3544,160,284,444
Dominican Republic,2009,sp,4554,92,217,309
Dominican Republic,2009,sp,5564,49,116,165
Dominican Republic,2009,sp,65,56,88,144
Dominican Republic,2010,ep,014,0,0,0
Dominican Republic,2010,ep,1524,0,0,0
Dominican Republic,2010,ep,2534,0,0,0
Dominican Republic,2010,ep,3544,0,0,0
Dominican Republic,2010,ep,4554,0,0,0
Dominican Republic,2010,ep,5564,0,0,0
Dominican Republic,2010,ep,65,0,0,0
Dominican Republic,2010,sn,014,0,0,0
Dominican Republic,2010,sn,1524,0,0,0
Dominican Republic,2010,sn,2534,0,0,0
Dominican Republic,2010,sn,3544,0,0,0
Dominican Republic,2010,sn,4554,0,0,0
Dominican Republic,2010,sn,5564,0,0,0
Dominican Republic,2010,sn,65,0,0,0
Dominican Republic,2010,sp,014,43,29,72
Dominican Republic,2010,sp,1524,239,276,515
Dominican Republic,2010,sp,2534,207,346,553
Dominican Republic,2010,sp,3544,142,292,434
Dominican Republic,2010,sp,4554,102,170,272
Dominican Republic,2010,sp,5564,54,112,166
Dominican Republic,2010,sp,65,62,85,147
Dominican Republic,2011,sp,014,30,20,50
Dominican Republic,2011,sp,1524,242,333,575
Dominican Republic,2011,sp,2534,274,406,680
Dominican Republic,2011,sp,3544,159,318,477
Dominican Republic,2011,sp,4554,103,200,303
Dominican Republic,2011,sp,5564,66,133,199
Dominican Republic,2011,sp,65,58,112,170
Dominican Republic,2012,sp,014,26,15,41
Dominican Republic,2012,sp,1524,230,317,547
Dominican Republic,2012,sp,2534,260,489,749
Dominican Republic,2012,sp,3544,148,315,463
Dominican Republic,2012,sp,4554,119,197,316
Dominican Republic,2012,sp,5564,62,126,188
Dominican Republic,2012,sp,65,68,111,179
Dominican Republic,2013,rel,014,30,22,52
Dominican Republic,2013,rel,1524,246,388,634
Dominican Republic,2013,rel,2534,240,477,717
Dominican Republic,2013,rel,3544,166,333,499
Dominican Republic,2013,rel,4554,130,244,374
Dominican Republic,2013,rel,5564,66,158,224
Dominican Republic,2013,rel,65,62,113,175
Ecuador,1998,sp,014,44,169,213
Ecuador,1998,sp,1524,290,402,692
Ecuador,1998,sp,2534,175,286,461
Ecuador,1998,sp,3544,99,58,157
Ecuador,2001,sp,014,37,39,76
Ecuador,2001,sp,1524,591,673,1264
Ecuador,2001,sp,2534,584,832,1416
Ecuador,2001,sp,3544,267,269,536
Ecuador,2001,sp,4554,180,202,382
Ecuador,2001,sp,5564,208,251,459
Ecuador,2001,sp,65,190,116,306
Ecuador,2003,sp,014,24,18,42
Ecuador,2003,sp,1524,217,310,527
Ecuador,2003,sp,2534,140,266,406
Ecuador,2003,sp,3544,94,194,288
Ecuador,2003,sp,4554,56,125,181
Ecuador,2003,sp,5564,44,75,119
Ecuador,2003,sp,65,40,96,136
Ecuador,2004,sp,014,108,84,192
Ecuador,2004,sp,1524,522,732,1254
Ecuador,2004,sp,2534,342,537,879
Ecuador,2004,sp,3544,268,563,831
Ecuador,2004,sp,4554,170,265,435
Ecuador,2004,sp,5564,161,315,476
Ecuador,2004,sp,65,120,153,273
Ecuador,2005,sp,014,48,48,96
Ecuador,2005,sp,1524,329,446,775
Ecuador,2005,sp,2534,305,468,773
Ecuador,2005,sp,3544,199,308,507
Ecuador,2005,sp,4554,139,237,376
Ecuador,2005,sp,5564,85,150,235
Ecuador,2005,sp,65,127,159,286
Ecuador,2006,sp,014,46,32,78
Ecuador,2006,sp,1524,321,479,800
Ecuador,2006,sp,2534,315,496,811
Ecuador,2006,sp,3544,183,340,523
Ecuador,2006,sp,4554,143,259,402
Ecuador,2006,sp,5564,92,181,273
Ecuador,2006,sp,65,112,183,295
Ecuador,2007,sp,014,57,42,99
Ecuador,2007,sp,1524,365,555,920
Ecuador,2007,sp,2534,335,486,821
Ecuador,2007,sp,3544,198,367,565
Ecuador,2007,sp,4554,133,282,415
Ecuador,2007,sp,5564,100,178,278
Ecuador,2007,sp,65,123,227,350
Ecuador,2008,ep,014,0,0,0
Ecuador,2008,ep,1524,0,0,0
Ecuador,2008,ep,2534,0,0,0
Ecuador,2008,ep,3544,0,0,0
Ecuador,2008,ep,4554,0,0,0
Ecuador,2008,ep,5564,0,0,0
Ecuador,2008,ep,65,0,0,0
Ecuador,2008,sn,014,0,0,0
Ecuador,2008,sn,1524,0,0,0
Ecuador,2008,sn,2534,0,0,0
Ecuador,2008,sn,3544,0,0,0
Ecuador,2008,sn,4554,0,0,0
Ecuador,2008,sn,5564,0,0,0
Ecuador,2008,sn,65,0,0,0
Ecuador,2008,sp,014,56,32,88
Ecuador,2008,sp,1524,334,507,841
Ecuador,2008,sp,2534,331,518,849
Ecuador,2008,sp,3544,185,372,557
Ecuador,2008,sp,4554,126,278,404
Ecuador,2008,sp,5564,107,187,294
Ecuador,2008,sp,65,145,202,347
Ecuador,2009,sp,014,49,40,89
Ecuador,2009,sp,1524,342,485,827
Ecuador,2009,sp,2534,312,519,831
Ecuador,2009,sp,3544,162,296,458
Ecuador,2009,sp,4554,141,297,438
Ecuador,2009,sp,5564,99,212,311
Ecuador,2009,sp,65,146,230,376
Ecuador,2010,sp,014,52,32,84
Ecuador,2010,sp,1524,298,499,797
Ecuador,2010,sp,2534,308,529,837
Ecuador,2010,sp,3544,178,314,492
Ecuador,2010,sp,4554,158,309,467
Ecuador,2010,sp,5564,113,227,340
Ecuador,2010,sp,65,110,246,356
Ecuador,2011,ep,014,20,39,59
Ecuador,2011,ep,1524,50,77,127
Ecuador,2011,ep,2534,78,131,209
Ecuador,2011,ep,3544,39,107,146
Ecuador,2011,ep,4554,29,58,87
Ecuador,2011,ep,5564,31,52,83
Ecuador,2011,ep,65,39,58,97
Ecuador,2011,sn,014,31,46,77
Ecuador,2011,sn,1524,18,42,60
Ecuador,2011,sn,2534,25,59,84
Ecuador,2011,sn,3544,10,40,50
Ecuador,2011,sn,4554,13,23,36
Ecuador,2011,sn,5564,21,17,38
Ecuador,2011,sn,65,12,23,35
Ecuador,2011,sp,014,49,45,94
Ecuador,2011,sp,1524,340,481,821
Ecuador,2011,sp,2534,311,547,858
Ecuador,2011,sp,3544,177,364,541
Ecuador,2011,sp,4554,141,323,464
Ecuador,2011,sp,5564,118,272,390
Ecuador,2011,sp,65,121,232,353
Ecuador,2012,ep,014,19,29,48
Ecuador,2012,ep,1524,72,102,174
Ecuador,2012,ep,2534,80,126,206
Ecuador,2012,ep,3544,55,87,142
Ecuador,2012,ep,4554,40,61,101
Ecuador,2012,ep,5564,43,50,93
Ecuador,2012,ep,65,42,50,92
Ecuador,2012,sn,014,24,35,59
Ecuador,2012,sn,1524,17,28,45
Ecuador,2012,sn,2534,15,41,56
Ecuador,2012,sn,3544,7,20,27
Ecuador,2012,sn,4554,9,25,34
Ecuador,2012,sn,5564,12,18,30
Ecuador,2012,sn,65,15,19,34
Ecuador,2012,sp,014,59,37,96
Ecuador,2012,sp,1524,333,506,839
Ecuador,2012,sp,2534,337,567,904
Ecuador,2012,sp,3544,184,387,571
Ecuador,2012,sp,4554,164,359,523
Ecuador,2012,sp,5564,146,291,437
Ecuador,2012,sp,65,153,333,486
Ecuador,2013,rel,014,119,115,234
Ecuador,2013,rel,1524,440,686,1126
Ecuador,2013,rel,2534,387,825,1212
Ecuador,2013,rel,3544,268,545,813
Ecuador,2013,rel,4554,239,540,779
Ecuador,2013,rel,5564,176,353,529
Ecuador,2013,rel,65,199,385,584
Egypt,1995,sp,014,134,223,357
Egypt,1995,sp,1524,288,542,830
Egypt,1995,sp,2534,367,665,1032
Egypt,1995,sp,3544,274,460,734
Egypt,1995,sp,4554,256,408,664
Egypt,1995,sp,5564,160,463,623
Egypt,1995,sp,65,75,160,235
Egypt,1996,sp,014,64,58,122
Egypt,1996,sp,1524,52,714,766
Egypt,1996,sp,2534,420,1056,1476
Egypt,1996,sp,3544,259,703,962
Egypt,1996,sp,4554,229,485,714
Egypt,1996,sp,5564,89,308,397
Egypt,1996,sp,65,44,154,198
Egypt,1997,sp,014,64,50,114
Egypt,1997,sp,1524,525,737,1262
Egypt,1997,sp,2534,388,1033,1421
Egypt,1997,sp,3544,264,767,1031
Egypt,1997,sp,4554,200,465,665
Egypt,1997,sp,5564,114,291,405
Egypt,1997,sp,65,34,142,176
Egypt,1998,sp,014,60,45,105
Egypt,1998,sp,1524,489,761,1250
Egypt,1998,sp,2534,405,943,1348
Egypt,1998,sp,3544,291,761,1052
Egypt,1998,sp,4554,204,475,679
Egypt,1998,sp,5564,139,286,425
Egypt,1998,sp,65,44,174,218
Egypt,1999,sp,014,57,31,88
Egypt,1999,sp,1524,485,708,1193
Egypt,1999,sp,2534,347,889,1236
Egypt,1999,sp,3544,248,691,939
Egypt,1999,sp,4554,193,458,651
Egypt,1999,sp,5564,112,288,400
Egypt,1999,sp,65,36,170,206
Egypt,2000,sp,014,55,21,76
Egypt,2000,sp,1524,457,641,1098
Egypt,2000,sp,2534,343,827,1170
Egypt,2000,sp,3544,257,667,924
Egypt,2000,sp,4554,211,476,687
Egypt,2000,sp,5564,112,307,419
Egypt,2000,sp,65,48,158,206
Egypt,2001,sp,014,57,34,91
Egypt,2001,sp,1524,438,586,1024
Egypt,2001,sp,2534,396,879,1275
Egypt,2001,sp,3544,265,614,879
Egypt,2001,sp,4554,207,453,660
Egypt,2001,sp,5564,109,268,377
Egypt,2001,sp,65,49,159,208
Egypt,2002,sp,014,77,39,116
Egypt,2002,sp,1524,424,662,1086
Egypt,2002,sp,2534,365,774,1139
Egypt,2002,sp,3544,245,682,927
Egypt,2002,sp,4554,254,576,830
Egypt,2002,sp,5564,145,303,448
Egypt,2002,sp,65,60,171,231
Egypt,2003,sp,014,57,42,99
Egypt,2003,sp,1524,463,586,1049
Egypt,2003,sp,2534,338,814,1152
Egypt,2003,sp,3544,268,675,943
Egypt,2003,sp,4554,282,631,913
Egypt,2003,sp,5564,175,404,579
Egypt,2003,sp,65,71,195,266
Egypt,2004,sp,014,44,14,58
Egypt,2004,sp,1524,491,563,1054
Egypt,2004,sp,2534,317,763,1080
Egypt,2004,sp,3544,233,588,821
Egypt,2004,sp,4554,233,502,735
Egypt,2004,sp,5564,111,502,613
Egypt,2004,sp,65,54,204,258
Egypt,2005,sp,014,48,25,73
Egypt,2005,sp,1524,431,524,955
Egypt,2005,sp,2534,298,606,904
Egypt,2005,sp,3544,205,421,626
Egypt,2005,sp,4554,218,414,632
Egypt,2005,sp,5564,132,243,375
Egypt,2005,sp,65,42,123,165
Egypt,2006,ep,014,123,184,307
Egypt,2006,ep,1524,299,313,612
Egypt,2006,ep,2534,323,338,661
Egypt,2006,ep,3544,322,204,526
Egypt,2006,ep,4554,183,119,302
Egypt,2006,ep,5564,118,111,229
Egypt,2006,ep,65,32,54,86
Egypt,2006,sn,014,127,212,339
Egypt,2006,sn,1524,224,223,447
Egypt,2006,sn,2534,171,260,431
Egypt,2006,sn,3544,182,142,324
Egypt,2006,sn,4554,132,122,254
Egypt,2006,sn,5564,68,105,173
Egypt,2006,sn,65,42,116,158
Egypt,2006,sp,014,64,54,118
Egypt,2006,sp,1524,470,542,1012
Egypt,2006,sp,2534,367,728,1095
Egypt,2006,sp,3544,338,563,901
Egypt,2006,sp,4554,279,587,866
Egypt,2006,sp,5564,155,340,495
Egypt,2006,sp,65,87,136,223
Egypt,2007,ep,014,141,159,300
Egypt,2007,ep,1524,337,355,692
Egypt,2007,ep,2534,312,377,689
Egypt,2007,ep,3544,276,263,539
Egypt,2007,ep,4554,153,171,324
Egypt,2007,ep,5564,106,100,206
Egypt,2007,ep,65,50,69,119
Egypt,2007,sn,014,85,124,209
Egypt,2007,sn,1524,158,150,308
Egypt,2007,sn,2534,157,193,350
Egypt,2007,sn,3544,129,157,286
Egypt,2007,sn,4554,123,137,260
Egypt,2007,sn,5564,73,96,169
Egypt,2007,sn,65,35,86,121
Egypt,2007,sp,014,25,35,60
Egypt,2007,sp,1524,500,588,1088
Egypt,2007,sp,2534,325,853,1178
Egypt,2007,sp,3544,245,629,874
Egypt,2007,sp,4554,225,643,868
Egypt,2007,sp,5564,173,359,532
Egypt,2007,sp,65,72,214,286
Egypt,2008,ep,014,158,186,344
Egypt,2008,ep,1524,249,266,515
Egypt,2008,ep,2534,186,291,477
Egypt,2008,ep,3544,161,298,459
Egypt,2008,ep,4554,149,252,401
Egypt,2008,ep,5564,125,159,284
Egypt,2008,ep,65,51,134,185
Egypt,2008,sn,014,70,83,153
Egypt,2008,sn,1524,110,118,228
Egypt,2008,sn,2534,83,129,212
Egypt,2008,sn,3544,71,132,203
Egypt,2008,sn,4554,66,112,178
Egypt,2008,sn,5564,56,71,127
Egypt,2008,sn,65,23,59,82
Egypt,2008,sp,014,7,13,20
Egypt,2008,sp,1524,382,581,963
Egypt,2008,sp,2534,412,640,1052
Egypt,2008,sp,3544,308,807,1115
Egypt,2008,sp,4554,195,791,986
Egypt,2008,sp,5564,169,431,600
Egypt,2008,sp,65,113,242,355
Egypt,2009,ep,014,139,157,296
Egypt,2009,ep,1524,334,353,687
Egypt,2009,ep,2534,309,374,683
Egypt,2009,ep,3544,275,265,540
Egypt,2009,ep,4554,154,168,322
Egypt,2009,ep,5564,106,99,205
Egypt,2009,ep,65,49,68,117
Egypt,2009,sn,014,61,90,151
Egypt,2009,sn,1524,115,109,224
Egypt,2009,sn,2534,113,139,252
Egypt,2009,sn,3544,94,116,210
Egypt,2009,sn,4554,89,102,191
Egypt,2009,sn,5564,53,70,123
Egypt,2009,sn,65,25,62,87
Egypt,2009,sp,014,10,17,27
Egypt,2009,sp,1524,317,536,853
Egypt,2009,sp,2534,369,599,968
Egypt,2009,sp,3544,456,797,1253
Egypt,2009,sp,4554,210,885,1095
Egypt,2009,sp,5564,191,417,608
Egypt,2009,sp,65,126,271,397
Egypt,2010,ep,014,150,176,326
Egypt,2010,ep,1524,357,376,733
Egypt,2010,ep,2534,331,399,730
Egypt,2010,ep,3544,293,278,571
Egypt,2010,ep,4554,162,182,344
Egypt,2010,ep,5564,112,106,218
Egypt,2010,ep,65,53,73,126
Egypt,2010,sn,014,62,85,147
Egypt,2010,sn,1524,58,111,169
Egypt,2010,sn,2534,115,112,227
Egypt,2010,sn,3544,95,115,210
Egypt,2010,sn,4554,91,99,190
Egypt,2010,sn,5564,54,72,126
Egypt,2010,sn,65,26,64,90
Egypt,2010,sp,014,8,9,17
Egypt,2010,sp,1524,199,358,557
Egypt,2010,sp,2534,352,617,969
Egypt,2010,sp,3544,423,783,1206
Egypt,2010,sp,4554,292,725,1017
Egypt,2010,sp,5564,192,407,599
Egypt,2010,sp,65,97,217,314
Egypt,2011,ep,014,185,215,400
Egypt,2011,ep,1524,273,194,467
Egypt,2011,ep,2534,376,390,766
Egypt,2011,ep,3544,333,316,649
Egypt,2011,ep,4554,185,206,391
Egypt,2011,ep,5564,109,121,230
Egypt,2011,ep,65,90,83,173
Egypt,2011,sn,014,66,76,142
Egypt,2011,sn,1524,56,67,123
Egypt,2011,sn,2534,112,109,221
Egypt,2011,sn,3544,92,112,204
Egypt,2011,sn,4554,88,98,186
Egypt,2011,sn,5564,52,69,121
Egypt,2011,sn,65,25,30,55
Egypt,2011,sp,014,7,23,30
Egypt,2011,sp,1524,192,382,574
Egypt,2011,sp,2534,355,611,966
Egypt,2011,sp,3544,387,596,983
Egypt,2011,sp,4554,280,715,995
Egypt,2011,sp,5564,198,387,585
Egypt,2011,sp,65,94,168,262
Egypt,2012,ep,014,190,202,392
Egypt,2012,ep,1524,257,183,440
Egypt,2012,ep,2534,355,367,722
Egypt,2012,ep,3544,314,298,612
Egypt,2012,ep,4554,174,195,369
Egypt,2012,ep,5564,102,114,216
Egypt,2012,ep,65,84,78,162
Egypt,2012,sn,014,59,68,127
Egypt,2012,sn,1524,52,60,112
Egypt,2012,sn,2534,98,97,195
Egypt,2012,sn,3544,82,100,182
Egypt,2012,sn,4554,78,87,165
Egypt,2012,sn,5564,47,60,107
Egypt,2012,sn,65,22,27,49
Egypt,2012,sp,014,8,23,31
Egypt,2012,sp,1524,187,373,560
Egypt,2012,sp,2534,346,597,943
Egypt,2012,sp,3544,379,582,961
Egypt,2012,sp,4554,274,698,972
Egypt,2012,sp,5564,193,379,572
Egypt,2012,sp,65,92,164,256
Egypt,2013,rel,014,230,282,512
Egypt,2013,rel,1524,425,556,981
Egypt,2013,rel,2534,803,940,1743
Egypt,2013,rel,3544,687,886,1573
Egypt,2013,rel,4554,572,896,1468
Egypt,2013,rel,5564,320,516,836
Egypt,2013,rel,65,176,245,421
El Salvador,1996,sp,014,102,102,204
El Salvador,1996,sp,1524,76,76,152
El Salvador,1996,sp,2534,62,76,138
El Salvador,1996,sp,3544,43,77,120
El Salvador,1996,sp,4554,49,57,106
El Salvador,1996,sp,5564,38,54,92
El Salvador,1996,sp,65,61,92,153
El Salvador,1997,sp,014,17,13,30
El Salvador,1997,sp,1524,67,86,153
El Salvador,1997,sp,2534,72,110,182
El Salvador,1997,sp,3544,44,117,161
El Salvador,1997,sp,4554,33,71,104
El Salvador,1997,sp,5564,42,68,110
El Salvador,1997,sp,65,45,75,120
El Salvador,1998,sp,014,21,21,42
El Salvador,1998,sp,1524,81,95,176
El Salvador,1998,sp,2534,93,131,224
El Salvador,1998,sp,3544,53,99,152
El Salvador,1998,sp,4554,40,87,127
El Salvador,1998,sp,5564,43,65,108
El Salvador,1998,sp,65,71,84,155
El Salvador,1999,sp,014,20,18,38
El Salvador,1999,sp,1524,81,102,183
El Salvador,1999,sp,2534,73,128,201
El Salvador,1999,sp,3544,61,104,165
El Salvador,1999,sp,4554,47,88,135
El Salvador,1999,sp,5564,44,88,132
El Salvador,1999,sp,65,65,104,169
El Salvador,2000,sp,014,28,13,41
El Salvador,2000,sp,1524,81,99,180
El Salvador,2000,sp,2534,76,124,200
El Salvador,2000,sp,3544,63,114,177
El Salvador,2000,sp,4554,63,92,155
El Salvador,2000,sp,5564,39,62,101
El Salvador,2000,sp,65,47,107,154
El Salvador,2001,sp,014,22,20,42
El Salvador,2001,sp,1524,68,101,169
El Salvador,2001,sp,2534,86,144,230
El Salvador,2001,sp,3544,59,100,159
El Salvador,2001,sp,4554,59,78,137
El Salvador,2001,sp,5564,53,62,115
El Salvador,2001,sp,65,50,101,151
El Salvador,2002,sp,014,6,8,14
El Salvador,2002,sp,1524,80,85,165
El Salvador,2002,sp,2534,84,127,211
El Salvador,2002,sp,3544,61,101,162
El Salvador,2002,sp,4554,49,91,140
El Salvador,2002,sp,5564,51,59,110
El Salvador,2002,sp,65,85,93,178
El Salvador,2003,sp,014,7,7,14
El Salvador,2003,sp,1524,70,75,145
El Salvador,2003,sp,2534,71,105,176
El Salvador,2003,sp,3544,47,103,150
El Salvador,2003,sp,4554,48,81,129
El Salvador,2003,sp,5564,44,59,103
El Salvador,2003,sp,65,64,89,153
El Salvador,2004,sp,014,15,5,20
El Salvador,2004,sp,1524,64,92,156
El Salvador,2004,sp,2534,73,121,194
El Salvador,2004,sp,3544,55,90,145
El Salvador,2004,sp,4554,44,84,128
El Salvador,2004,sp,5564,48,77,125
El Salvador,2004,sp,65,67,91,158
El Salvador,2005,sp,014,6,5,11
El Salvador,2005,sp,1524,85,97,182
El Salvador,2005,sp,2534,82,140,222
El Salvador,2005,sp,3544,59,128,187
El Salvador,2005,sp,4554,50,104,154
El Salvador,2005,sp,5564,42,74,116
El Salvador,2005,sp,65,70,117,187
El Salvador,2006,ep,014,17,27,44
El Salvador,2006,ep,1524,18,15,33
El Salvador,2006,ep,2534,38,40,78
El Salvador,2006,ep,3544,18,26,44
El Salvador,2006,ep,4554,11,14,25
El Salvador,2006,ep,5564,5,10,15
El Salvador,2006,ep,65,11,33,44
El Salvador,2006,sp,014,7,6,13
El Salvador,2006,sp,1524,71,93,164
El Salvador,2006,sp,2534,80,124,204
El Salvador,2006,sp,3544,49,101,150
El Salvador,2006,sp,4554,50,76,126
El Salvador,2006,sp,5564,38,54,92
El Salvador,2006,sp,65,61,103,164
El Salvador,2007,ep,014,20,27,47
El Salvador,2007,ep,1524,18,22,40
El Salvador,2007,ep,2534,30,46,76
El Salvador,2007,ep,3544,26,26,52
El Salvador,2007,ep,4554,18,23,41
El Salvador,2007,ep,5564,9,13,22
El Salvador,2007,ep,65,9,19,28
El Salvador,2007,sn,014,129,147,276
El Salvador,2007,sn,1524,6,5,11
El Salvador,2007,sn,2534,5,9,14
El Salvador,2007,sn,3544,9,6,15
El Salvador,2007,sn,4554,4,8,12
El Salvador,2007,sn,5564,3,6,9
El Salvador,2007,sn,65,10,11,21
El Salvador,2007,sp,014,4,8,12
El Salvador,2007,sp,1524,63,79,142
El Salvador,2007,sp,2534,85,179,264
El Salvador,2007,sp,3544,50,110,160
El Salvador,2007,sp,4554,45,73,118
El Salvador,2007,sp,5564,33,62,95
El Salvador,2007,sp,65,56,95,151
El Salvador,2008,ep,014,27,17,44
El Salvador,2008,ep,1524,25,22,47
El Salvador,2008,ep,2534,29,49,78
El Salvador,2008,ep,3544,37,31,68
El Salvador,2008,ep,4554,13,15,28
El Salvador,2008,ep,5564,11,12,23
El Salvador,2008,ep,65,9,16,25
El Salvador,2008,sn,014,138,138,276
El Salvador,2008,sn,1524,4,9,13
El Salvador,2008,sn,2534,4,25,29
El Salvador,2008,sn,3544,2,6,8
El Salvador,2008,sn,4554,3,4,7
El Salvador,2008,sn,5564,4,4,8
El Salvador,2008,sn,65,8,13,21
El Salvador,2008,sp,014,8,8,16
El Salvador,2008,sp,1524,73,107,180
El Salvador,2008,sp,2534,71,168,239
El Salvador,2008,sp,3544,55,112,167
El Salvador,2008,sp,4554,42,67,109
El Salvador,2008,sp,5564,40,79,119
El Salvador,2008,sp,65,66,89,155
El Salvador,2009,ep,014,37,19,56
El Salvador,2009,ep,1524,20,30,50
El Salvador,2009,ep,2534,47,42,89
El Salvador,2009,ep,3544,26,32,58
El Salvador,2009,ep,4554,18,16,34
El Salvador,2009,ep,5564,10,11,21
El Salvador,2009,ep,65,5,16,21
El Salvador,2009,sn,014,119,138,257
El Salvador,2009,sn,1524,9,11,20
El Salvador,2009,sn,2534,5,19,24
El Salvador,2009,sn,3544,4,6,10
El Salvador,2009,sn,4554,4,9,13
El Salvador,2009,sn,5564,7,12,19
El Salvador,2009,sn,65,7,13,20
El Salvador,2009,sp,014,2,7,9
El Salvador,2009,sp,1524,59,99,158
El Salvador,2009,sp,2534,69,147,216
El Salvador,2009,sp,3544,50,111,161
El Salvador,2009,sp,4554,46,80,126
El Salvador,2009,sp,5564,27,64,91
El Salvador,2009,sp,65,58,111,169
El Salvador,2010,ep,014,27,27,54
El Salvador,2010,ep,1524,15,36,51
El Salvador,2010,ep,2534,40,38,78
El Salvador,2010,ep,3544,29,40,69
El Salvador,2010,ep,4554,19,21,40
El Salvador,2010,ep,5564,10,11,21
El Salvador,2010,ep,65,3,12,15
El Salvador,2010,sn,014,102,122,224
El Salvador,2010,sn,1524,6,18,24
El Salvador,2010,sn,2534,4,16,20
El Salvador,2010,sn,3544,8,16,24
El Salvador,2010,sn,4554,4,11,15
El Salvador,2010,sn,5564,4,11,15
El Salvador,2010,sn,65,2,14,16
El Salvador,2010,sp,014,6,5,11
El Salvador,2010,sp,1524,63,101,164
El Salvador,2010,sp,2534,65,170,235
El Salvador,2010,sp,3544,49,96,145
El Salvador,2010,sp,4554,58,77,135
El Salvador,2010,sp,5564,51,62,113
El Salvador,2010,sp,65,68,101,169
El Salvador,2011,ep,014,26,23,49
El Salvador,2011,ep,1524,37,47,84
El Salvador,2011,ep,2534,34,52,86
El Salvador,2011,ep,3544,26,34,60
El Salvador,2011,ep,4554,14,21,35
El Salvador,2011,ep,5564,15,13,28
El Salvador,2011,ep,65,12,30,42
El Salvador,2011,sn,014,99,111,210
El Salvador,2011,sn,1524,9,9,18
El Salvador,2011,sn,2534,12,27,39
El Salvador,2011,sn,3544,13,24,37
El Salvador,2011,sn,4554,5,13,18
El Salvador,2011,sn,5564,7,19,26
El Salvador,2011,sn,65,7,16,23
El Salvador,2011,sp,014,6,3,9
El Salvador,2011,sp,1524,61,114,175
El Salvador,2011,sp,2534,61,183,244
El Salvador,2011,sp,3544,44,106,150
El Salvador,2011,sp,4554,52,96,148
El Salvador,2011,sp,5564,69,77,146
El Salvador,2011,sp,65,92,115,207
El Salvador,2012,ep,014,24,24,48
El Salvador,2012,ep,1524,39,40,79
El Salvador,2012,ep,2534,29,67,96
El Salvador,2012,ep,3544,38,51,89
El Salvador,2012,ep,4554,18,33,51
El Salvador,2012,ep,5564,9,20,29
El Salvador,2012,ep,65,11,12,23
El Salvador,2012,sn,014,81,96,177
El Salvador,2012,sn,1524,5,18,23
El Salvador,2012,sn,2534,10,28,38
El Salvador,2012,sn,3544,12,19,31
El Salvador,2012,sn,4554,7,9,16
El Salvador,2012,sn,5564,4,7,11
El Salvador,2012,sn,65,7,10,17
El Salvador,2012,sp,014,5,5,10
El Salvador,2012,sp,1524,81,131,212
El Salvador,2012,sp,2534,73,194,267
El Salvador,2012,sp,3544,80,122,202
El Salvador,2012,sp,4554,90,100,190
El Salvador,2012,sp,5564,64,87,151
El Salvador,2012,sp,65,90,115,205
El Salvador,2013,rel,014,80,120,200
El Salvador,2013,rel,1524,90,208,298
El Salvador,2013,rel,2534,122,344,466
El Salvador,2013,rel,3544,123,197,320
El Salvador,2013,rel,4554,95,133,228
El Salvador,2013,rel,5564,115,96,211
El Salvador,2013,rel,65,164,180,344
Equatorial Guinea,1995,sp,014,2,8,10
Equatorial Guinea,1995,sp,1524,18,15,33
Equatorial Guinea,1995,sp,2534,28,45,73
Equatorial Guinea,1995,sp,3544,20,37,57
Equatorial Guinea,1995,sp,4554,4,15,19
Equatorial Guinea,1995,sp,5564,7,11,18
Equatorial Guinea,1995,sp,65,1,7,8
Equatorial Guinea,1997,sp,014,3,5,8
Equatorial Guinea,1997,sp,1524,23,32,55
Equatorial Guinea,1997,sp,2534,20,40,60
Equatorial Guinea,1997,sp,3544,14,36,50
Equatorial Guinea,1997,sp,4554,10,25,35
Equatorial Guinea,1997,sp,5564,3,8,11
Equatorial Guinea,1997,sp,65,3,4,7
Equatorial Guinea,1998,sp,014,3,6,9
Equatorial Guinea,1998,sp,1524,37,30,67
Equatorial Guinea,1998,sp,2534,31,46,77
Equatorial Guinea,1998,sp,3544,20,39,59
Equatorial Guinea,1998,sp,4554,7,29,36
Equatorial Guinea,1998,sp,5564,5,16,21
Equatorial Guinea,1998,sp,65,4,11,15
Equatorial Guinea,2004,sp,014,9,5,14
Equatorial Guinea,2004,sp,1524,45,50,95
Equatorial Guinea,2004,sp,2534,48,63,111
Equatorial Guinea,2004,sp,3544,30,54,84
Equatorial Guinea,2004,sp,4554,15,41,56
Equatorial Guinea,2004,sp,5564,10,17,27
Equatorial Guinea,2004,sp,65,4,15,19
Equatorial Guinea,2008,sp,014,10,8,18
Equatorial Guinea,2008,sp,1524,57,68,125
Equatorial Guinea,2008,sp,2534,66,95,161
Equatorial Guinea,2008,sp,3544,35,85,120
Equatorial Guinea,2008,sp,4554,23,44,67
Equatorial Guinea,2008,sp,5564,13,17,30
Equatorial Guinea,2008,sp,65,9,11,20
Equatorial Guinea,2009,sn,014,7,12,19
Equatorial Guinea,2009,sn,1524,3,13,16
Equatorial Guinea,2009,sn,2534,12,9,21
Equatorial Guinea,2009,sn,3544,6,16,22
Equatorial Guinea,2009,sn,4554,6,9,15
Equatorial Guinea,2009,sn,5564,2,9,11
Equatorial Guinea,2009,sn,65,2,3,5
Equatorial Guinea,2009,sp,014,2,10,12
Equatorial Guinea,2009,sp,1524,57,53,110
Equatorial Guinea,2009,sp,2534,66,79,145
Equatorial Guinea,2009,sp,3544,54,64,118
Equatorial Guinea,2009,sp,4554,19,52,71
Equatorial Guinea,2009,sp,5564,4,20,24
Equatorial Guinea,2009,sp,65,6,4,10
Equatorial Guinea,2010,ep,014,21,24,45
Equatorial Guinea,2010,ep,1524,10,10,20
Equatorial Guinea,2010,ep,2534,7,5,12
Equatorial Guinea,2010,ep,3544,11,3,14
Equatorial Guinea,2010,ep,4554,5,4,9
Equatorial Guinea,2010,ep,5564,4,1,5
Equatorial Guinea,2010,ep,65,4,0,4
Equatorial Guinea,2010,sn,014,13,5,18
Equatorial Guinea,2010,sn,1524,7,10,17
Equatorial Guinea,2010,sn,2534,9,12,21
Equatorial Guinea,2010,sn,3544,9,4,13
Equatorial Guinea,2010,sn,4554,4,9,13
Equatorial Guinea,2010,sn,5564,4,5,9
Equatorial Guinea,2010,sn,65,3,4,7
Equatorial Guinea,2010,sp,014,13,10,23
Equatorial Guinea,2010,sp,1524,80,71,151
Equatorial Guinea,2010,sp,2534,57,80,137
Equatorial Guinea,2010,sp,3544,45,59,104
Equatorial Guinea,2010,sp,4554,26,35,61
Equatorial Guinea,2010,sp,5564,9,16,25
Equatorial Guinea,2010,sp,65,6,10,16
Equatorial Guinea,2011,ep,014,22,24,46
Equatorial Guinea,2011,ep,1524,8,13,21
Equatorial Guinea,2011,ep,2534,14,12,26
Equatorial Guinea,2011,ep,3544,9,8,17
Equatorial Guinea,2011,ep,4554,7,7,14
Equatorial Guinea,2011,ep,5564,3,1,4
Equatorial Guinea,2011,ep,65,2,1,3
Equatorial Guinea,2011,sn,014,13,11,24
Equatorial Guinea,2011,sn,1524,12,9,21
Equatorial Guinea,2011,sn,2534,14,9,23
Equatorial Guinea,2011,sn,3544,18,8,26
Equatorial Guinea,2011,sn,4554,3,3,6
Equatorial Guinea,2011,sn,5564,4,8,12
Equatorial Guinea,2011,sn,65,2,2,4
Equatorial Guinea,2011,sp,014,15,11,26
Equatorial Guinea,2011,sp,1524,76,77,153
Equatorial Guinea,2011,sp,2534,81,90,171
Equatorial Guinea,2011,sp,3544,46,89,135
Equatorial Guinea,2011,sp,4554,21,59,80
Equatorial Guinea,2011,sp,5564,9,22,31
Equatorial Guinea,2011,sp,65,3,12,15
Eritrea,1997,sp,014,0,0,0
Eritrea,1997,sp,1524,3,2,5
Eritrea,1997,sp,2534,10,12,22
Eritrea,1997,sp,3544,20,21,41
Eritrea,1997,sp,4554,10,12,22
Eritrea,1997,sp,5564,4,6,10
Eritrea,1997,sp,65,5,4,9
Eritrea,1998,sp,014,3,4,7
Eritrea,1998,sp,1524,43,36,79
Eritrea,1998,sp,2534,29,30,59
Eritrea,1998,sp,3544,11,19,30
Eritrea,1998,sp,4554,9,15,24
Eritrea,1998,sp,5564,6,8,14
Eritrea,1998,sp,65,5,10,15
Eritrea,1999,sp,014,3,3,6
Eritrea,1999,sp,1524,65,55,120
Eritrea,1999,sp,2534,94,75,169
Eritrea,1999,sp,3544,34,49,83
Eritrea,1999,sp,4554,30,51,81
Eritrea,1999,sp,5564,17,30,47
Eritrea,1999,sp,65,7,17,24
Eritrea,2000,sp,014,10,9,19
Eritrea,2000,sp,1524,100,70,170
Eritrea,2000,sp,2534,87,75,162
Eritrea,2000,sp,3544,71,57,128
Eritrea,2000,sp,4554,21,32,53
Eritrea,2000,sp,5564,12,25,37
Eritrea,2000,sp,65,8,20,28
Eritrea,2001,sp,014,9,5,14
Eritrea,2001,sp,1524,96,79,175
Eritrea,2001,sp,2534,76,95,171
Eritrea,2001,sp,3544,66,77,143
Eritrea,2001,sp,4554,50,40,90
Eritrea,2001,sp,5564,31,42,73
Eritrea,2001,sp,65,15,21,36
Eritrea,2002,sp,014,15,16,31
Eritrea,2002,sp,1524,75,85,160
Eritrea,2002,sp,2534,85,88,173
Eritrea,2002,sp,3544,52,53,105
Eritrea,2002,sp,4554,39,41,80
Eritrea,2002,sp,5564,30,24,54
Eritrea,2002,sp,65,20,23,43
Eritrea,2003,sp,014,27,17,44
Eritrea,2003,sp,1524,120,90,210
Eritrea,2003,sp,2534,149,85,234
Eritrea,2003,sp,3544,100,55,155
Eritrea,2003,sp,4554,60,46,106
Eritrea,2003,sp,5564,36,44,80
Eritrea,2003,sp,65,22,36,58
Eritrea,2004,sp,014,13,14,27
Eritrea,2004,sp,1524,95,67,162
Eritrea,2004,sp,2534,118,61,179
Eritrea,2004,sp,3544,67,45,112
Eritrea,2004,sp,4554,43,45,88
Eritrea,2004,sp,5564,23,39,62
Eritrea,2004,sp,65,20,29,49
Eritrea,2005,sp,014,8,9,17
Eritrea,2005,sp,1524,67,68,135
Eritrea,2005,sp,2534,127,73,200
Eritrea,2005,sp,3544,72,50,122
Eritrea,2005,sp,4554,39,45,84
Eritrea,2005,sp,5564,21,51,72
Eritrea,2005,sp,65,18,39,57
Eritrea,2006,sp,014,17,6,23
Eritrea,2006,sp,1524,109,50,159
Eritrea,2006,sp,2534,123,55,178
Eritrea,2006,sp,3544,64,44,108
Eritrea,2006,sp,4554,45,52,97
Eritrea,2006,sp,5564,19,42,61
Eritrea,2006,sp,65,18,36,54
Eritrea,2007,sp,014,2,21,23
Eritrea,2007,sp,1524,70,56,126
Eritrea,2007,sp,2534,89,85,174
Eritrea,2007,sp,3544,56,73,129
Eritrea,2007,sp,4554,47,62,109
Eritrea,2007,sp,5564,21,53,74
Eritrea,2007,sp,65,15,44,59
Eritrea,2009,sp,014,4,6,10
Eritrea,2009,sp,1524,85,104,189
Eritrea,2009,sp,2534,88,111,199
Eritrea,2009,sp,3544,88,79,167
Eritrea,2009,sp,4554,39,46,85
Eritrea,2009,sp,5564,27,57,84
Eritrea,2009,sp,65,24,44,68
Eritrea,2010,sp,014,3,10,13
Eritrea,2010,sp,1524,88,93,181
Eritrea,2010,sp,2534,111,109,220
Eritrea,2010,sp,3544,79,81,160
Eritrea,2010,sp,4554,43,51,94
Eritrea,2010,sp,5564,31,37,68
Eritrea,2010,sp,65,36,60,96
Eritrea,2012,sp,014,4,2,6
Eritrea,2012,sp,1524,86,84,170
Eritrea,2012,sp,2534,98,105,203
Eritrea,2012,sp,3544,74,90,164
Eritrea,2012,sp,4554,45,62,107
Eritrea,2012,sp,5564,19,39,58
Eritrea,2012,sp,65,20,51,71
Estonia,1996,sp,014,0,1,1
Estonia,1996,sp,1524,10,7,17
Estonia,1996,sp,2534,14,34,48
Estonia,1996,sp,3544,16,53,69
Estonia,1996,sp,4554,5,39,44
Estonia,1996,sp,5564,2,28,30
Estonia,1996,sp,65,12,19,31
Estonia,1997,sp,014,0,0,0
Estonia,1997,sp,1524,8,4,12
Estonia,1997,sp,2534,16,23,39
Estonia,1997,sp,3544,17,59,76
Estonia,1997,sp,4554,14,53,67
Estonia,1997,sp,5564,6,29,35
Estonia,1997,sp,65,12,17,29
Estonia,1998,sp,014,0,0,0
Estonia,1998,sp,1524,7,15,22
Estonia,1998,sp,2534,7,49,56
Estonia,1998,sp,3544,15,60,75
Estonia,1998,sp,4554,9,64,73
Estonia,1998,sp,5564,7,34,41
Estonia,1998,sp,65,10,22,32
Estonia,1999,sp,014,0,0,0
Estonia,1999,sp,1524,8,14,22
Estonia,1999,sp,2534,9,35,44
Estonia,1999,sp,3544,20,72,92
Estonia,1999,sp,4554,16,55,71
Estonia,1999,sp,5564,2,19,21
Estonia,1999,sp,65,7,17,24
Estonia,2000,sp,014,0,0,0
Estonia,2000,sp,1524,9,6,15
Estonia,2000,sp,2534,11,31,42
Estonia,2000,sp,3544,14,53,67
Estonia,2000,sp,4554,11,56,67
Estonia,2000,sp,5564,4,35,39
Estonia,2000,sp,65,10,15,25
Estonia,2001,sp,014,0,0,0
Estonia,2001,sp,1524,6,10,16
Estonia,2001,sp,2534,11,25,36
Estonia,2001,sp,3544,17,43,60
Estonia,2001,sp,4554,11,37,48
Estonia,2001,sp,5564,6,24,30
Estonia,2001,sp,65,8,14,22
Estonia,2002,sp,014,0,0,0
Estonia,2002,sp,1524,7,9,16
Estonia,2002,sp,2534,11,20,31
Estonia,2002,sp,3544,16,47,63
Estonia,2002,sp,4554,9,45,54
Estonia,2002,sp,5564,5,19,24
Estonia,2002,sp,65,8,7,15
Estonia,2003,sp,014,0,0,0
Estonia,2003,sp,1524,7,7,14
Estonia,2003,sp,2534,4,28,32
Estonia,2003,sp,3544,11,38,49
Estonia,2003,sp,4554,12,35,47
Estonia,2003,sp,5564,2,24,26
Estonia,2003,sp,65,15,18,33
Estonia,2004,sp,014,0,0,0
Estonia,2004,sp,1524,4,6,10
Estonia,2004,sp,2534,12,24,36
Estonia,2004,sp,3544,10,42,52
Estonia,2004,sp,4554,13,54,67
Estonia,2004,sp,5564,6,14,20
Estonia,2004,sp,65,7,11,18
Estonia,2005,sp,014,0,0,0
Estonia,2005,sp,1524,6,9,15
Estonia,2005,sp,2534,11,25,36
Estonia,2005,sp,3544,8,19,27
Estonia,2005,sp,4554,11,40,51
Estonia,2005,sp,5564,6,12,18
Estonia,2005,sp,65,8,7,15
Estonia,2006,ep,014,1,1,2
Estonia,2006,ep,1524,1,3,4
Estonia,2006,ep,2534,1,0,1
Estonia,2006,ep,3544,2,1,3
Estonia,2006,ep,4554,1,2,3
Estonia,2006,ep,5564,3,6,9
Estonia,2006,ep,65,3,6,9
Estonia,2006,sn,014,2,3,5
Estonia,2006,sn,1524,9,7,16
Estonia,2006,sn,2534,13,26,39
Estonia,2006,sn,3544,13,33,46
Estonia,2006,sn,4554,14,35,49
Estonia,2006,sn,5564,7,15,22
Estonia,2006,sn,65,9,9,18
Estonia,2006,sp,014,0,0,0
Estonia,2006,sp,1524,3,4,7
Estonia,2006,sp,2534,9,19,28
Estonia,2006,sp,3544,10,24,34
Estonia,2006,sp,4554,9,40,49
Estonia,2006,sp,5564,4,12,16
Estonia,2006,sp,65,6,7,13
Estonia,2007,ep,014,1,0,1
Estonia,2007,ep,1524,3,0,3
Estonia,2007,ep,2534,1,5,6
Estonia,2007,ep,3544,1,4,5
Estonia,2007,ep,4554,2,3,5
Estonia,2007,ep,5564,3,1,4
Estonia,2007,ep,65,4,3,7
Estonia,2007,sn,014,0,0,0
Estonia,2007,sn,1524,9,6,15
Estonia,2007,sn,2534,16,26,42
Estonia,2007,sn,3544,12,32,44
Estonia,2007,sn,4554,12,37,49
Estonia,2007,sn,5564,12,21,33
Estonia,2007,sn,65,3,12,15
Estonia,2007,sp,014,0,0,0
Estonia,2007,sp,1524,2,6,8
Estonia,2007,sp,2534,5,26,31
Estonia,2007,sp,3544,5,32,37
Estonia,2007,sp,4554,8,37,45
Estonia,2007,sp,5564,7,21,28
Estonia,2007,sp,65,6,12,18
Estonia,2008,ep,014,0,1,1
Estonia,2008,ep,1524,1,0,1
Estonia,2008,ep,2534,0,3,3
Estonia,2008,ep,3544,0,3,3
Estonia,2008,ep,4554,1,4,5
Estonia,2008,ep,5564,2,2,4
Estonia,2008,ep,65,6,7,13
Estonia,2008,sn,014,0,1,1
Estonia,2008,sn,1524,7,9,16
Estonia,2008,sn,2534,11,16,27
Estonia,2008,sn,3544,9,33,42
Estonia,2008,sn,4554,4,34,38
Estonia,2008,sn,5564,8,26,34
Estonia,2008,sn,65,10,12,22
Estonia,2008,sp,014,0,0,0
Estonia,2008,sp,1524,2,3,5
Estonia,2008,sp,2534,7,14,21
Estonia,2008,sp,3544,6,26,32
Estonia,2008,sp,4554,8,34,42
Estonia,2008,sp,5564,4,12,16
Estonia,2008,sp,65,15,13,28
Estonia,2009,ep,014,1,0,1
Estonia,2009,ep,1524,0,1,1
Estonia,2009,ep,2534,0,3,3
Estonia,2009,ep,3544,1,2,3
Estonia,2009,ep,4554,1,3,4
Estonia,2009,ep,5564,3,2,5
Estonia,2009,ep,65,3,1,4
Estonia,2009,sn,014,0,2,2
Estonia,2009,sn,1524,4,8,12
Estonia,2009,sn,2534,15,17,32
Estonia,2009,sn,3544,9,34,43
Estonia,2009,sn,4554,12,23,35
Estonia,2009,sn,5564,8,16,24
Estonia,2009,sn,65,9,13,22
Estonia,2009,sp,014,0,0,0
Estonia,2009,sp,1524,6,4,10
Estonia,2009,sp,2534,8,10,18
Estonia,2009,sp,3544,8,12,20
Estonia,2009,sp,4554,7,34,41
Estonia,2009,sp,5564,5,22,27
Estonia,2009,sp,65,7,12,19
Estonia,2010,ep,014,1,2,3
Estonia,2010,ep,1524,0,1,1
Estonia,2010,ep,2534,1,4,5
Estonia,2010,ep,3544,0,2,2
Estonia,2010,ep,4554,1,2,3
Estonia,2010,ep,5564,0,0,0
Estonia,2010,ep,65,2,1,3
Estonia,2010,sn,014,2,1,3
Estonia,2010,sn,1524,5,5,10
Estonia,2010,sn,2534,5,18,23
Estonia,2010,sn,3544,8,13,21
Estonia,2010,sn,4554,6,26,32
Estonia,2010,sn,5564,6,17,23
Estonia,2010,sn,65,10,13,23
Estonia,2010,sp,014,0,0,0
Estonia,2010,sp,1524,3,3,6
Estonia,2010,sp,2534,6,7,13
Estonia,2010,sp,3544,3,21,24
Estonia,2010,sp,4554,3,25,28
Estonia,2010,sp,5564,6,12,18
Estonia,2010,sp,65,3,8,11
Estonia,2011,ep,014,0,0,0
Estonia,2011,ep,1524,0,1,1
Estonia,2011,ep,2534,1,1,2
Estonia,2011,ep,3544,2,2,4
Estonia,2011,ep,4554,0,0,0
Estonia,2011,ep,5564,1,5,6
Estonia,2011,ep,65,4,1,5
Estonia,2011,sn,014,0,1,1
Estonia,2011,sn,1524,3,5,8
Estonia,2011,sn,2534,8,21,29
Estonia,2011,sn,3544,9,15,24
Estonia,2011,sn,4554,10,20,30
Estonia,2011,sn,5564,2,16,18
Estonia,2011,sn,65,6,6,12
Estonia,2011,sp,014,0,0,0
Estonia,2011,sp,1524,4,4,8
Estonia,2011,sp,2534,8,22,30
Estonia,2011,sp,3544,12,16,28
Estonia,2011,sp,4554,3,15,18
Estonia,2011,sp,5564,3,18,21
Estonia,2011,sp,65,6,13,19
Estonia,2012,ep,014,0,1,1
Estonia,2012,ep,1524,1,1,2
Estonia,2012,ep,2534,0,0,0
Estonia,2012,ep,3544,0,1,1
Estonia,2012,ep,4554,2,0,2
Estonia,2012,ep,5564,1,1,2
Estonia,2012,ep,65,3,8,11
Estonia,2012,sn,014,1,0,1
Estonia,2012,sn,1524,2,5,7
Estonia,2012,sn,2534,7,12,19
Estonia,2012,sn,3544,9,18,27
Estonia,2012,sn,4554,4,18,22
Estonia,2012,sn,5564,3,9,12
Estonia,2012,sn,65,11,11,22
Estonia,2012,sp,014,0,0,0
Estonia,2012,sp,1524,5,6,11
Estonia,2012,sp,2534,7,15,22
Estonia,2012,sp,3544,2,13,15
Estonia,2012,sp,4554,4,21,25
Estonia,2012,sp,5564,1,17,18
Estonia,2012,sp,65,5,9,14
Estonia,2013,rel,014,0,1,1
Estonia,2013,rel,1524,3,5,8
Estonia,2013,rel,2534,20,25,45
Estonia,2013,rel,3544,14,42,56
Estonia,2013,rel,4554,10,48,58
Estonia,2013,rel,5564,8,39,47
Estonia,2013,rel,65,31,17,48
Ethiopia,1995,sp,014,283,247,530
Ethiopia,1995,sp,1524,908,1221,2129
Ethiopia,1995,sp,2534,781,1017,1798
Ethiopia,1995,sp,3544,382,541,923
Ethiopia,1995,sp,4554,152,276,428
Ethiopia,1995,sp,5564,64,142,206
Ethiopia,1995,sp,65,15,51,66
Ethiopia,1996,sp,014,369,302,671
Ethiopia,1996,sp,1524,1564,1739,3303
Ethiopia,1996,sp,2534,1147,1609,2756
Ethiopia,1996,sp,3544,576,854,1430
Ethiopia,1996,sp,4554,246,427,673
Ethiopia,1996,sp,5564,88,201,289
Ethiopia,1996,sp,65,32,71,103
Ethiopia,1997,sp,014,687,579,1266
Ethiopia,1997,sp,1524,2469,2810,5279
Ethiopia,1997,sp,2534,2173,2520,4693
Ethiopia,1997,sp,3544,1039,1365,2404
Ethiopia,1997,sp,4554,481,736,1217
Ethiopia,1997,sp,5564,192,401,593
Ethiopia,1997,sp,65,108,193,301
Ethiopia,1998,sp,014,832,715,1547
Ethiopia,1998,sp,1524,3016,2643,5659
Ethiopia,1998,sp,2534,2434,3187,5621
Ethiopia,1998,sp,3544,1220,1610,2830
Ethiopia,1998,sp,4554,519,839,1358
Ethiopia,1998,sp,5564,194,429,623
Ethiopia,1998,sp,65,55,171,226
Ethiopia,1999,sp,014,798,692,1490
Ethiopia,1999,sp,1524,3310,3916,7226
Ethiopia,1999,sp,2534,2949,3673,6622
Ethiopia,1999,sp,3544,1539,1925,3464
Ethiopia,1999,sp,4554,713,1045,1758
Ethiopia,1999,sp,5564,225,471,696
Ethiopia,1999,sp,65,69,230,299
Ethiopia,2000,sp,014,1037,915,1952
Ethiopia,2000,sp,1524,4699,5095,9794
Ethiopia,2000,sp,2534,4424,5187,9611
Ethiopia,2000,sp,3544,2105,3082,5187
Ethiopia,2000,sp,4554,976,1495,2471
Ethiopia,2000,sp,5564,366,610,976
Ethiopia,2000,sp,65,122,397,519
Ethiopia,2001,sp,014,1107,913,2020
Ethiopia,2001,sp,1524,5109,5730,10839
Ethiopia,2001,sp,2534,4830,5594,10424
Ethiopia,2001,sp,3544,2372,3233,5605
Ethiopia,2001,sp,4554,1014,1581,2595
Ethiopia,2001,sp,5564,338,742,1080
Ethiopia,2001,sp,65,111,354,465
Ethiopia,2002,sp,014,1614,1251,2865
Ethiopia,2002,sp,1524,5607,6764,12371
Ethiopia,2002,sp,2534,5692,5669,11361
Ethiopia,2002,sp,3544,2685,3128,5813
Ethiopia,2002,sp,4554,935,1544,2479
Ethiopia,2002,sp,5564,323,821,1144
Ethiopia,2002,sp,65,136,372,508
Ethiopia,2003,sp,014,1387,1110,2497
Ethiopia,2003,sp,1524,5936,6923,12859
Ethiopia,2003,sp,2534,5908,6648,12556
Ethiopia,2003,sp,3544,2780,3737,6517
Ethiopia,2003,sp,4554,1239,2022,3261
Ethiopia,2003,sp,5564,412,976,1388
Ethiopia,2003,sp,65,137,483,620
Ethiopia,2004,sp,014,1367,1160,2527
Ethiopia,2004,sp,1524,6422,7167,13589
Ethiopia,2004,sp,2534,6091,7002,13093
Ethiopia,2004,sp,3544,2984,4060,7044
Ethiopia,2004,sp,4554,1284,1988,3272
Ethiopia,2004,sp,5564,414,911,1325
Ethiopia,2004,sp,65,124,456,580
Ethiopia,2005,sp,014,1326,1109,2435
Ethiopia,2005,sp,1524,5885,6726,12611
Ethiopia,2005,sp,2534,5663,6181,11844
Ethiopia,2005,sp,3544,2730,3454,6184
Ethiopia,2005,sp,4554,1296,1985,3281
Ethiopia,2005,sp,5564,513,1027,1540
Ethiopia,2005,sp,65,155,475,630
Ethiopia,2006,sp,014,1178,978,2156
Ethiopia,2006,sp,1524,5238,6137,11375
Ethiopia,2006,sp,2534,5326,5950,11276
Ethiopia,2006,sp,3544,2704,3567,6271
Ethiopia,2006,sp,4554,1324,2016,3340
Ethiopia,2006,sp,5564,510,1066,1576
Ethiopia,2006,sp,65,159,521,680
Ethiopia,2007,sp,014,1229,1055,2284
Ethiopia,2007,sp,1524,5426,6522,11948
Ethiopia,2007,sp,2534,5507,6114,11621
Ethiopia,2007,sp,3544,2850,3545,6395
Ethiopia,2007,sp,4554,1429,2038,3467
Ethiopia,2007,sp,5564,502,1051,1553
Ethiopia,2007,sp,65,213,559,772
Ethiopia,2008,sp,014,1167,978,2145
Ethiopia,2008,sp,1524,5490,6512,12002
Ethiopia,2008,sp,2534,5893,6794,12687
Ethiopia,2008,sp,3544,3251,4067,7318
Ethiopia,2008,sp,4554,1553,2290,3843
Ethiopia,2008,sp,5564,616,1176,1792
Ethiopia,2008,sp,65,322,685,1007
Ethiopia,2009,sp,014,1593,1421,3014
Ethiopia,2009,sp,1524,5556,7215,12771
Ethiopia,2009,sp,2534,6075,7193,13268
Ethiopia,2009,sp,3544,3499,4267,7766
Ethiopia,2009,sp,4554,1798,2452,4250
Ethiopia,2009,sp,5564,824,1331,2155
Ethiopia,2009,sp,65,378,794,1172
Ethiopia,2010,sp,014,1608,1582,3190
Ethiopia,2010,sp,1524,5708,7400,13108
Ethiopia,2010,sp,2534,6480,7785,14265
Ethiopia,2010,sp,3544,3439,4451,7890
Ethiopia,2010,sp,4554,1950,2746,4696
Ethiopia,2010,sp,5564,855,1473,2328
Ethiopia,2010,sp,65,335,822,1157
Ethiopia,2011,sp,014,1983,1847,3830
Ethiopia,2011,sp,1524,6570,7835,14405
Ethiopia,2011,sp,2534,7917,9246,17163
Ethiopia,2011,sp,3544,3069,3881,6950
Ethiopia,2011,sp,4554,1564,2771,4335
Ethiopia,2011,sp,5564,719,1218,1937
Ethiopia,2011,sp,65,303,771,1074
Ethiopia,2012,ep,014,4054,3798,7852
Ethiopia,2012,sn,014,3990,3692,7682
Ethiopia,2013,rel,014,10363,10954,21317
Fiji,1994,sp,014,0,2,2
Fiji,1994,sp,1524,4,8,12
Fiji,1994,sp,2534,6,6,12
Fiji,1994,sp,3544,3,2,5
Fiji,1994,sp,4554,6,3,9
Fiji,1994,sp,5564,7,11,18
Fiji,1994,sp,65,1,3,4
Fiji,1995,sp,014,1,0,1
Fiji,1995,sp,1524,10,8,18
Fiji,1995,sp,2534,9,10,19
Fiji,1995,sp,3544,2,9,11
Fiji,1995,sp,4554,3,4,7
Fiji,1995,sp,5564,4,2,6
Fiji,1995,sp,65,3,3,6
Fiji,1996,sp,014,3,1,4
Fiji,1996,sp,1524,6,8,14
Fiji,1996,sp,2534,8,8,16
Fiji,1996,sp,3544,2,9,11
Fiji,1996,sp,4554,6,9,15
Fiji,1996,sp,5564,2,3,5
Fiji,1996,sp,65,2,2,4
Fiji,1997,sp,014,0,1,1
Fiji,1997,sp,1524,6,4,10
Fiji,1997,sp,2534,9,8,17
Fiji,1997,sp,3544,1,6,7
Fiji,1997,sp,4554,5,8,13
Fiji,1997,sp,5564,7,6,13
Fiji,1997,sp,65,3,2,5
Fiji,1998,sp,014,2,0,2
Fiji,1998,sp,1524,10,7,17
Fiji,1998,sp,2534,10,11,21
Fiji,1998,sp,3544,4,7,11
Fiji,1998,sp,4554,4,8,12
Fiji,1998,sp,5564,3,4,7
Fiji,1998,sp,65,2,2,4
Fiji,1999,sp,014,0,1,1
Fiji,1999,sp,1524,5,13,18
Fiji,1999,sp,2534,7,7,14
Fiji,1999,sp,3544,5,5,10
Fiji,1999,sp,4554,2,8,10
Fiji,1999,sp,5564,5,3,8
Fiji,1999,sp,65,1,3,4
Fiji,2000,sp,014,0,0,0
Fiji,2000,sp,1524,7,8,15
Fiji,2000,sp,2534,5,6,11
Fiji,2000,sp,3544,7,13,20
Fiji,2000,sp,4554,1,5,6
Fiji,2000,sp,5564,4,4,8
Fiji,2000,sp,65,0,2,2
Fiji,2001,sp,014,0,0,0
Fiji,2001,sp,1524,7,6,13
Fiji,2001,sp,2534,5,8,13
Fiji,2001,sp,3544,7,11,18
Fiji,2001,sp,4554,1,7,8
Fiji,2001,sp,5564,2,4,6
Fiji,2001,sp,65,2,2,4
Fiji,2002,sp,014,2,1,3
Fiji,2002,sp,1524,8,13,21
Fiji,2002,sp,2534,4,11,15
Fiji,2002,sp,3544,6,7,13
Fiji,2002,sp,4554,3,4,7
Fiji,2002,sp,5564,4,7,11
Fiji,2002,sp,65,2,2,4
Fiji,2003,sp,014,1,2,3
Fiji,2003,sp,1524,4,8,12
Fiji,2003,sp,2534,7,9,16
Fiji,2003,sp,3544,4,6,10
Fiji,2003,sp,4554,4,11,15
Fiji,2003,sp,5564,8,7,15
Fiji,2003,sp,65,1,6,7
Fiji,2004,sp,014,0,0,0
Fiji,2004,sp,1524,8,8,16
Fiji,2004,sp,2534,6,6,12
Fiji,2004,sp,3544,3,8,11
Fiji,2004,sp,4554,5,6,11
Fiji,2004,sp,5564,2,7,9
Fiji,2004,sp,65,1,2,3
Fiji,2005,sp,014,7,7,14
Fiji,2005,sp,1524,7,9,16
Fiji,2005,sp,2534,9,18,27
Fiji,2005,sp,3544,6,18,24
Fiji,2005,sp,4554,4,14,18
Fiji,2005,sp,5564,6,16,22
Fiji,2005,sp,65,5,6,11
Fiji,2006,ep,014,2,1,3
Fiji,2006,ep,1524,1,2,3
Fiji,2006,ep,2534,0,1,1
Fiji,2006,ep,3544,0,2,2
Fiji,2006,ep,4554,3,1,4
Fiji,2006,ep,5564,2,3,5
Fiji,2006,ep,65,0,0,0
Fiji,2006,sn,014,0,0,0
Fiji,2006,sn,1524,3,3,6
Fiji,2006,sn,2534,1,4,5
Fiji,2006,sn,3544,0,1,1
Fiji,2006,sn,4554,1,2,3
Fiji,2006,sn,5564,2,3,5
Fiji,2006,sn,65,0,2,2
Fiji,2006,sp,014,1,0,1
Fiji,2006,sp,1524,12,8,20
Fiji,2006,sp,2534,5,11,16
Fiji,2006,sp,3544,6,4,10
Fiji,2006,sp,4554,4,7,11
Fiji,2006,sp,5564,6,5,11
Fiji,2006,sp,65,0,4,4
Fiji,2007,ep,014,0,1,1
Fiji,2007,ep,1524,4,5,9
Fiji,2007,ep,2534,3,2,5
Fiji,2007,ep,3544,3,4,7
Fiji,2007,ep,4554,2,6,8
Fiji,2007,ep,5564,0,0,0
Fiji,2007,ep,65,0,1,1
Fiji,2007,sn,014,0,1,1
Fiji,2007,sn,1524,4,2,6
Fiji,2007,sn,2534,3,2,5
Fiji,2007,sn,3544,0,4,4
Fiji,2007,sn,4554,1,5,6
Fiji,2007,sn,5564,1,2,3
Fiji,2007,sn,65,1,3,4
Fiji,2007,sp,014,7,1,8
Fiji,2007,sp,1524,11,7,18
Fiji,2007,sp,2534,4,7,11
Fiji,2007,sp,3544,6,7,13
Fiji,2007,sp,4554,5,4,9
Fiji,2007,sp,5564,1,1,2
Fiji,2007,sp,65,2,4,6
Fiji,2008,ep,2534,2,3,5
Fiji,2008,ep,3544,2,2,4
Fiji,2008,ep,4554,2,4,6
Fiji,2008,ep,5564,1,0,1
Fiji,2008,ep,65,0,3,3
Fiji,2008,sn,014,1,NA,NA
Fiji,2008,sn,1524,0,1,1
Fiji,2008,sn,2534,2,1,3
Fiji,2008,sn,3544,1,2,3
Fiji,2008,sn,4554,1,3,4
Fiji,2008,sn,5564,1,0,1
Fiji,2008,sn,65,0,4,4
Fiji,2008,sp,1524,13,10,23
Fiji,2008,sp,2534,6,10,16
Fiji,2008,sp,3544,5,4,9
Fiji,2008,sp,4554,6,9,15
Fiji,2008,sp,5564,3,4,7
Fiji,2008,sp,65,4,4,8
Fiji,2009,ep,014,0,2,2
Fiji,2009,ep,1524,2,4,6
Fiji,2009,ep,2534,3,5,8
Fiji,2009,ep,3544,2,5,7
Fiji,2009,ep,4554,5,5,10
Fiji,2009,ep,5564,0,5,5
Fiji,2009,ep,65,0,0,0
Fiji,2009,sp,014,1,0,1
Fiji,2009,sp,1524,11,15,26
Fiji,2009,sp,2534,7,14,21
Fiji,2009,sp,3544,4,7,11
Fiji,2009,sp,4554,4,8,12
Fiji,2009,sp,5564,3,6,9
Fiji,2009,sp,65,1,2,3
Fiji,2010,ep,014,6,5,11
Fiji,2010,ep,1524,2,2,4
Fiji,2010,ep,2534,5,6,11
Fiji,2010,ep,3544,2,5,7
Fiji,2010,ep,4554,3,2,5
Fiji,2010,ep,5564,3,1,4
Fiji,2010,ep,65,3,0,3
Fiji,2010,sn,014,3,5,8
Fiji,2010,sn,1524,1,5,6
Fiji,2010,sn,2534,1,4,5
Fiji,2010,sn,3544,1,0,1
Fiji,2010,sn,4554,0,7,7
Fiji,2010,sn,5564,5,8,13
Fiji,2010,sn,65,2,3,5
Fiji,2010,sp,014,1,1,2
Fiji,2010,sp,1524,11,7,18
Fiji,2010,sp,2534,12,15,27
Fiji,2010,sp,3544,5,11,16
Fiji,2010,sp,4554,1,6,7
Fiji,2010,sp,5564,8,2,10
Fiji,2010,sp,65,5,4,9
Fiji,2011,ep,014,6,2,8
Fiji,2011,ep,1524,3,6,9
Fiji,2011,ep,2534,3,4,7
Fiji,2011,ep,3544,2,2,4
Fiji,2011,ep,4554,2,2,4
Fiji,2011,ep,5564,0,5,5
Fiji,2011,ep,65,2,2,4
Fiji,2011,sn,014,2,3,5
Fiji,2011,sn,1524,8,2,10
Fiji,2011,sn,2534,5,9,14
Fiji,2011,sn,3544,3,5,8
Fiji,2011,sn,4554,3,5,8
Fiji,2011,sn,5564,2,6,8
Fiji,2011,sn,65,1,4,5
Fiji,2011,sp,014,1,0,1
Fiji,2011,sp,1524,13,12,25
Fiji,2011,sp,2534,17,16,33
Fiji,2011,sp,3544,7,8,15
Fiji,2011,sp,4554,5,9,14
Fiji,2011,sp,5564,2,9,11
Fiji,2011,sp,65,3,4,7
Fiji,2012,ep,014,2,6,8
Fiji,2012,ep,1524,3,4,7
Fiji,2012,ep,2534,2,2,4
Fiji,2012,ep,3544,1,3,4
Fiji,2012,ep,4554,2,5,7
Fiji,2012,ep,5564,2,2,4
Fiji,2012,ep,65,4,2,6
Fiji,2012,sn,014,6,3,9
Fiji,2012,sn,1524,2,6,8
Fiji,2012,sn,2534,4,4,8
Fiji,2012,sn,3544,2,3,5
Fiji,2012,sn,4554,2,6,8
Fiji,2012,sn,5564,3,6,9
Fiji,2012,sn,65,4,3,7
Fiji,2012,sp,014,2,2,4
Fiji,2012,sp,1524,11,14,25
Fiji,2012,sp,2534,10,12,22
Fiji,2012,sp,3544,7,9,16
Fiji,2012,sp,4554,6,12,18
Fiji,2012,sp,5564,7,5,12
Fiji,2012,sp,65,7,7,14
Fiji,2013,rel,014,14,10,24
Fiji,2013,rel,1524,24,19,43
Fiji,2013,rel,2534,27,31,58
Fiji,2013,rel,3544,18,25,43
Fiji,2013,rel,4554,6,25,31
Fiji,2013,rel,5564,9,17,26
Fiji,2013,rel,65,10,19,29
Finland,1995,sp,014,1,1,2
Finland,1995,sp,1524,1,1,2
Finland,1995,sp,2534,6,10,16
Finland,1995,sp,3544,7,25,32
Finland,1995,sp,4554,4,28,32
Finland,1995,sp,5564,10,24,34
Finland,1995,sp,65,65,61,126
Finland,1996,sp,014,0,0,0
Finland,1996,sp,1524,4,2,6
Finland,1996,sp,2534,5,5,10
Finland,1996,sp,3544,3,24,27
Finland,1996,sp,4554,7,26,33
Finland,1996,sp,5564,6,23,29
Finland,1996,sp,65,58,77,135
Finland,1997,sp,014,0,0,0
Finland,1997,sp,1524,2,1,3
Finland,1997,sp,2534,6,5,11
Finland,1997,sp,3544,2,22,24
Finland,1997,sp,4554,5,24,29
Finland,1997,sp,5564,5,26,31
Finland,1997,sp,65,35,53,88
Finland,1998,sp,014,0,0,0
Finland,1998,sp,1524,3,4,7
Finland,1998,sp,2534,4,4,8
Finland,1998,sp,3544,9,9,18
Finland,1998,sp,4554,4,15,19
Finland,1998,sp,5564,12,21,33
Finland,1998,sp,65,40,63,103
Finland,1999,sp,014,0,0,0
Finland,1999,sp,1524,2,NA,NA
Finland,1999,sp,2534,6,4,10
Finland,1999,sp,3544,NA,13,NA
Finland,1999,sp,4554,11,26,37
Finland,1999,sp,5564,5,20,25
Finland,1999,sp,65,39,53,92
Finland,2000,sp,014,0,0,0
Finland,2000,sp,1524,1,3,4
Finland,2000,sp,2534,5,8,13
Finland,2000,sp,3544,3,22,25
Finland,2000,sp,4554,4,19,23
Finland,2000,sp,5564,6,28,34
Finland,2000,sp,65,49,53,102
Finland,2001,sp,014,0,0,0
Finland,2001,sp,1524,3,1,4
Finland,2001,sp,2534,4,9,13
Finland,2001,sp,3544,5,13,18
Finland,2001,sp,4554,8,17,25
Finland,2001,sp,5564,10,13,23
Finland,2001,sp,65,22,43,65
Finland,2002,sp,014,0,0,0
Finland,2002,sp,1524,4,0,4
Finland,2002,sp,2534,3,5,8
Finland,2002,sp,3544,0,8,8
Finland,2002,sp,4554,3,17,20
Finland,2002,sp,5564,6,20,26
Finland,2002,sp,65,26,36,62
Finland,2003,sp,014,0,0,0
Finland,2003,sp,1524,2,2,4
Finland,2003,sp,2534,10,3,13
Finland,2003,sp,3544,3,8,11
Finland,2003,sp,4554,6,19,25
Finland,2003,sp,5564,5,17,22
Finland,2003,sp,65,31,29,60
Finland,2004,sp,014,0,0,0
Finland,2004,sp,1524,1,1,2
Finland,2004,sp,2534,0,5,5
Finland,2004,sp,3544,3,7,10
Finland,2004,sp,4554,4,17,21
Finland,2004,sp,5564,3,13,16
Finland,2004,sp,65,15,33,48
Finland,2005,sp,014,0,1,1
Finland,2005,sp,1524,3,5,8
Finland,2005,sp,2534,4,4,8
Finland,2005,sp,3544,1,3,4
Finland,2005,sp,4554,0,14,14
Finland,2005,sp,5564,6,11,17
Finland,2005,sp,65,20,25,45
Finland,2006,ep,014,0,1,1
Finland,2006,ep,1524,4,2,6
Finland,2006,ep,2534,6,3,9
Finland,2006,ep,3544,3,8,11
Finland,2006,ep,4554,0,3,3
Finland,2006,ep,5564,8,4,12
Finland,2006,ep,65,30,14,44
Finland,2006,sn,014,0,0,0
Finland,2006,sn,1524,0,4,4
Finland,2006,sn,2534,6,2,8
Finland,2006,sn,3544,1,6,7
Finland,2006,sn,4554,2,8,10
Finland,2006,sn,5564,3,18,21
Finland,2006,sn,65,18,42,60
Finland,2006,sp,014,0,0,0
Finland,2006,sp,1524,2,5,7
Finland,2006,sp,2534,4,6,10
Finland,2006,sp,3544,3,5,8
Finland,2006,sp,4554,4,9,13
Finland,2006,sp,5564,1,6,7
Finland,2006,sp,65,19,20,39
Finland,2007,ep,014,4,0,4
Finland,2007,ep,1524,12,4,16
Finland,2007,ep,2534,10,12,22
Finland,2007,ep,3544,4,10,14
Finland,2007,ep,4554,10,12,22
Finland,2007,ep,5564,16,16,32
Finland,2007,ep,65,50,44,94
Finland,2007,sn,014,0,2,2
Finland,2007,sn,1524,12,8,20
Finland,2007,sn,2534,11,24,35
Finland,2007,sn,3544,4,17,21
Finland,2007,sn,4554,15,28,43
Finland,2007,sn,5564,12,40,52
Finland,2007,sn,65,65,86,151
Finland,2007,sp,014,0,0,0
Finland,2007,sp,1524,6,4,10
Finland,2007,sp,2534,4,5,9
Finland,2007,sp,3544,2,5,7
Finland,2007,sp,4554,5,10,15
Finland,2007,sp,5564,0,7,7
Finland,2007,sp,65,13,24,37
Finland,2008,ep,014,0,0,0
Finland,2008,ep,1524,2,6,8
Finland,2008,ep,2534,7,4,11
Finland,2008,ep,3544,5,1,6
Finland,2008,ep,4554,7,5,12
Finland,2008,ep,5564,8,9,17
Finland,2008,ep,65,36,33,69
Finland,2008,sn,014,1,3,4
Finland,2008,sn,1524,2,4,6
Finland,2008,sn,2534,2,3,5
Finland,2008,sn,3544,2,6,8
Finland,2008,sn,4554,3,11,14
Finland,2008,sn,5564,8,11,19
Finland,2008,sn,65,19,29,48
Finland,2008,sp,014,0,0,0
Finland,2008,sp,1524,4,3,7
Finland,2008,sp,2534,3,5,8
Finland,2008,sp,3544,2,8,10
Finland,2008,sp,4554,4,13,17
Finland,2008,sp,5564,2,11,13
Finland,2008,sp,65,14,35,49
Finland,2009,ep,014,0,1,1
Finland,2009,ep,1524,4,12,16
Finland,2009,ep,2534,4,6,10
Finland,2009,ep,3544,5,4,9
Finland,2009,ep,4554,4,4,8
Finland,2009,ep,5564,6,9,15
Finland,2009,ep,65,37,24,61
Finland,2009,sn,014,3,3,6
Finland,2009,sn,1524,6,12,18
Finland,2009,sn,2534,11,11,22
Finland,2009,sn,3544,7,12,19
Finland,2009,sn,4554,4,16,20
Finland,2009,sn,5564,7,24,31
Finland,2009,sn,65,27,47,74
Finland,2009,sp,014,0,0,0
Finland,2009,sp,1524,7,9,16
Finland,2009,sp,2534,7,3,10
Finland,2009,sp,3544,3,3,6
Finland,2009,sp,4554,4,11,15
Finland,2009,sp,5564,1,11,12
Finland,2009,sp,65,14,17,31
Finland,2010,ep,014,2,0,2
Finland,2010,ep,1524,5,3,8
Finland,2010,ep,2534,7,10,17
Finland,2010,ep,3544,4,4,8
Finland,2010,ep,4554,4,2,6
Finland,2010,ep,5564,6,5,11
Finland,2010,ep,65,25,13,38
Finland,2010,sn,014,1,3,4
Finland,2010,sn,1524,5,9,14
Finland,2010,sn,2534,5,6,11
Finland,2010,sn,3544,1,7,8
Finland,2010,sn,4554,6,9,15
Finland,2010,sn,5564,3,13,16
Finland,2010,sn,65,26,40,66
Finland,2010,sp,014,0,0,0
Finland,2010,sp,1524,3,10,13
Finland,2010,sp,2534,3,6,9
Finland,2010,sp,3544,4,7,11
Finland,2010,sp,4554,1,9,10
Finland,2010,sp,5564,2,8,10
Finland,2010,sp,65,12,15,27
Finland,2011,ep,014,1,1,2
Finland,2011,ep,1524,7,4,11
Finland,2011,ep,2534,5,4,9
Finland,2011,ep,3544,1,4,5
Finland,2011,ep,4554,1,3,4
Finland,2011,ep,5564,8,5,13
Finland,2011,ep,65,31,15,46
Finland,2011,sn,014,4,4,8
Finland,2011,sn,1524,4,5,9
Finland,2011,sn,2534,7,12,19
Finland,2011,sn,3544,3,3,6
Finland,2011,sn,4554,6,4,10
Finland,2011,sn,5564,3,17,20
Finland,2011,sn,65,30,38,68
Finland,2011,sp,014,1,0,1
Finland,2011,sp,1524,2,1,3
Finland,2011,sp,2534,3,4,7
Finland,2011,sp,3544,5,4,9
Finland,2011,sp,4554,3,7,10
Finland,2011,sp,5564,1,10,11
Finland,2011,sp,65,13,27,40
Finland,2012,ep,014,1,0,1
Finland,2012,ep,1524,4,4,8
Finland,2012,ep,2534,3,5,8
Finland,2012,ep,3544,5,3,8
Finland,2012,ep,4554,2,1,3
Finland,2012,ep,5564,4,3,7
Finland,2012,ep,65,22,13,35
Finland,2012,sn,014,1,2,3
Finland,2012,sn,1524,4,4,8
Finland,2012,sn,2534,7,5,12
Finland,2012,sn,3544,7,6,13
Finland,2012,sn,4554,3,10,13
Finland,2012,sn,5564,3,10,13
Finland,2012,sn,65,14,28,42
Finland,2012,sp,014,1,0,1
Finland,2012,sp,1524,4,2,6
Finland,2012,sp,2534,0,9,9
Finland,2012,sp,3544,4,7,11
Finland,2012,sp,4554,2,5,7
Finland,2012,sp,5564,3,9,12
Finland,2012,sp,65,11,21,32
Finland,2013,rel,014,1,1,2
Finland,2013,rel,1524,10,22,32
Finland,2013,rel,2534,18,17,35
Finland,2013,rel,3544,6,13,19
Finland,2013,rel,4554,7,12,19
Finland,2013,rel,5564,13,20,33
Finland,2013,rel,65,47,79,126
France,1995,sp,014,36,30,66
France,1995,sp,1524,138,156,294
France,1995,sp,2534,226,431,657
France,1995,sp,3544,176,502,678
France,1995,sp,4554,90,414,504
France,1995,sp,5564,92,297,389
France,1995,sp,65,365,496,861
France,1996,sp,014,22,36,58
France,1996,sp,1524,124,124,248
France,1996,sp,2534,195,335,530
France,1996,sp,3544,131,413,544
France,1996,sp,4554,79,351,430
France,1996,sp,5564,82,248,330
France,1996,sp,65,376,475,851
France,1997,sp,014,17,24,41
France,1997,sp,1524,117,113,230
France,1997,sp,2534,166,288,454
France,1997,sp,3544,115,362,477
France,1997,sp,4554,80,271,351
France,1997,sp,5564,57,194,251
France,1997,sp,65,274,343,617
France,1999,sp,014,25,13,38
France,1999,sp,1524,110,147,257
France,1999,sp,2534,145,267,412
France,1999,sp,3544,120,310,430
France,1999,sp,4554,80,276,356
France,1999,sp,5564,60,157,217
France,1999,sp,65,284,318,602
France,2000,sp,014,18,10,28
France,2000,sp,1524,108,136,244
France,2000,sp,2534,127,248,375
France,2000,sp,3544,89,247,336
France,2000,sp,4554,46,211,257
France,2000,sp,5564,43,125,168
France,2000,sp,65,155,244,399
France,2001,sp,014,17,10,27
France,2001,sp,1524,131,124,255
France,2001,sp,2534,132,230,362
France,2001,sp,3544,102,260,362
France,2001,sp,4554,63,205,268
France,2001,sp,5564,40,119,159
France,2001,sp,65,183,211,394
France,2002,sp,014,13,24,37
France,2002,sp,1524,106,138,244
France,2002,sp,2534,127,265,392
France,2002,sp,3544,90,223,313
France,2002,sp,4554,56,219,275
France,2002,sp,5564,33,119,152
France,2002,sp,65,161,180,341
France,2003,sp,014,16,18,34
France,2003,sp,1524,114,129,243
France,2003,sp,2534,129,249,378
France,2003,sp,3544,79,223,302
France,2003,sp,4554,44,190,234
France,2003,sp,5564,32,127,159
France,2003,sp,65,159,210,369
France,2004,sp,014,11,13,24
France,2004,sp,1524,96,109,205
France,2004,sp,2534,116,222,338
France,2004,sp,3544,82,220,302
France,2004,sp,4554,53,200,253
France,2004,sp,5564,34,138,172
France,2004,sp,65,171,216,387
France,2005,sp,014,16,12,28
France,2005,sp,1524,104,127,231
France,2005,sp,2534,134,212,346
France,2005,sp,3544,82,222,304
France,2005,sp,4554,56,196,252
France,2005,sp,5564,38,134,172
France,2005,sp,65,180,205,385
France,2006,ep,014,46,39,85
France,2006,ep,1524,62,92,154
France,2006,ep,2534,97,140,237
France,2006,ep,3544,102,103,205
France,2006,ep,4554,88,84,172
France,2006,ep,5564,69,64,133
France,2006,ep,65,152,133,285
France,2006,sn,014,52,59,111
France,2006,sn,1524,90,92,182
France,2006,sn,2534,128,171,299
France,2006,sn,3544,92,151,243
France,2006,sn,4554,81,131,212
France,2006,sn,5564,57,108,165
France,2006,sn,65,205,198,403
France,2006,sp,014,15,17,32
France,2006,sp,1524,112,137,249
France,2006,sp,2534,158,214,372
France,2006,sp,3544,91,238,329
France,2006,sp,4554,67,209,276
France,2006,sp,5564,44,153,197
France,2006,sp,65,170,278,448
France,2007,ep,014,90,92,182
France,2007,ep,1524,122,142,264
France,2007,ep,2534,224,332,556
France,2007,ep,3544,178,216,394
France,2007,ep,4554,166,164,330
France,2007,ep,5564,138,138,276
France,2007,ep,65,294,264,558
France,2007,sn,014,67,66,133
France,2007,sn,1524,97,123,220
France,2007,sn,2534,150,207,357
France,2007,sn,3544,100,186,286
France,2007,sn,4554,76,159,235
France,2007,sn,5564,61,127,188
France,2007,sn,65,206,225,431
France,2007,sp,014,20,17,37
France,2007,sp,1524,127,120,247
France,2007,sp,2534,167,225,392
France,2007,sp,3544,91,196,287
France,2007,sp,4554,56,219,275
France,2007,sp,5564,61,156,217
France,2007,sp,65,188,273,461
France,2008,ep,014,34,34,68
France,2008,ep,1524,48,50,98
France,2008,ep,2534,75,116,191
France,2008,ep,3544,73,84,157
France,2008,ep,4554,67,63,130
France,2008,ep,5564,40,47,87
France,2008,ep,65,133,89,222
France,2008,sn,014,39,28,67
France,2008,sn,1524,64,58,122
France,2008,sn,2534,89,123,212
France,2008,sn,3544,65,101,166
France,2008,sn,4554,50,93,143
France,2008,sn,5564,54,88,142
France,2008,sn,65,113,143,256
France,2008,sp,014,8,10,18
France,2008,sp,1524,57,73,130
France,2008,sp,2534,96,136,232
France,2008,sp,3544,71,161,232
France,2008,sp,4554,50,134,184
France,2008,sp,5564,38,110,148
France,2008,sp,65,101,175,276
France,2009,ep,014,21,27,48
France,2009,ep,1524,40,49,89
France,2009,ep,2534,66,84,150
France,2009,ep,3544,67,83,150
France,2009,ep,4554,42,51,93
France,2009,ep,5564,46,45,91
France,2009,ep,65,96,98,194
France,2009,sn,014,35,39,74
France,2009,sn,1524,61,66,127
France,2009,sn,2534,76,115,191
France,2009,sn,3544,64,100,164
France,2009,sn,4554,46,72,118
France,2009,sn,5564,27,67,94
France,2009,sn,65,104,155,259
France,2009,sp,014,9,11,20
France,2009,sp,1524,63,74,137
France,2009,sp,2534,87,109,196
France,2009,sp,3544,69,114,183
France,2009,sp,4554,35,97,132
France,2009,sp,5564,23,81,104
France,2009,sp,65,108,125,233
France,2010,ep,014,21,36,57
France,2010,ep,1524,29,47,76
France,2010,ep,2534,50,92,142
France,2010,ep,3544,51,81,132
France,2010,ep,4554,44,46,90
France,2010,ep,5564,43,45,88
France,2010,ep,65,98,81,179
France,2010,sn,014,35,35,70
France,2010,sn,1524,58,64,122
France,2010,sn,2534,84,111,195
France,2010,sn,3544,49,95,144
France,2010,sn,4554,52,73,125
France,2010,sn,5564,39,73,112
France,2010,sn,65,109,132,241
France,2010,sp,014,10,10,20
France,2010,sp,1524,47,60,107
France,2010,sp,2534,76,139,215
France,2010,sp,3544,49,114,163
France,2010,sp,4554,45,99,144
France,2010,sp,5564,25,76,101
France,2010,sp,65,97,110,207
France,2011,ep,014,29,31,60
France,2011,ep,1524,26,32,58
France,2011,ep,2534,64,87,151
France,2011,ep,3544,43,74,117
France,2011,ep,4554,41,44,85
France,2011,ep,5564,28,39,67
France,2011,ep,65,73,96,169
France,2011,sn,014,38,32,70
France,2011,sn,1524,50,67,117
France,2011,sn,2534,93,125,218
France,2011,sn,3544,66,88,154
France,2011,sn,4554,60,76,136
France,2011,sn,5564,44,65,109
France,2011,sn,65,87,144,231
France,2011,sp,014,7,12,19
France,2011,sp,1524,58,89,147
France,2011,sp,2534,69,113,182
France,2011,sp,3544,50,116,166
France,2011,sp,4554,36,95,131
France,2011,sp,5564,24,73,97
France,2011,sp,65,66,102,168
France,2012,ep,014,22,30,52
France,2012,ep,1524,36,39,75
France,2012,ep,2534,76,96,172
France,2012,ep,3544,42,58,100
France,2012,ep,4554,46,43,89
France,2012,ep,5564,38,44,82
France,2012,ep,65,73,72,145
France,2012,sn,014,46,39,85
France,2012,sn,1524,59,68,127
France,2012,sn,2534,78,131,209
France,2012,sn,3544,56,82,138
France,2012,sn,4554,49,91,140
France,2012,sn,5564,39,72,111
France,2012,sn,65,96,121,217
France,2012,sp,014,14,8,22
France,2012,sp,1524,43,63,106
France,2012,sp,2534,81,114,195
France,2012,sp,3544,74,98,172
France,2012,sp,4554,23,90,113
France,2012,sp,5564,24,56,80
France,2012,sp,65,80,90,170
France,2013,rel,014,116,139,255
France,2013,rel,1524,254,340,594
France,2013,rel,2534,374,642,1016
France,2013,rel,3544,262,469,731
France,2013,rel,4554,199,389,588
France,2013,rel,5564,188,314,502
France,2013,rel,65,407,587,994
French Polynesia,1996,sp,014,0,1,1
French Polynesia,1996,sp,1524,5,4,9
French Polynesia,1996,sp,2534,4,7,11
French Polynesia,1996,sp,3544,2,5,7
French Polynesia,1996,sp,4554,0,2,2
French Polynesia,1996,sp,5564,2,1,3
French Polynesia,1996,sp,65,1,3,4
French Polynesia,1997,sp,014,1,1,2
French Polynesia,1997,sp,1524,5,4,9
French Polynesia,1997,sp,2534,3,2,5
French Polynesia,1997,sp,3544,2,4,6
French Polynesia,1997,sp,4554,3,3,6
French Polynesia,1997,sp,5564,2,5,7
French Polynesia,1997,sp,65,3,3,6
French Polynesia,1998,sp,014,3,0,3
French Polynesia,1998,sp,1524,1,4,5
French Polynesia,1998,sp,2534,2,4,6
French Polynesia,1998,sp,3544,5,3,8
French Polynesia,1998,sp,4554,1,1,2
French Polynesia,1998,sp,5564,0,5,5
French Polynesia,1998,sp,65,1,4,5
French Polynesia,1999,sp,014,4,0,4
French Polynesia,1999,sp,1524,2,2,4
French Polynesia,1999,sp,2534,2,2,4
French Polynesia,1999,sp,3544,4,2,6
French Polynesia,1999,sp,4554,2,1,3
French Polynesia,1999,sp,5564,3,2,5
French Polynesia,1999,sp,65,3,4,7
French Polynesia,2000,sp,014,1,1,2
French Polynesia,2000,sp,1524,4,3,7
French Polynesia,2000,sp,2534,1,3,4
French Polynesia,2000,sp,3544,0,4,4
French Polynesia,2000,sp,4554,1,4,5
French Polynesia,2000,sp,5564,0,4,4
French Polynesia,2000,sp,65,0,3,3
French Polynesia,2001,sp,014,3,2,5
French Polynesia,2001,sp,1524,7,5,12
French Polynesia,2001,sp,2534,1,1,2
French Polynesia,2001,sp,3544,1,2,3
French Polynesia,2001,sp,4554,3,4,7
French Polynesia,2001,sp,5564,4,4,8
French Polynesia,2001,sp,65,3,5,8
French Polynesia,2002,sp,014,0,0,0
French Polynesia,2002,sp,1524,4,4,8
French Polynesia,2002,sp,2534,2,2,4
French Polynesia,2002,sp,3544,1,1,2
French Polynesia,2002,sp,4554,2,3,5
French Polynesia,2002,sp,5564,2,3,5
French Polynesia,2002,sp,65,2,1,3
French Polynesia,2003,sp,1524,3,2,5
French Polynesia,2003,sp,2534,1,2,3
French Polynesia,2003,sp,3544,1,1,2
French Polynesia,2003,sp,4554,1,2,3
French Polynesia,2003,sp,5564,0,4,4
French Polynesia,2003,sp,65,1,3,4
French Polynesia,2004,sp,014,NA,1,NA
French Polynesia,2004,sp,1524,4,1,5
French Polynesia,2004,sp,2534,6,2,8
French Polynesia,2004,sp,3544,1,3,4
French Polynesia,2004,sp,4554,4,0,4
French Polynesia,2004,sp,5564,2,1,3
French Polynesia,2004,sp,65,1,4,5
French Polynesia,2005,sp,014,0,0,0
French Polynesia,2005,sp,1524,2,2,4
French Polynesia,2005,sp,2534,3,2,5
French Polynesia,2005,sp,3544,0,2,2
French Polynesia,2005,sp,4554,1,0,1
French Polynesia,2005,sp,5564,1,4,5
French Polynesia,2005,sp,65,3,2,5
French Polynesia,2006,ep,014,0,1,1
French Polynesia,2006,ep,1524,0,2,2
French Polynesia,2006,ep,2534,2,1,3
French Polynesia,2006,ep,3544,1,1,2
French Polynesia,2006,ep,4554,0,2,2
French Polynesia,2006,ep,5564,1,1,2
French Polynesia,2006,ep,65,1,2,3
French Polynesia,2006,sn,014,0,0,0
French Polynesia,2006,sn,1524,0,2,2
French Polynesia,2006,sn,2534,1,2,3
French Polynesia,2006,sn,3544,4,1,5
French Polynesia,2006,sn,4554,2,1,3
French Polynesia,2006,sn,5564,3,5,8
French Polynesia,2006,sn,65,3,4,7
French Polynesia,2006,sp,014,1,1,2
French Polynesia,2006,sp,1524,6,1,7
French Polynesia,2006,sp,2534,1,1,2
French Polynesia,2006,sp,3544,0,3,3
French Polynesia,2006,sp,4554,0,3,3
French Polynesia,2006,sp,5564,2,1,3
French Polynesia,2006,sp,65,3,1,4
French Polynesia,2007,ep,1524,1,2,3
French Polynesia,2007,ep,2534,1,1,2
French Polynesia,2007,ep,3544,1,NA,NA
French Polynesia,2007,ep,4554,2,NA,NA
French Polynesia,2007,ep,5564,1,NA,NA
French Polynesia,2007,ep,65,NA,2,NA
French Polynesia,2007,sn,014,1,2,3
French Polynesia,2007,sn,1524,1,1,2
French Polynesia,2007,sn,2534,4,2,6
French Polynesia,2007,sn,3544,2,2,4
French Polynesia,2007,sn,4554,4,0,4
French Polynesia,2007,sn,5564,2,5,7
French Polynesia,2007,sn,65,2,4,6
French Polynesia,2007,sp,014,1,NA,NA
French Polynesia,2007,sp,1524,1,NA,NA
French Polynesia,2007,sp,2534,1,2,3
French Polynesia,2007,sp,3544,5,2,7
French Polynesia,2007,sp,4554,0,2,2
French Polynesia,2007,sp,5564,3,NA,NA
French Polynesia,2007,sp,65,2,NA,NA
French Polynesia,2008,ep,014,0,0,0
French Polynesia,2008,ep,1524,1,0,1
French Polynesia,2008,ep,2534,0,2,2
French Polynesia,2008,ep,3544,0,2,2
French Polynesia,2008,ep,4554,0,0,0
French Polynesia,2008,ep,5564,0,1,1
French Polynesia,2008,ep,65,2,2,4
French Polynesia,2008,sn,014,2,0,2
French Polynesia,2008,sn,1524,2,2,4
French Polynesia,2008,sn,2534,3,1,4
French Polynesia,2008,sn,3544,0,0,0
French Polynesia,2008,sn,4554,1,1,2
French Polynesia,2008,sn,5564,1,1,2
French Polynesia,2008,sn,65,2,2,4
French Polynesia,2008,sp,014,0,1,1
French Polynesia,2008,sp,1524,1,3,4
French Polynesia,2008,sp,2534,1,1,2
French Polynesia,2008,sp,3544,1,1,2
French Polynesia,2008,sp,4554,0,1,1
French Polynesia,2008,sp,5564,1,2,3
French Polynesia,2008,sp,65,2,2,4
French Polynesia,2009,ep,014,0,1,1
French Polynesia,2009,ep,1524,0,2,2
French Polynesia,2009,ep,2534,2,1,3
French Polynesia,2009,ep,3544,1,3,4
French Polynesia,2009,ep,4554,2,0,2
French Polynesia,2009,ep,5564,1,0,1
French Polynesia,2009,ep,65,0,1,1
French Polynesia,2009,sn,014,1,2,3
French Polynesia,2009,sn,1524,2,3,5
French Polynesia,2009,sn,2534,0,1,1
French Polynesia,2009,sn,3544,1,2,3
French Polynesia,2009,sn,4554,0,2,2
French Polynesia,2009,sn,5564,1,1,2
French Polynesia,2009,sn,65,0,1,1
French Polynesia,2009,sp,014,0,1,1
French Polynesia,2009,sp,1524,2,1,3
French Polynesia,2009,sp,2534,0,4,4
French Polynesia,2009,sp,3544,0,1,1
French Polynesia,2009,sp,4554,1,3,4
French Polynesia,2009,sp,5564,3,0,3
French Polynesia,2009,sp,65,1,0,1
French Polynesia,2010,ep,014,0,0,0
French Polynesia,2010,ep,1524,0,0,0
French Polynesia,2010,ep,2534,1,0,1
French Polynesia,2010,ep,3544,1,2,3
French Polynesia,2010,ep,4554,2,0,2
French Polynesia,2010,ep,5564,0,0,0
French Polynesia,2010,ep,65,0,0,0
French Polynesia,2010,sn,014,2,3,5
French Polynesia,2010,sn,1524,1,2,3
French Polynesia,2010,sn,2534,2,0,2
French Polynesia,2010,sn,3544,0,1,1
French Polynesia,2010,sn,4554,1,1,2
French Polynesia,2010,sn,5564,2,2,4
French Polynesia,2010,sn,65,1,0,1
French Polynesia,2010,sp,014,0,0,0
French Polynesia,2010,sp,1524,1,3,4
French Polynesia,2010,sp,2534,1,1,2
French Polynesia,2010,sp,3544,0,0,0
French Polynesia,2010,sp,4554,3,1,4
French Polynesia,2010,sp,5564,0,1,1
French Polynesia,2010,sp,65,1,1,2
French Polynesia,2011,ep,014,0,2,2
French Polynesia,2011,ep,1524,2,0,2
French Polynesia,2011,ep,2534,0,0,0
French Polynesia,2011,ep,3544,1,1,2
French Polynesia,2011,ep,4554,2,0,2
French Polynesia,2011,ep,5564,0,1,1
French Polynesia,2011,ep,65,3,1,4
French Polynesia,2011,sn,014,0,2,2
French Polynesia,2011,sn,1524,5,2,7
French Polynesia,2011,sn,2534,1,0,1
French Polynesia,2011,sn,3544,1,2,3
French Polynesia,2011,sn,4554,2,3,5
French Polynesia,2011,sn,5564,1,1,2
French Polynesia,2011,sn,65,1,6,7
French Polynesia,2011,sp,014,0,0,0
French Polynesia,2011,sp,1524,3,3,6
French Polynesia,2011,sp,2534,3,1,4
French Polynesia,2011,sp,3544,0,1,1
French Polynesia,2011,sp,4554,1,5,6
French Polynesia,2011,sp,5564,0,1,1
French Polynesia,2011,sp,65,1,3,4
French Polynesia,2012,ep,014,1,0,1
French Polynesia,2012,ep,1524,1,1,2
French Polynesia,2012,ep,2534,1,1,2
French Polynesia,2012,ep,3544,2,1,3
French Polynesia,2012,ep,4554,0,0,0
French Polynesia,2012,ep,5564,0,0,0
French Polynesia,2012,ep,65,0,0,0
French Polynesia,2012,sn,014,0,0,0
French Polynesia,2012,sn,1524,1,1,2
French Polynesia,2012,sn,2534,1,1,2
French Polynesia,2012,sn,3544,0,1,1
French Polynesia,2012,sn,4554,1,1,2
French Polynesia,2012,sn,5564,1,0,1
French Polynesia,2012,sn,65,1,1,2
French Polynesia,2012,sp,014,0,0,0
French Polynesia,2012,sp,1524,2,1,3
French Polynesia,2012,sp,2534,3,2,5
French Polynesia,2012,sp,3544,0,2,2
French Polynesia,2012,sp,4554,3,3,6
French Polynesia,2012,sp,5564,4,3,7
French Polynesia,2012,sp,65,0,3,3
French Polynesia,2013,rel,014,2,1,3
French Polynesia,2013,rel,1524,8,3,11
French Polynesia,2013,rel,2534,3,4,7
French Polynesia,2013,rel,3544,3,6,9
French Polynesia,2013,rel,4554,1,1,2
French Polynesia,2013,rel,5564,5,3,8
French Polynesia,2013,rel,65,9,3,12
Gabon,1995,sp,014,9,3,12
Gabon,1995,sp,1524,47,45,92
Gabon,1995,sp,2534,54,74,128
Gabon,1995,sp,3544,28,80,108
Gabon,1995,sp,4554,25,54,79
Gabon,1995,sp,5564,19,30,49
Gabon,1995,sp,65,3,15,18
Gabon,1996,sp,014,5,0,5
Gabon,1996,sp,1524,33,28,61
Gabon,1996,sp,2534,26,44,70
Gabon,1996,sp,3544,19,40,59
Gabon,1996,sp,4554,11,22,33
Gabon,1996,sp,5564,4,11,15
Gabon,1996,sp,65,4,2,6
Gabon,1998,sp,014,15,14,29
Gabon,1998,sp,1524,97,93,190
Gabon,1998,sp,2534,85,159,244
Gabon,1998,sp,3544,67,129,196
Gabon,1998,sp,4554,32,76,108
Gabon,1998,sp,5564,30,43,73
Gabon,1998,sp,65,14,32,46
Gabon,1999,sp,014,15,14,29
Gabon,1999,sp,1524,97,98,195
Gabon,1999,sp,2534,110,158,268
Gabon,1999,sp,3544,67,129,196
Gabon,1999,sp,4554,32,76,108
Gabon,1999,sp,5564,30,43,73
Gabon,1999,sp,65,14,32,46
Gabon,2001,sp,014,27,21,48
Gabon,2001,sp,1524,127,137,264
Gabon,2001,sp,2534,139,205,344
Gabon,2001,sp,3544,73,147,220
Gabon,2001,sp,4554,34,73,107
Gabon,2001,sp,5564,21,60,81
Gabon,2001,sp,65,21,46,67
Gabon,2002,sp,014,18,10,28
Gabon,2002,sp,1524,125,137,262
Gabon,2002,sp,2534,140,173,313
Gabon,2002,sp,3544,71,148,219
Gabon,2002,sp,4554,32,63,95
Gabon,2002,sp,5564,21,27,48
Gabon,2002,sp,65,28,40,68
Gabon,2003,sp,014,16,14,30
Gabon,2003,sp,1524,138,165,303
Gabon,2003,sp,2534,144,225,369
Gabon,2003,sp,3544,107,149,256
Gabon,2003,sp,4554,51,103,154
Gabon,2003,sp,5564,33,48,81
Gabon,2003,sp,65,18,22,40
Gabon,2004,sp,014,15,17,32
Gabon,2004,sp,1524,173,197,370
Gabon,2004,sp,2534,141,289,430
Gabon,2004,sp,3544,80,143,223
Gabon,2004,sp,4554,37,83,120
Gabon,2004,sp,5564,24,47,71
Gabon,2004,sp,65,27,50,77
Gabon,2005,sp,014,19,13,32
Gabon,2005,sp,1524,128,123,251
Gabon,2005,sp,2534,123,199,322
Gabon,2005,sp,3544,88,140,228
Gabon,2005,sp,4554,29,70,99
Gabon,2005,sp,5564,29,38,67
Gabon,2005,sp,65,18,25,43
Gabon,2006,sp,014,19,20,39
Gabon,2006,sp,1524,160,157,317
Gabon,2006,sp,2534,123,207,330
Gabon,2006,sp,3544,79,148,227
Gabon,2006,sp,4554,39,89,128
Gabon,2006,sp,5564,20,40,60
Gabon,2006,sp,65,21,23,44
Gabon,2008,sp,014,29,14,43
Gabon,2008,sp,1524,209,209,418
Gabon,2008,sp,2534,158,297,455
Gabon,2008,sp,3544,93,196,289
Gabon,2008,sp,4554,59,104,163
Gabon,2008,sp,5564,32,45,77
Gabon,2008,sp,65,17,39,56
Gabon,2009,sp,014,14,45,59
Gabon,2009,sp,1524,103,145,248
Gabon,2009,sp,2534,118,163,281
Gabon,2009,sp,3544,121,158,279
Gabon,2009,sp,4554,105,138,243
Gabon,2009,sp,5564,33,42,75
Gabon,2009,sp,65,29,29,58
Gabon,2010,ep,014,32,70,102
Gabon,2010,ep,1524,26,37,63
Gabon,2010,ep,2534,22,28,50
Gabon,2010,ep,3544,36,32,68
Gabon,2010,ep,4554,39,28,67
Gabon,2010,ep,5564,13,17,30
Gabon,2010,ep,65,12,20,32
Gabon,2010,sn,014,95,183,278
Gabon,2010,sn,1524,82,88,170
Gabon,2010,sn,2534,71,87,158
Gabon,2010,sn,3544,83,101,184
Gabon,2010,sn,4554,65,88,153
Gabon,2010,sn,5564,70,76,146
Gabon,2010,sn,65,62,75,137
Gabon,2010,sp,014,13,15,28
Gabon,2010,sp,1524,110,145,255
Gabon,2010,sp,2534,164,223,387
Gabon,2010,sp,3544,122,208,330
Gabon,2010,sp,4554,100,130,230
Gabon,2010,sp,5564,86,89,175
Gabon,2010,sp,65,64,91,155
Gabon,2011,sp,014,25,34,59
Gabon,2011,sp,1524,177,240,417
Gabon,2011,sp,2534,188,269,457
Gabon,2011,sp,3544,125,229,354
Gabon,2011,sp,4554,74,144,218
Gabon,2011,sp,5564,44,86,130
Gabon,2011,sp,65,39,66,105
Gabon,2012,ep,014,12,25,37
Gabon,2012,ep,1524,36,41,77
Gabon,2012,ep,2534,47,58,105
Gabon,2012,ep,3544,35,53,88
Gabon,2012,ep,4554,22,40,62
Gabon,2012,ep,5564,7,13,20
Gabon,2012,ep,65,11,14,25
Gabon,2012,sn,014,123,110,233
Gabon,2012,sn,1524,176,230,406
Gabon,2012,sn,2534,225,278,503
Gabon,2012,sn,3544,216,274,490
Gabon,2012,sn,4554,152,185,337
Gabon,2012,sn,5564,86,122,208
Gabon,2012,sn,65,91,85,176
Gabon,2012,sp,014,29,42,71
Gabon,2012,sp,1524,185,236,421
Gabon,2012,sp,2534,165,286,451
Gabon,2012,sp,3544,109,228,337
Gabon,2012,sp,4554,78,166,244
Gabon,2012,sp,5564,45,101,146
Gabon,2012,sp,65,34,41,75
Gabon,2013,rel,014,29,43,72
Gabon,2013,rel,1524,190,242,432
Gabon,2013,rel,2534,213,295,508
Gabon,2013,rel,3544,158,267,425
Gabon,2013,rel,4554,106,155,261
Gabon,2013,rel,5564,53,89,142
Gabon,2013,rel,65,35,55,90
Gambia,1995,sp,014,4,3,7
Gambia,1995,sp,1524,39,68,107
Gambia,1995,sp,2534,61,181,242
Gambia,1995,sp,3544,44,88,132
Gambia,1995,sp,4554,25,72,97
Gambia,1995,sp,5564,12,29,41
Gambia,1995,sp,65,8,24,32
Gambia,1996,sp,014,20,29,49
Gambia,1996,sp,1524,50,42,92
Gambia,1996,sp,2534,64,148,212
Gambia,1996,sp,3544,46,100,146
Gambia,1996,sp,4554,46,66,112
Gambia,1996,sp,5564,30,46,76
Gambia,1996,sp,65,22,48,70
Gambia,1997,sp,014,5,2,7
Gambia,1997,sp,1524,55,83,138
Gambia,1997,sp,2534,76,219,295
Gambia,1997,sp,3544,45,126,171
Gambia,1997,sp,4554,20,61,81
Gambia,1997,sp,5564,20,63,83
Gambia,1997,sp,65,8,37,45
Gambia,1998,sp,014,7,6,13
Gambia,1998,sp,1524,60,99,159
Gambia,1998,sp,2534,95,193,288
Gambia,1998,sp,3544,53,158,211
Gambia,1998,sp,4554,25,79,104
Gambia,1998,sp,5564,18,61,79
Gambia,1998,sp,65,14,35,49
Gambia,1999,sp,014,10,6,16
Gambia,1999,sp,1524,58,99,157
Gambia,1999,sp,2534,82,180,262
Gambia,1999,sp,3544,54,124,178
Gambia,1999,sp,4554,30,86,116
Gambia,1999,sp,5564,16,65,81
Gambia,1999,sp,65,13,39,52
Gambia,2002,sp,014,5,2,7
Gambia,2002,sp,1524,71,135,206
Gambia,2002,sp,2534,112,240,352
Gambia,2002,sp,3544,42,160,202
Gambia,2002,sp,4554,40,100,140
Gambia,2002,sp,5564,21,60,81
Gambia,2002,sp,65,10,37,47
Gambia,2003,sp,014,8,3,11
Gambia,2003,sp,1524,81,162,243
Gambia,2003,sp,2534,85,236,321
Gambia,2003,sp,3544,62,149,211
Gambia,2003,sp,4554,39,83,122
Gambia,2003,sp,5564,27,52,79
Gambia,2003,sp,65,17,31,48
Gambia,2004,sp,014,7,5,12
Gambia,2004,sp,1524,55,145,200
Gambia,2004,sp,2534,81,260,341
Gambia,2004,sp,3544,59,151,210
Gambia,2004,sp,4554,38,103,141
Gambia,2004,sp,5564,21,46,67
Gambia,2004,sp,65,18,23,41
Gambia,2005,sp,014,2,13,15
Gambia,2005,sp,1524,84,133,217
Gambia,2005,sp,2534,87,292,379
Gambia,2005,sp,3544,64,206,270
Gambia,2005,sp,4554,38,62,100
Gambia,2005,sp,5564,22,53,75
Gambia,2005,sp,65,27,44,71
Gambia,2006,sp,014,5,13,18
Gambia,2006,sp,1524,88,126,214
Gambia,2006,sp,2534,126,284,410
Gambia,2006,sp,3544,71,170,241
Gambia,2006,sp,4554,49,112,161
Gambia,2006,sp,5564,25,58,83
Gambia,2006,sp,65,26,56,82
Gambia,2008,ep,014,10,13,23
Gambia,2008,ep,1524,9,10,19
Gambia,2008,ep,2534,15,10,25
Gambia,2008,ep,3544,10,10,20
Gambia,2008,ep,4554,6,4,10
Gambia,2008,ep,5564,3,13,16
Gambia,2008,ep,65,0,3,3
Gambia,2008,sn,014,38,45,83
Gambia,2008,sn,1524,29,39,68
Gambia,2008,sn,2534,64,51,115
Gambia,2008,sn,3544,47,56,103
Gambia,2008,sn,4554,41,67,108
Gambia,2008,sn,5564,46,73,119
Gambia,2008,sn,65,6,8,14
Gambia,2008,sp,014,9,7,16
Gambia,2008,sp,1524,94,151,245
Gambia,2008,sp,2534,133,307,440
Gambia,2008,sp,3544,90,167,257
Gambia,2008,sp,4554,43,125,168
Gambia,2008,sp,5564,45,87,132
Gambia,2008,sp,65,8,34,42
Gambia,2009,ep,014,1,4,5
Gambia,2009,ep,1524,11,27,38
Gambia,2009,ep,2534,20,19,39
Gambia,2009,ep,3544,27,30,57
Gambia,2009,ep,4554,0,0,0
Gambia,2009,ep,5564,0,1,1
Gambia,2009,ep,65,0,1,1
Gambia,2009,sn,014,21,37,58
Gambia,2009,sn,1524,7,13,20
Gambia,2009,sn,2534,94,79,173
Gambia,2009,sn,3544,111,122,233
Gambia,2009,sn,4554,49,49,98
Gambia,2009,sn,5564,8,16,24
Gambia,2009,sn,65,7,9,16
Gambia,2009,sp,014,20,12,32
Gambia,2009,sp,1524,91,159,250
Gambia,2009,sp,2534,143,240,383
Gambia,2009,sp,3544,84,185,269
Gambia,2009,sp,4554,70,124,194
Gambia,2009,sp,5564,37,74,111
Gambia,2009,sp,65,28,49,77
Gambia,2010,sp,014,6,9,15
Gambia,2010,sp,1524,104,194,298
Gambia,2010,sp,2534,121,314,435
Gambia,2010,sp,3544,71,184,255
Gambia,2010,sp,4554,35,141,176
Gambia,2010,sp,5564,40,68,108
Gambia,2010,sp,65,18,39,57
Gambia,2011,sp,014,16,14,30
Gambia,2011,sp,1524,103,183,286
Gambia,2011,sp,2534,112,271,383
Gambia,2011,sp,3544,88,181,269
Gambia,2011,sp,4554,63,136,199
Gambia,2011,sp,5564,32,87,119
Gambia,2011,sp,65,33,56,89
Gambia,2012,sp,014,16,7,23
Gambia,2012,sp,1524,123,210,333
Gambia,2012,sp,2534,106,331,437
Gambia,2012,sp,3544,89,191,280
Gambia,2012,sp,4554,41,107,148
Gambia,2012,sp,5564,32,80,112
Gambia,2012,sp,65,42,54,96
Gambia,2013,rel,014,66,71,137
Georgia,1995,sp,014,2,2,4
Georgia,1995,sp,1524,8,20,28
Georgia,1995,sp,2534,17,30,47
Georgia,1995,sp,3544,17,25,42
Georgia,1995,sp,4554,18,40,58
Georgia,1995,sp,5564,7,18,25
Georgia,1995,sp,65,5,12,17
Georgia,1996,sp,014,1,4,5
Georgia,1996,sp,1524,13,27,40
Georgia,1996,sp,2534,28,82,110
Georgia,1996,sp,3544,36,93,129
Georgia,1996,sp,4554,23,76,99
Georgia,1996,sp,5564,27,38,65
Georgia,1996,sp,65,11,16,27
Georgia,1997,sp,014,0,0,0
Georgia,1997,sp,1524,38,75,113
Georgia,1997,sp,2534,46,97,143
Georgia,1997,sp,3544,40,91,131
Georgia,1997,sp,4554,36,67,103
Georgia,1997,sp,5564,19,58,77
Georgia,1997,sp,65,12,16,28
Georgia,1998,sp,014,4,4,8
Georgia,1998,sp,1524,41,64,105
Georgia,1998,sp,2534,52,91,143
Georgia,1998,sp,3544,25,99,124
Georgia,1998,sp,4554,14,58,72
Georgia,1998,sp,5564,17,52,69
Georgia,1998,sp,65,7,19,26
Georgia,1999,sp,014,3,5,8
Georgia,1999,sp,1524,27,135,162
Georgia,1999,sp,2534,40,176,216
Georgia,1999,sp,3544,26,151,177
Georgia,1999,sp,4554,10,77,87
Georgia,1999,sp,5564,10,55,65
Georgia,1999,sp,65,8,23,31
Georgia,2000,sp,014,1,4,5
Georgia,2000,sp,1524,49,76,125
Georgia,2000,sp,2534,37,111,148
Georgia,2000,sp,3544,33,113,146
Georgia,2000,sp,4554,17,63,80
Georgia,2000,sp,5564,10,45,55
Georgia,2000,sp,65,5,28,33
Georgia,2001,sp,014,2,4,6
Georgia,2001,sp,1524,63,142,205
Georgia,2001,sp,2534,63,233,296
Georgia,2001,sp,3544,37,199,236
Georgia,2001,sp,4554,22,117,139
Georgia,2001,sp,5564,18,46,64
Georgia,2001,sp,65,22,46,68
Georgia,2002,sp,014,5,1,6
Georgia,2002,sp,1524,54,155,209
Georgia,2002,sp,2534,68,197,265
Georgia,2002,sp,3544,39,181,220
Georgia,2002,sp,4554,31,119,150
Georgia,2002,sp,5564,20,54,74
Georgia,2002,sp,65,18,42,60
Georgia,2003,sp,014,1,1,2
Georgia,2003,sp,1524,65,112,177
Georgia,2003,sp,2534,59,220,279
Georgia,2003,sp,3544,56,185,241
Georgia,2003,sp,4554,19,111,130
Georgia,2003,sp,5564,23,65,88
Georgia,2003,sp,65,17,53,70
Georgia,2004,sp,014,3,3,6
Georgia,2004,sp,1524,87,157,244
Georgia,2004,sp,2534,81,292,373
Georgia,2004,sp,3544,52,226,278
Georgia,2004,sp,4554,32,177,209
Georgia,2004,sp,5564,26,80,106
Georgia,2004,sp,65,29,66,95
Georgia,2005,sp,014,4,0,4
Georgia,2005,sp,1524,109,226,335
Georgia,2005,sp,2534,105,272,377
Georgia,2005,sp,3544,58,268,326
Georgia,2005,sp,4554,46,207,253
Georgia,2005,sp,5564,17,76,93
Georgia,2005,sp,65,47,60,107
Georgia,2006,ep,014,130,162,292
Georgia,2006,ep,1524,120,210,330
Georgia,2006,ep,2534,95,128,223
Georgia,2006,ep,3544,75,73,148
Georgia,2006,ep,4554,48,64,112
Georgia,2006,ep,5564,32,43,75
Georgia,2006,ep,65,40,39,79
Georgia,2006,sn,014,24,23,47
Georgia,2006,sn,1524,91,165,256
Georgia,2006,sn,2534,118,156,274
Georgia,2006,sn,3544,61,162,223
Georgia,2006,sn,4554,43,124,167
Georgia,2006,sn,5564,31,79,110
Georgia,2006,sn,65,44,108,152
Georgia,2006,sp,014,5,3,8
Georgia,2006,sp,1524,115,315,430
Georgia,2006,sp,2534,110,392,502
Georgia,2006,sp,3544,71,300,371
Georgia,2006,sp,4554,60,241,301
Georgia,2006,sp,5564,26,86,112
Georgia,2006,sp,65,34,72,106
Georgia,2007,ep,014,103,142,245
Georgia,2007,ep,1524,122,176,298
Georgia,2007,ep,2534,104,145,249
Georgia,2007,ep,3544,72,91,163
Georgia,2007,ep,4554,49,81,130
Georgia,2007,ep,5564,37,33,70
Georgia,2007,ep,65,37,38,75
Georgia,2007,sn,014,25,23,48
Georgia,2007,sn,1524,83,132,215
Georgia,2007,sn,2534,62,116,178
Georgia,2007,sn,3544,56,114,170
Georgia,2007,sn,4554,31,120,151
Georgia,2007,sn,5564,14,75,89
Georgia,2007,sn,65,29,54,83
Georgia,2007,sp,014,6,7,13
Georgia,2007,sp,1524,153,277,430
Georgia,2007,sp,2534,140,388,528
Georgia,2007,sp,3544,67,308,375
Georgia,2007,sp,4554,54,230,284
Georgia,2007,sp,5564,17,96,113
Georgia,2007,sp,65,46,75,121
Georgia,2008,ep,014,89,139,228
Georgia,2008,ep,1524,120,183,303
Georgia,2008,ep,2534,105,123,228
Georgia,2008,ep,3544,66,92,158
Georgia,2008,ep,4554,45,70,115
Georgia,2008,ep,5564,28,57,85
Georgia,2008,ep,65,48,52,100
Georgia,2008,sn,014,14,17,31
Georgia,2008,sn,1524,89,133,222
Georgia,2008,sn,2534,89,145,234
Georgia,2008,sn,3544,49,139,188
Georgia,2008,sn,4554,26,112,138
Georgia,2008,sn,5564,20,84,104
Georgia,2008,sn,65,42,104,146
Georgia,2008,sp,014,4,4,8
Georgia,2008,sp,1524,142,294,436
Georgia,2008,sp,2534,121,380,501
Georgia,2008,sp,3544,61,312,373
Georgia,2008,sp,4554,44,243,287
Georgia,2008,sp,5564,22,118,140
Georgia,2008,sp,65,46,77,123
Georgia,2009,ep,014,86,153,239
Georgia,2009,ep,1524,124,175,299
Georgia,2009,ep,2534,104,191,295
Georgia,2009,ep,3544,62,99,161
Georgia,2009,ep,4554,47,86,133
Georgia,2009,ep,5564,28,44,72
Georgia,2009,ep,65,45,39,84
Georgia,2009,sn,014,20,15,35
Georgia,2009,sn,1524,93,140,233
Georgia,2009,sn,2534,97,170,267
Georgia,2009,sn,3544,36,141,177
Georgia,2009,sn,4554,21,145,166
Georgia,2009,sn,5564,28,73,101
Georgia,2009,sn,65,42,98,140
Georgia,2009,sp,014,5,2,7
Georgia,2009,sp,1524,124,327,451
Georgia,2009,sp,2534,134,435,569
Georgia,2009,sp,3544,74,310,384
Georgia,2009,sp,4554,60,284,344
Georgia,2009,sp,5564,30,135,165
Georgia,2009,sp,65,46,89,135
Georgia,2010,ep,014,86,123,209
Georgia,2010,ep,1524,98,156,254
Georgia,2010,ep,2534,93,170,263
Georgia,2010,ep,3544,56,125,181
Georgia,2010,ep,4554,37,71,108
Georgia,2010,ep,5564,30,50,80
Georgia,2010,ep,65,27,33,60
Georgia,2010,sn,014,16,14,30
Georgia,2010,sn,1524,94,143,237
Georgia,2010,sn,2534,92,182,274
Georgia,2010,sn,3544,59,135,194
Georgia,2010,sn,4554,39,136,175
Georgia,2010,sn,5564,10,66,76
Georgia,2010,sn,65,24,78,102
Georgia,2010,sp,014,5,5,10
Georgia,2010,sp,1524,135,340,475
Georgia,2010,sp,2534,118,529,647
Georgia,2010,sp,3544,62,341,403
Georgia,2010,sp,4554,52,264,316
Georgia,2010,sp,5564,28,143,171
Georgia,2010,sp,65,41,77,118
Georgia,2011,ep,014,67,98,165
Georgia,2011,ep,1524,105,139,244
Georgia,2011,ep,2534,95,155,250
Georgia,2011,ep,3544,54,91,145
Georgia,2011,ep,4554,50,60,110
Georgia,2011,ep,5564,28,43,71
Georgia,2011,ep,65,33,38,71
Georgia,2011,sn,014,14,10,24
Georgia,2011,sn,1524,88,146,234
Georgia,2011,sn,2534,90,220,310
Georgia,2011,sn,3544,47,162,209
Georgia,2011,sn,4554,33,130,163
Georgia,2011,sn,5564,26,67,93
Georgia,2011,sn,65,30,78,108
Georgia,2011,sp,014,8,5,13
Georgia,2011,sp,1524,136,271,407
Georgia,2011,sp,2534,132,478,610
Georgia,2011,sp,3544,59,333,392
Georgia,2011,sp,4554,32,251,283
Georgia,2011,sp,5564,35,139,174
Georgia,2011,sp,65,54,93,147
Georgia,2012,ep,014,81,106,187
Georgia,2012,ep,1524,83,138,221
Georgia,2012,ep,2534,88,124,212
Georgia,2012,ep,3544,49,71,120
Georgia,2012,ep,4554,35,53,88
Georgia,2012,ep,5564,24,33,57
Georgia,2012,ep,65,26,33,59
Georgia,2012,sn,014,10,9,19
Georgia,2012,sn,1524,84,167,251
Georgia,2012,sn,2534,100,200,300
Georgia,2012,sn,3544,48,161,209
Georgia,2012,sn,4554,37,134,171
Georgia,2012,sn,5564,23,101,124
Georgia,2012,sn,65,26,86,112
Georgia,2012,sp,014,5,4,9
Georgia,2012,sp,1524,101,200,301
Georgia,2012,sp,2534,116,314,430
Georgia,2012,sp,3544,72,248,320
Georgia,2012,sp,4554,43,235,278
Georgia,2012,sp,5564,32,150,182
Georgia,2012,sp,65,47,81,128
Georgia,2013,rel,014,78,105,183
Georgia,2013,rel,1524,248,337,585
Georgia,2013,rel,2534,298,556,854
Georgia,2013,rel,3544,145,455,600
Georgia,2013,rel,4554,99,431,530
Georgia,2013,rel,5564,73,306,379
Georgia,2013,rel,65,118,185,303
Germany,1995,sp,014,17,14,31
Germany,1995,sp,1524,115,179,294
Germany,1995,sp,2534,251,453,704
Germany,1995,sp,3544,167,539,706
Germany,1995,sp,4554,89,460,549
Germany,1995,sp,5564,104,442,546
Germany,1995,sp,65,397,625,1022
Germany,1996,sp,014,19,20,39
Germany,1996,sp,1524,150,181,331
Germany,1996,sp,2534,214,377,591
Germany,1996,sp,3544,180,520,700
Germany,1996,sp,4554,97,413,510
Germany,1996,sp,5564,108,405,513
Germany,1996,sp,65,389,607,996
Germany,1997,sp,014,16,11,27
Germany,1997,sp,1524,109,166,275
Germany,1997,sp,2534,204,375,579
Germany,1997,sp,3544,154,459,613
Germany,1997,sp,4554,93,384,477
Germany,1997,sp,5564,99,424,523
Germany,1997,sp,65,343,509,852
Germany,1998,sp,014,11,9,20
Germany,1998,sp,1524,121,179,300
Germany,1998,sp,2534,166,333,499
Germany,1998,sp,3544,141,448,589
Germany,1998,sp,4554,93,358,451
Germany,1998,sp,5564,80,349,429
Germany,1998,sp,65,298,538,836
Germany,1999,sp,014,15,13,28
Germany,1999,sp,1524,118,145,263
Germany,1999,sp,2534,177,308,485
Germany,1999,sp,3544,98,419,517
Germany,1999,sp,4554,85,362,447
Germany,1999,sp,5564,99,335,434
Germany,1999,sp,65,295,449,744
Germany,2001,sp,014,1,3,4
Germany,2001,sp,1524,36,3,39
Germany,2001,sp,2534,59,89,148
Germany,2001,sp,3544,48,136,184
Germany,2001,sp,4554,42,106,148
Germany,2001,sp,5564,26,94,120
Germany,2001,sp,65,79,119,198
Germany,2002,sp,014,1,3,4
Germany,2002,sp,1524,32,34,66
Germany,2002,sp,2534,61,75,136
Germany,2002,sp,3544,50,102,152
Germany,2002,sp,4554,14,88,102
Germany,2002,sp,5564,16,81,97
Germany,2002,sp,65,64,101,165
Germany,2003,sp,014,10,2,12
Germany,2003,sp,1524,61,68,129
Germany,2003,sp,2534,96,107,203
Germany,2003,sp,3544,86,177,263
Germany,2003,sp,4554,43,163,206
Germany,2003,sp,5564,22,103,125
Germany,2003,sp,65,102,155,257
Germany,2004,sp,014,6,5,11
Germany,2004,sp,1524,75,63,138
Germany,2004,sp,2534,110,130,240
Germany,2004,sp,3544,97,182,279
Germany,2004,sp,4554,42,161,203
Germany,2004,sp,5564,32,110,142
Germany,2004,sp,65,116,198,314
Germany,2005,sp,014,4,6,10
Germany,2005,sp,1524,51,59,110
Germany,2005,sp,2534,104,113,217
Germany,2005,sp,3544,73,171,244
Germany,2005,sp,4554,43,167,210
Germany,2005,sp,5564,37,92,129
Germany,2005,sp,65,103,167,270
Germany,2006,ep,014,26,16,42
Germany,2006,ep,1524,46,43,89
Germany,2006,ep,2534,104,93,197
Germany,2006,ep,3544,81,77,158
Germany,2006,ep,4554,67,49,116
Germany,2006,ep,5564,53,65,118
Germany,2006,ep,65,177,129,306
Germany,2006,sn,014,75,63,138
Germany,2006,sn,1524,102,93,195
Germany,2006,sn,2534,180,203,383
Germany,2006,sn,3544,134,230,364
Germany,2006,sn,4554,133,223,356
Germany,2006,sn,5564,98,224,322
Germany,2006,sn,65,342,434,776
Germany,2006,sp,014,7,2,9
Germany,2006,sp,1524,66,78,144
Germany,2006,sp,2534,109,138,247
Germany,2006,sp,3544,77,169,246
Germany,2006,sp,4554,39,189,228
Germany,2006,sp,5564,24,103,127
Germany,2006,sp,65,102,199,301
Germany,2007,ep,014,23,24,47
Germany,2007,ep,1524,47,36,83
Germany,2007,ep,2534,86,80,166
Germany,2007,ep,3544,66,58,124
Germany,2007,ep,4554,56,63,119
Germany,2007,ep,5564,74,63,137
Germany,2007,ep,65,181,119,300
Germany,2007,sn,014,55,62,117
Germany,2007,sn,1524,96,106,202
Germany,2007,sn,2534,141,145,286
Germany,2007,sn,3544,137,191,328
Germany,2007,sn,4554,105,266,371
Germany,2007,sn,5564,100,187,287
Germany,2007,sn,65,312,414,726
Germany,2007,sp,014,4,2,6
Germany,2007,sp,1524,120,116,236
Germany,2007,sp,2534,176,248,424
Germany,2007,sp,3544,152,314,466
Germany,2007,sp,4554,116,344,460
Germany,2007,sp,5564,46,184,230
Germany,2007,sp,65,178,362,540
Germany,2008,ep,014,15,9,24
Germany,2008,ep,1524,34,27,61
Germany,2008,ep,2534,66,65,131
Germany,2008,ep,3544,50,71,121
Germany,2008,ep,4554,43,55,98
Germany,2008,ep,5564,59,45,104
Germany,2008,ep,65,145,113,258
Germany,2008,sn,014,35,45,80
Germany,2008,sn,1524,81,66,147
Germany,2008,sn,2534,117,129,246
Germany,2008,sn,3544,101,158,259
Germany,2008,sn,4554,89,212,301
Germany,2008,sn,5564,53,172,225
Germany,2008,sn,65,213,318,531
Germany,2008,sp,014,6,2,8
Germany,2008,sp,1524,35,40,75
Germany,2008,sp,2534,68,95,163
Germany,2008,sp,3544,61,114,175
Germany,2008,sp,4554,41,142,183
Germany,2008,sp,5564,33,96,129
Germany,2008,sp,65,71,148,219
Germany,2009,ep,014,17,15,32
Germany,2009,ep,1524,26,37,63
Germany,2009,ep,2534,69,58,127
Germany,2009,ep,3544,67,56,123
Germany,2009,ep,4554,54,36,90
Germany,2009,ep,5564,53,46,99
Germany,2009,ep,65,115,99,214
Germany,2009,sn,014,56,45,101
Germany,2009,sn,1524,73,77,150
Germany,2009,sn,2534,116,134,250
Germany,2009,sn,3544,84,133,217
Germany,2009,sn,4554,70,194,264
Germany,2009,sn,5564,80,151,231
Germany,2009,sn,65,232,332,564
Germany,2009,sp,014,1,2,3
Germany,2009,sp,1524,52,48,100
Germany,2009,sp,2534,76,109,185
Germany,2009,sp,3544,51,125,176
Germany,2009,sp,4554,49,163,212
Germany,2009,sp,5564,27,103,130
Germany,2009,sp,65,92,148,240
Germany,2010,ep,014,15,20,35
Germany,2010,ep,1524,25,30,55
Germany,2010,ep,2534,63,74,137
Germany,2010,ep,3544,68,45,113
Germany,2010,ep,4554,52,58,110
Germany,2010,ep,5564,50,40,90
Germany,2010,ep,65,138,106,244
Germany,2010,sn,014,53,60,113
Germany,2010,sn,1524,66,90,156
Germany,2010,sn,2534,125,119,244
Germany,2010,sn,3544,61,131,192
Germany,2010,sn,4554,89,185,274
Germany,2010,sn,5564,49,148,197
Germany,2010,sn,65,205,320,525
Germany,2010,sp,014,3,1,4
Germany,2010,sp,1524,48,49,97
Germany,2010,sp,2534,68,96,164
Germany,2010,sp,3544,63,105,168
Germany,2010,sp,4554,38,149,187
Germany,2010,sp,5564,27,97,124
Germany,2010,sp,65,78,145,223
Germany,2011,ep,014,14,15,29
Germany,2011,ep,1524,22,29,51
Germany,2011,ep,2534,55,67,122
Germany,2011,ep,3544,50,61,111
Germany,2011,ep,4554,49,52,101
Germany,2011,ep,5564,62,40,102
Germany,2011,ep,65,122,99,221
Germany,2011,sn,014,63,65,128
Germany,2011,sn,1524,62,74,136
Germany,2011,sn,2534,128,118,246
Germany,2011,sn,3544,85,141,226
Germany,2011,sn,4554,87,180,267
Germany,2011,sn,5564,76,151,227
Germany,2011,sn,65,212,333,545
Germany,2011,sp,014,2,0,2
Germany,2011,sp,1524,45,43,88
Germany,2011,sp,2534,90,95,185
Germany,2011,sp,3544,61,108,169
Germany,2011,sp,4554,53,139,192
Germany,2011,sp,5564,26,69,95
Germany,2011,sp,65,87,127,214
Germany,2012,ep,014,18,14,32
Germany,2012,ep,1524,25,51,76
Germany,2012,ep,2534,86,72,158
Germany,2012,ep,3544,53,59,112
Germany,2012,ep,4554,50,62,112
Germany,2012,ep,5564,57,49,106
Germany,2012,ep,65,109,119,228
Germany,2012,sn,014,61,66,127
Germany,2012,sn,1524,53,78,131
Germany,2012,sn,2534,97,122,219
Germany,2012,sn,3544,78,140,218
Germany,2012,sn,4554,68,154,222
Germany,2012,sn,5564,64,158,222
Germany,2012,sn,65,189,276,465
Germany,2012,sp,014,6,4,10
Germany,2012,sp,1524,53,47,100
Germany,2012,sp,2534,99,101,200
Germany,2012,sp,3544,38,114,152
Germany,2012,sp,4554,46,152,198
Germany,2012,sp,5564,25,106,131
Germany,2012,sp,65,55,104,159
Germany,2013,rel,014,80,88,168
Germany,2013,rel,1524,189,268,457
Germany,2013,rel,2534,323,399,722
Germany,2013,rel,3544,215,379,594
Germany,2013,rel,4554,186,433,619
Germany,2013,rel,5564,158,328,486
Germany,2013,rel,65,457,672,1129
Ghana,1995,sp,014,40,42,82
Ghana,1995,sp,1524,199,223,422
Ghana,1995,sp,2534,272,397,669
Ghana,1995,sp,3544,205,398,603
Ghana,1995,sp,4554,122,302,424
Ghana,1995,sp,5564,88,190,278
Ghana,1995,sp,65,48,112,160
Ghana,1996,sp,014,32,30,62
Ghana,1996,sp,1524,177,216,393
Ghana,1996,sp,2534,260,345,605
Ghana,1996,sp,3544,200,368,568
Ghana,1996,sp,4554,110,255,365
Ghana,1996,sp,5564,64,165,229
Ghana,1996,sp,65,43,157,200
Ghana,1997,sp,014,90,77,167
Ghana,1997,sp,1524,363,406,769
Ghana,1997,sp,2534,651,941,1592
Ghana,1997,sp,3544,418,781,1199
Ghana,1997,sp,4554,276,623,899
Ghana,1997,sp,5564,188,367,555
Ghana,1997,sp,65,121,294,415
Ghana,1998,sp,014,85,83,168
Ghana,1998,sp,1524,483,553,1036
Ghana,1998,sp,2534,758,1009,1767
Ghana,1998,sp,3544,493,913,1406
Ghana,1998,sp,4554,366,775,1141
Ghana,1998,sp,5564,248,509,757
Ghana,1998,sp,65,243,487,730
Ghana,1999,sp,014,80,64,144
Ghana,1999,sp,1524,491,586,1077
Ghana,1999,sp,2534,753,1132,1885
Ghana,1999,sp,3544,492,1008,1500
Ghana,1999,sp,4554,302,767,1069
Ghana,1999,sp,5564,192,389,581
Ghana,1999,sp,65,180,389,569
Ghana,2000,sp,014,74,73,147
Ghana,2000,sp,1524,456,550,1006
Ghana,2000,sp,2534,791,1266,2057
Ghana,2000,sp,3544,566,1115,1681
Ghana,2000,sp,4554,338,811,1149
Ghana,2000,sp,5564,179,495,674
Ghana,2000,sp,65,176,426,602
Ghana,2001,sp,014,128,84,212
Ghana,2001,sp,1524,515,587,1102
Ghana,2001,sp,2534,814,1223,2037
Ghana,2001,sp,3544,623,1144,1767
Ghana,2001,sp,4554,370,857,1227
Ghana,2001,sp,5564,209,471,680
Ghana,2001,sp,65,227,460,687
Ghana,2002,sp,014,98,80,178
Ghana,2002,sp,1524,489,535,1024
Ghana,2002,sp,2534,806,1245,2051
Ghana,2002,sp,3544,592,1282,1874
Ghana,2002,sp,4554,325,883,1208
Ghana,2002,sp,5564,223,507,730
Ghana,2002,sp,65,238,429,667
Ghana,2003,sp,014,83,79,162
Ghana,2003,sp,1524,487,579,1066
Ghana,2003,sp,2534,744,1265,2009
Ghana,2003,sp,3544,586,1234,1820
Ghana,2003,sp,4554,380,924,1304
Ghana,2003,sp,5564,200,509,709
Ghana,2003,sp,65,203,441,644
Ghana,2004,sp,014,69,54,123
Ghana,2004,sp,1524,454,532,986
Ghana,2004,sp,2534,701,1246,1947
Ghana,2004,sp,3544,518,1250,1768
Ghana,2004,sp,4554,303,854,1157
Ghana,2004,sp,5564,202,472,674
Ghana,2004,sp,65,191,413,604
Ghana,2005,sp,014,68,49,117
Ghana,2005,sp,1524,450,592,1042
Ghana,2005,sp,2534,693,1201,1894
Ghana,2005,sp,3544,527,1311,1838
Ghana,2005,sp,4554,366,944,1310
Ghana,2005,sp,5564,207,462,669
Ghana,2005,sp,65,221,414,635
Ghana,2006,sp,014,70,33,103
Ghana,2006,sp,1524,494,557,1051
Ghana,2006,sp,2534,711,1273,1984
Ghana,2006,sp,3544,515,1388,1903
Ghana,2006,sp,4554,381,956,1337
Ghana,2006,sp,5564,207,529,736
Ghana,2006,sp,65,229,443,672
Ghana,2007,ep,014,0,0,0
Ghana,2007,ep,1524,0,0,0
Ghana,2007,ep,3544,0,NA,NA
Ghana,2007,ep,5564,NA,0,NA
Ghana,2007,ep,65,0,NA,NA
Ghana,2007,sn,014,0,0,0
Ghana,2007,sn,1524,0,0,0
Ghana,2007,sn,2534,0,0,0
Ghana,2007,sn,3544,0,0,0
Ghana,2007,sn,4554,NA,0,NA
Ghana,2007,sn,5564,0,NA,NA
Ghana,2007,sn,65,0,0,0
Ghana,2007,sp,014,75,66,141
Ghana,2007,sp,1524,453,596,1049
Ghana,2007,sp,2534,667,1164,1831
Ghana,2007,sp,3544,564,1239,1803
Ghana,2007,sp,4554,371,861,1232
Ghana,2007,sp,5564,183,477,660
Ghana,2007,sp,65,207,506,713
Ghana,2009,sp,014,58,66,124
Ghana,2009,sp,1524,491,674,1165
Ghana,2009,sp,2534,701,1285,1986
Ghana,2009,sp,3544,605,1423,2028
Ghana,2009,sp,4554,362,1064,1426
Ghana,2009,sp,5564,197,505,702
Ghana,2009,sp,65,285,539,824
Ghana,2010,sn,014,251,292,543
Ghana,2010,sn,1524,206,285,491
Ghana,2010,sn,2534,455,607,1062
Ghana,2010,sn,3544,460,716,1176
Ghana,2010,sn,4554,283,511,794
Ghana,2010,sn,5564,147,284,431
Ghana,2010,sn,65,226,345,571
Ghana,2010,sp,014,64,63,127
Ghana,2010,sp,1524,446,570,1016
Ghana,2010,sp,2534,667,1146,1813
Ghana,2010,sp,3544,560,1301,1861
Ghana,2010,sp,4554,369,1030,1399
Ghana,2010,sp,5564,204,540,744
Ghana,2010,sp,65,249,447,696
Ghana,2011,ep,014,85,119,204
Ghana,2011,ep,1524,80,110,190
Ghana,2011,ep,2534,153,141,294
Ghana,2011,ep,3544,104,187,291
Ghana,2011,ep,4554,74,136,210
Ghana,2011,ep,5564,59,95,154
Ghana,2011,ep,65,54,74,128
Ghana,2011,sn,014,252,311,563
Ghana,2011,sn,1524,189,249,438
Ghana,2011,sn,2534,452,632,1084
Ghana,2011,sn,3544,496,869,1365
Ghana,2011,sn,4554,318,658,976
Ghana,2011,sn,5564,210,390,600
Ghana,2011,sn,65,313,536,849
Ghana,2011,sp,014,52,50,102
Ghana,2011,sp,1524,470,550,1020
Ghana,2011,sp,2534,699,1127,1826
Ghana,2011,sp,3544,614,1328,1942
Ghana,2011,sp,4554,390,955,1345
Ghana,2011,sp,5564,174,491,665
Ghana,2011,sp,65,260,456,716
Ghana,2012,ep,014,97,124,221
Ghana,2012,ep,1524,57,97,154
Ghana,2012,ep,2534,102,130,232
Ghana,2012,ep,3544,116,153,269
Ghana,2012,ep,4554,77,115,192
Ghana,2012,ep,5564,39,104,143
Ghana,2012,ep,65,36,54,90
Ghana,2012,sn,014,243,275,518
Ghana,2012,sn,1524,202,274,476
Ghana,2012,sn,2534,446,576,1022
Ghana,2012,sn,3544,496,871,1367
Ghana,2012,sn,4554,360,703,1063
Ghana,2012,sn,5564,220,419,639
Ghana,2012,sn,65,331,563,894
Ghana,2012,sp,014,51,30,81
Ghana,2012,sp,1524,418,559,977
Ghana,2012,sp,2534,563,1051,1614
Ghana,2012,sp,3544,468,1271,1739
Ghana,2012,sp,4554,332,921,1253
Ghana,2012,sp,5564,188,512,700
Ghana,2012,sp,65,271,462,733
Ghana,2013,rel,014,363,420,783
Ghana,2013,rel,1524,753,937,1690
Ghana,2013,rel,2534,1170,1871,3041
Ghana,2013,rel,3544,1089,2401,3490
Ghana,2013,rel,4554,793,1901,2694
Ghana,2013,rel,5564,463,1128,1591
Ghana,2013,rel,65,674,1080,1754
Greece,1997,sp,014,0,0,0
Greece,1997,sp,1524,14,16,30
Greece,1997,sp,2534,19,30,49
Greece,1997,sp,3544,8,34,42
Greece,1997,sp,4554,3,42,45
Greece,1997,sp,5564,9,39,48
Greece,1997,sp,65,26,47,73
Greece,1998,sp,014,11,15,26
Greece,1998,sp,1524,20,15,35
Greece,1998,sp,2534,12,31,43
Greece,1998,sp,3544,13,31,44
Greece,1998,sp,4554,8,22,30
Greece,1998,sp,5564,5,31,36
Greece,1998,sp,65,26,47,73
Greece,1999,sp,014,1,3,4
Greece,1999,sp,1524,5,11,16
Greece,1999,sp,2534,8,11,19
Greece,1999,sp,3544,8,17,25
Greece,1999,sp,4554,2,18,20
Greece,1999,sp,5564,3,18,21
Greece,1999,sp,65,10,27,37
Greece,2000,sp,014,0,1,1
Greece,2000,sp,1524,2,10,12
Greece,2000,sp,2534,9,22,31
Greece,2000,sp,3544,10,32,42
Greece,2000,sp,4554,5,24,29
Greece,2000,sp,5564,6,19,25
Greece,2000,sp,65,25,46,71
Greece,2001,sp,014,0,0,0
Greece,2001,sp,1524,7,10,17
Greece,2001,sp,2534,11,23,34
Greece,2001,sp,3544,7,29,36
Greece,2001,sp,4554,4,20,24
Greece,2001,sp,5564,7,17,24
Greece,2001,sp,65,27,37,64
Greece,2002,sp,014,0,0,0
Greece,2002,sp,1524,0,1,1
Greece,2002,sp,2534,3,13,16
Greece,2002,sp,3544,17,27,44
Greece,2002,sp,4554,11,33,44
Greece,2002,sp,5564,5,30,35
Greece,2002,sp,65,2,10,12
Greece,2003,sp,014,0,2,2
Greece,2003,sp,1524,7,20,27
Greece,2003,sp,2534,9,28,37
Greece,2003,sp,3544,7,25,32
Greece,2003,sp,4554,2,23,25
Greece,2003,sp,5564,5,25,30
Greece,2003,sp,65,18,36,54
Greece,2004,sp,014,0,1,1
Greece,2004,sp,1524,3,9,12
Greece,2004,sp,2534,7,14,21
Greece,2004,sp,3544,10,22,32
Greece,2004,sp,4554,3,18,21
Greece,2004,sp,5564,3,13,16
Greece,2004,sp,65,14,34,48
Greece,2005,sp,014,0,1,1
Greece,2005,sp,1524,13,14,27
Greece,2005,sp,2534,18,25,43
Greece,2005,sp,3544,8,22,30
Greece,2005,sp,4554,7,14,21
Greece,2005,sp,5564,2,12,14
Greece,2005,sp,65,17,23,40
Greece,2006,ep,014,2,1,3
Greece,2006,ep,1524,1,7,8
Greece,2006,ep,2534,1,10,11
Greece,2006,ep,3544,1,3,4
Greece,2006,ep,4554,3,10,13
Greece,2006,ep,5564,5,5,10
Greece,2006,ep,65,15,20,35
Greece,2006,sn,014,11,9,20
Greece,2006,sn,1524,10,13,23
Greece,2006,sn,2534,13,28,41
Greece,2006,sn,3544,12,19,31
Greece,2006,sn,4554,8,29,37
Greece,2006,sn,5564,5,27,32
Greece,2006,sn,65,40,59,99
Greece,2006,sp,014,0,0,0
Greece,2006,sp,1524,13,11,24
Greece,2006,sp,2534,12,32,44
Greece,2006,sp,3544,8,22,30
Greece,2006,sp,4554,5,24,29
Greece,2006,sp,5564,6,22,28
Greece,2006,sp,65,24,27,51
Greece,2007,ep,014,5,7,12
Greece,2007,ep,1524,0,1,1
Greece,2007,ep,2534,0,0,0
Greece,2007,ep,3544,1,3,4
Greece,2007,ep,4554,0,2,2
Greece,2007,ep,5564,0,0,0
Greece,2007,ep,65,0,1,1
Greece,2007,sn,014,13,9,22
Greece,2007,sn,1524,7,16,23
Greece,2007,sn,2534,16,15,31
Greece,2007,sn,3544,10,14,24
Greece,2007,sn,4554,8,17,25
Greece,2007,sn,5564,6,23,29
Greece,2007,sn,65,21,52,73
Greece,2007,sp,014,0,1,1
Greece,2007,sp,1524,13,21,34
Greece,2007,sp,2534,19,22,41
Greece,2007,sp,3544,11,34,45
Greece,2007,sp,4554,8,28,36
Greece,2007,sp,5564,3,15,18
Greece,2007,sp,65,24,54,78
Greece,2008,ep,014,8,0,8
Greece,2008,ep,1524,1,9,10
Greece,2008,ep,2534,5,12,17
Greece,2008,ep,3544,4,3,7
Greece,2008,ep,4554,2,3,5
Greece,2008,ep,5564,1,4,5
Greece,2008,ep,65,12,16,28
Greece,2008,sn,014,9,14,23
Greece,2008,sn,1524,16,18,34
Greece,2008,sn,2534,19,33,52
Greece,2008,sn,3544,18,38,56
Greece,2008,sn,4554,13,45,58
Greece,2008,sn,5564,10,28,38
Greece,2008,sn,65,36,76,112
Greece,2008,sp,014,0,0,0
Greece,2008,sp,1524,5,5,10
Greece,2008,sp,2534,9,14,23
Greece,2008,sp,3544,2,12,14
Greece,2008,sp,4554,4,4,8
Greece,2008,sp,5564,3,6,9
Greece,2008,sp,65,7,9,16
Greece,2009,ep,014,2,1,3
Greece,2009,ep,1524,3,8,11
Greece,2009,ep,2534,6,7,13
Greece,2009,ep,3544,5,3,8
Greece,2009,ep,4554,3,5,8
Greece,2009,ep,5564,0,4,4
Greece,2009,ep,65,11,9,20
Greece,2009,sn,014,8,11,19
Greece,2009,sn,1524,4,19,23
Greece,2009,sn,2534,10,30,40
Greece,2009,sn,3544,9,10,19
Greece,2009,sn,4554,6,14,20
Greece,2009,sn,5564,10,12,22
Greece,2009,sn,65,20,34,54
Greece,2009,sp,014,4,3,7
Greece,2009,sp,1524,8,20,28
Greece,2009,sp,2534,14,22,36
Greece,2009,sp,3544,8,23,31
Greece,2009,sp,4554,9,23,32
Greece,2009,sp,5564,2,15,17
Greece,2009,sp,65,12,31,43
Greece,2010,ep,014,4,2,6
Greece,2010,ep,1524,1,11,12
Greece,2010,ep,2534,3,6,9
Greece,2010,ep,3544,0,5,5
Greece,2010,ep,4554,0,1,1
Greece,2010,ep,5564,2,1,3
Greece,2010,ep,65,5,7,12
Greece,2010,sn,014,11,9,20
Greece,2010,sn,1524,6,15,21
Greece,2010,sn,2534,6,17,23
Greece,2010,sn,3544,2,11,13
Greece,2010,sn,4554,4,8,12
Greece,2010,sn,5564,2,10,12
Greece,2010,sn,65,6,20,26
Greece,2010,sp,014,3,1,4
Greece,2010,sp,1524,1,19,20
Greece,2010,sp,2534,13,27,40
Greece,2010,sp,3544,4,20,24
Greece,2010,sp,4554,4,18,22
Greece,2010,sp,5564,4,19,23
Greece,2010,sp,65,15,22,37
Greece,2011,ep,014,2,1,3
Greece,2011,ep,1524,1,5,6
Greece,2011,ep,2534,3,9,12
Greece,2011,ep,3544,3,3,6
Greece,2011,ep,4554,3,2,5
Greece,2011,ep,5564,2,2,4
Greece,2011,ep,65,11,10,21
Greece,2011,sn,014,15,12,27
Greece,2011,sn,1524,6,11,17
Greece,2011,sn,2534,7,26,33
Greece,2011,sn,3544,3,13,16
Greece,2011,sn,4554,3,10,13
Greece,2011,sn,5564,2,11,13
Greece,2011,sn,65,9,28,37
Greece,2011,sp,014,1,2,3
Greece,2011,sp,1524,9,30,39
Greece,2011,sp,2534,14,30,44
Greece,2011,sp,3544,9,26,35
Greece,2011,sp,4554,3,24,27
Greece,2011,sp,5564,5,19,24
Greece,2011,sp,65,20,38,58
Greece,2012,ep,014,0,2,2
Greece,2012,ep,1524,3,6,9
Greece,2012,ep,2534,3,8,11
Greece,2012,ep,3544,4,2,6
Greece,2012,ep,4554,3,1,4
Greece,2012,ep,5564,1,3,4
Greece,2012,ep,65,9,12,21
Greece,2012,sn,014,16,12,28
Greece,2012,sn,1524,0,7,7
Greece,2012,sn,2534,8,20,28
Greece,2012,sn,3544,4,10,14
Greece,2012,sn,4554,5,12,17
Greece,2012,sn,5564,4,11,15
Greece,2012,sn,65,9,39,48
Greece,2012,sp,014,3,2,5
Greece,2012,sp,1524,11,20,31
Greece,2012,sp,2534,8,31,39
Greece,2012,sp,3544,12,25,37
Greece,2012,sp,4554,1,23,24
Greece,2012,sp,5564,3,24,27
Greece,2012,sp,65,21,45,66
Greece,2013,rel,014,9,21,30
Greece,2013,rel,1524,13,44,57
Greece,2013,rel,2534,22,68,90
Greece,2013,rel,3544,12,56,68
Greece,2013,rel,4554,12,47,59
Greece,2013,rel,5564,12,40,52
Greece,2013,rel,65,52,78,130
Greenland,2009,ep,2534,1,NA,NA
Greenland,2009,ep,3544,NA,1,NA
Greenland,2009,ep,4554,NA,1,NA
Greenland,2009,sn,014,NA,2,NA
Greenland,2009,sn,1524,4,4,8
Greenland,2009,sn,2534,2,5,7
Greenland,2009,sn,3544,NA,1,NA
Greenland,2009,sn,4554,2,7,9
Greenland,2009,sn,5564,NA,3,NA
Greenland,2009,sp,1524,4,2,6
Greenland,2009,sp,2534,5,3,8
Greenland,2009,sp,3544,2,3,5
Greenland,2009,sp,4554,1,3,4
Greenland,2009,sp,5564,NA,1,NA
Greenland,2010,ep,014,0,0,0
Greenland,2010,ep,1524,2,3,5
Greenland,2010,ep,2534,0,0,0
Greenland,2010,ep,3544,0,1,1
Greenland,2010,ep,4554,0,1,1
Greenland,2010,ep,5564,0,0,0
Greenland,2010,ep,65,0,0,0
Greenland,2010,sn,014,4,4,8
Greenland,2010,sn,1524,11,10,21
Greenland,2010,sn,2534,7,6,13
Greenland,2010,sn,3544,4,1,5
Greenland,2010,sn,4554,5,1,6
Greenland,2010,sn,5564,2,2,4
Greenland,2010,sn,65,1,1,2
Greenland,2010,sp,014,1,0,1
Greenland,2010,sp,1524,5,5,10
Greenland,2010,sp,2534,0,7,7
Greenland,2010,sp,3544,0,5,5
Greenland,2010,sp,4554,4,5,9
Greenland,2010,sp,5564,2,2,4
Greenland,2010,sp,65,0,2,2
Greenland,2011,ep,014,1,NA,NA
Greenland,2011,ep,1524,1,3,4
Greenland,2011,ep,2534,0,0,0
Greenland,2011,ep,3544,0,0,0
Greenland,2011,ep,4554,0,0,0
Greenland,2011,ep,5564,0,0,0
Greenland,2011,ep,65,0,0,0
Greenland,2011,sn,014,3,3,6
Greenland,2011,sn,1524,12,20,32
Greenland,2011,sn,2534,4,5,9
Greenland,2011,sn,3544,2,5,7
Greenland,2011,sn,4554,6,3,9
Greenland,2011,sn,5564,7,3,10
Greenland,2011,sn,65,2,1,3
Greenland,2011,sp,014,0,0,0
Greenland,2011,sp,1524,8,10,18
Greenland,2011,sp,2534,1,2,3
Greenland,2011,sp,3544,1,0,1
Greenland,2011,sp,4554,2,3,5
Greenland,2011,sp,5564,3,3,6
Greenland,2011,sp,65,0,1,1
Greenland,2012,ep,014,0,0,0
Greenland,2012,ep,1524,0,0,0
Greenland,2012,ep,2534,0,1,1
Greenland,2012,ep,3544,0,0,0
Greenland,2012,ep,4554,1,1,2
Greenland,2012,ep,5564,2,0,2
Greenland,2012,ep,65,0,0,0
Greenland,2012,sn,014,1,1,2
Greenland,2012,sn,1524,2,8,10
Greenland,2012,sn,2534,3,2,5
Greenland,2012,sn,3544,1,3,4
Greenland,2012,sn,4554,5,8,13
Greenland,2012,sn,5564,0,7,7
Greenland,2012,sn,65,0,3,3
Greenland,2012,sp,014,2,0,2
Greenland,2012,sp,1524,3,6,9
Greenland,2012,sp,2534,0,3,3
Greenland,2012,sp,3544,3,5,8
Greenland,2012,sp,4554,1,1,2
Greenland,2012,sp,5564,0,5,5
Greenland,2012,sp,65,3,1,4
Greenland,2013,rel,014,3,2,5
Greenland,2013,rel,1524,9,21,30
Greenland,2013,rel,2534,3,14,17
Greenland,2013,rel,3544,3,6,9
Greenland,2013,rel,4554,13,7,20
Greenland,2013,rel,5564,4,7,11
Greenland,2013,rel,65,1,3,4
Grenada,1997,sp,014,0,0,0
Grenada,1997,sp,1524,1,0,1
Grenada,1997,sp,2534,0,1,1
Grenada,1997,sp,3544,0,0,0
Grenada,1997,sp,4554,0,0,0
Grenada,1997,sp,5564,0,0,0
Grenada,1997,sp,65,0,0,0
Grenada,1998,sp,014,NA,0,NA
Grenada,1998,sp,1524,NA,1,NA
Grenada,1998,sp,2534,NA,0,NA
Grenada,1998,sp,3544,NA,1,NA
Grenada,1998,sp,4554,NA,0,NA
Grenada,1998,sp,5564,NA,0,NA
Grenada,1998,sp,65,NA,0,NA
Grenada,1999,sp,014,0,0,0
Grenada,1999,sp,1524,0,0,0
Grenada,1999,sp,2534,0,1,1
Grenada,1999,sp,3544,0,0,0
Grenada,1999,sp,4554,0,0,0
Grenada,1999,sp,5564,0,1,1
Grenada,1999,sp,65,1,0,1
Grenada,2003,sp,4554,NA,1,NA
Grenada,2003,sp,5564,1,NA,NA
Grenada,2004,sp,65,1,NA,NA
Grenada,2006,ep,014,0,0,0
Grenada,2006,ep,1524,0,0,0
Grenada,2006,ep,2534,0,0,0
Grenada,2006,ep,3544,0,0,0
Grenada,2006,ep,4554,0,0,0
Grenada,2006,ep,5564,0,0,0
Grenada,2006,ep,65,0,0,0
Grenada,2006,sn,014,0,0,0
Grenada,2006,sn,1524,0,0,0
Grenada,2006,sn,2534,0,0,0
Grenada,2006,sn,3544,0,0,0
Grenada,2006,sn,4554,0,0,0
Grenada,2006,sn,5564,0,0,0
Grenada,2006,sn,65,0,0,0
Grenada,2006,sp,014,0,0,0
Grenada,2006,sp,1524,0,0,0
Grenada,2006,sp,2534,0,1,1
Grenada,2006,sp,3544,0,0,0
Grenada,2006,sp,4554,0,0,0
Grenada,2006,sp,5564,0,0,0
Grenada,2006,sp,65,0,0,0
Grenada,2007,ep,014,0,0,0
Grenada,2007,ep,1524,0,0,0
Grenada,2007,ep,2534,0,0,0
Grenada,2007,ep,3544,0,0,0
Grenada,2007,ep,4554,0,0,0
Grenada,2007,ep,5564,0,0,0
Grenada,2007,ep,65,0,0,0
Grenada,2007,sn,014,0,0,0
Grenada,2007,sn,1524,0,0,0
Grenada,2007,sn,2534,0,0,0
Grenada,2007,sn,3544,0,0,0
Grenada,2007,sn,4554,0,0,0
Grenada,2007,sn,5564,0,0,0
Grenada,2007,sn,65,0,0,0
Grenada,2007,sp,1524,1,NA,NA
Grenada,2007,sp,5564,NA,1,NA
Grenada,2007,sp,65,NA,1,NA
Grenada,2008,ep,014,0,0,0
Grenada,2008,ep,1524,0,0,0
Grenada,2008,ep,2534,0,0,0
Grenada,2008,ep,3544,0,0,0
Grenada,2008,ep,4554,0,0,0
Grenada,2008,ep,5564,0,0,0
Grenada,2008,ep,65,0,0,0
Grenada,2008,sn,014,0,0,0
Grenada,2008,sn,1524,0,0,0
Grenada,2008,sn,2534,0,0,0
Grenada,2008,sn,3544,0,0,0
Grenada,2008,sn,4554,0,0,0
Grenada,2008,sn,5564,0,0,0
Grenada,2008,sn,65,0,0,0
Grenada,2008,sp,1524,NA,1,NA
Grenada,2008,sp,3544,NA,1,NA
Grenada,2008,sp,4554,NA,2,NA
Grenada,2008,sp,65,NA,1,NA
Grenada,2009,sn,4554,NA,1,NA
Grenada,2009,sp,2534,1,NA,NA
Grenada,2009,sp,3544,NA,1,NA
Grenada,2009,sp,5564,1,1,2
Grenada,2010,sp,2534,1,NA,NA
Grenada,2010,sp,3544,NA,1,NA
Grenada,2010,sp,4554,NA,1,NA
Grenada,2010,sp,5564,NA,1,NA
Grenada,2011,ep,014,0,0,0
Grenada,2011,ep,1524,0,0,0
Grenada,2011,ep,2534,0,0,0
Grenada,2011,ep,3544,0,0,0
Grenada,2011,ep,4554,0,0,0
Grenada,2011,ep,5564,0,0,0
Grenada,2011,ep,65,0,0,0
Grenada,2011,sn,014,0,0,0
Grenada,2011,sn,1524,0,0,0
Grenada,2011,sn,2534,0,0,0
Grenada,2011,sn,3544,0,0,0
Grenada,2011,sn,4554,1,0,1
Grenada,2011,sn,5564,0,0,0
Grenada,2011,sn,65,0,0,0
Grenada,2011,sp,014,0,0,0
Grenada,2011,sp,1524,0,0,0
Grenada,2011,sp,2534,0,0,0
Grenada,2011,sp,3544,0,0,0
Grenada,2011,sp,4554,0,1,1
Grenada,2011,sp,5564,0,0,0
Grenada,2011,sp,65,0,0,0
Grenada,2012,sp,65,NA,1,NA
Grenada,2013,rel,5564,NA,1,NA
Guam,2000,sp,014,0,2,2
Guam,2000,sp,1524,3,1,4
Guam,2000,sp,2534,1,6,7
Guam,2000,sp,3544,2,6,8
Guam,2000,sp,4554,5,9,14
Guam,2000,sp,5564,2,6,8
Guam,2000,sp,65,2,9,11
Guam,2001,sp,014,0,0,0
Guam,2001,sp,1524,2,1,3
Guam,2001,sp,2534,3,4,7
Guam,2001,sp,3544,3,10,13
Guam,2001,sp,4554,4,9,13
Guam,2001,sp,5564,2,3,5
Guam,2001,sp,65,1,6,7
Guam,2002,sp,014,5,3,8
Guam,2002,sp,1524,1,3,4
Guam,2002,sp,2534,6,5,11
Guam,2002,sp,3544,3,5,8
Guam,2002,sp,4554,3,6,9
Guam,2002,sp,5564,2,12,14
Guam,2002,sp,65,7,4,11
Guam,2003,sp,014,1,0,1
Guam,2003,sp,1524,3,2,5
Guam,2003,sp,2534,1,1,2
Guam,2003,sp,3544,4,3,7
Guam,2003,sp,4554,2,4,6
Guam,2003,sp,5564,1,7,8
Guam,2003,sp,65,5,5,10
Guam,2004,sp,014,0,0,0
Guam,2004,sp,1524,0,0,0
Guam,2004,sp,2534,1,1,2
Guam,2004,sp,3544,2,2,4
Guam,2004,sp,4554,3,6,9
Guam,2004,sp,5564,1,2,3
Guam,2004,sp,65,1,3,4
Guam,2005,sp,014,0,0,0
Guam,2005,sp,1524,3,2,5
Guam,2005,sp,2534,1,4,5
Guam,2005,sp,3544,1,4,5
Guam,2005,sp,4554,2,2,4
Guam,2005,sp,5564,0,2,2
Guam,2005,sp,65,2,4,6
Guam,2006,ep,014,0,0,0
Guam,2006,ep,1524,2,0,2
Guam,2006,ep,2534,2,0,2
Guam,2006,ep,3544,1,0,1
Guam,2006,ep,4554,1,1,2
Guam,2006,ep,5564,0,1,1
Guam,2006,ep,65,0,0,0
Guam,2006,sn,014,7,3,10
Guam,2006,sn,1524,1,0,1
Guam,2006,sn,2534,0,2,2
Guam,2006,sn,3544,0,0,0
Guam,2006,sn,4554,0,0,0
Guam,2006,sn,5564,0,1,1
Guam,2006,sn,65,1,0,1
Guam,2006,sp,014,0,0,0
Guam,2006,sp,1524,0,1,1
Guam,2006,sp,2534,0,1,1
Guam,2006,sp,3544,1,2,3
Guam,2006,sp,4554,1,3,4
Guam,2006,sp,5564,2,2,4
Guam,2006,sp,65,2,6,8
Guam,2007,ep,014,1,0,1
Guam,2007,ep,1524,0,0,0
Guam,2007,ep,2534,1,1,2
Guam,2007,ep,3544,0,0,0
Guam,2007,ep,4554,1,0,1
Guam,2007,ep,5564,0,0,0
Guam,2007,ep,65,0,0,0
Guam,2007,sn,014,16,13,29
Guam,2007,sn,1524,2,2,4
Guam,2007,sn,2534,2,0,2
Guam,2007,sn,3544,0,1,1
Guam,2007,sn,4554,0,4,4
Guam,2007,sn,5564,1,0,1
Guam,2007,sn,65,1,1,2
Guam,2007,sp,014,0,0,0
Guam,2007,sp,1524,0,0,0
Guam,2007,sp,2534,0,0,0
Guam,2007,sp,3544,0,2,2
Guam,2007,sp,4554,1,0,1
Guam,2007,sp,5564,1,0,1
Guam,2007,sp,65,1,0,1
Guam,2008,ep,014,0,0,0
Guam,2008,ep,1524,1,1,2
Guam,2008,ep,2534,1,0,1
Guam,2008,ep,3544,0,0,0
Guam,2008,ep,4554,0,0,0
Guam,2008,ep,5564,3,1,4
Guam,2008,ep,65,0,1,1
Guam,2008,sn,014,13,12,25
Guam,2008,sn,1524,2,1,3
Guam,2008,sn,2534,0,0,0
Guam,2008,sn,3544,2,4,6
Guam,2008,sn,4554,2,1,3
Guam,2008,sn,5564,1,4,5
Guam,2008,sn,65,2,6,8
Guam,2008,sp,014,0,0,0
Guam,2008,sp,1524,1,0,1
Guam,2008,sp,2534,2,1,3
Guam,2008,sp,3544,0,7,7
Guam,2008,sp,4554,1,8,9
Guam,2008,sp,5564,1,3,4
Guam,2008,sp,65,3,4,7
Guam,2009,ep,014,0,1,1
Guam,2009,ep,1524,0,1,1
Guam,2009,ep,2534,2,0,2
Guam,2009,ep,3544,1,0,1
Guam,2009,ep,4554,1,2,3
Guam,2009,ep,5564,1,0,1
Guam,2009,ep,65,1,0,1
Guam,2009,sn,014,13,13,26
Guam,2009,sn,1524,2,4,6
Guam,2009,sn,2534,2,3,5
Guam,2009,sn,3544,0,3,3
Guam,2009,sn,4554,3,5,8
Guam,2009,sn,5564,1,6,7
Guam,2009,sn,65,0,5,5
Guam,2009,sp,014,1,0,1
Guam,2009,sp,1524,1,1,2
Guam,2009,sp,2534,3,0,3
Guam,2009,sp,3544,1,5,6
Guam,2009,sp,4554,1,3,4
Guam,2009,sp,5564,2,9,11
Guam,2009,sp,65,0,4,4
Guam,2010,ep,014,0,0,0
Guam,2010,ep,1524,3,0,3
Guam,2010,ep,2534,0,1,1
Guam,2010,ep,3544,1,0,1
Guam,2010,ep,4554,1,1,2
Guam,2010,ep,5564,0,0,0
Guam,2010,ep,65,1,1,2
Guam,2010,sn,014,9,9,18
Guam,2010,sn,1524,1,0,1
Guam,2010,sn,2534,3,3,6
Guam,2010,sn,3544,5,7,12
Guam,2010,sn,4554,2,1,3
Guam,2010,sn,5564,4,5,9
Guam,2010,sn,65,0,2,2
Guam,2010,sp,014,1,0,1
Guam,2010,sp,1524,0,2,2
Guam,2010,sp,2534,4,3,7
Guam,2010,sp,3544,3,5,8
Guam,2010,sp,4554,3,5,8
Guam,2010,sp,5564,0,7,7
Guam,2010,sp,65,3,3,6
Guam,2011,ep,014,0,0,0
Guam,2011,ep,1524,1,2,3
Guam,2011,ep,2534,0,0,0
Guam,2011,ep,3544,0,0,0
Guam,2011,ep,4554,0,2,2
Guam,2011,ep,5564,3,0,3
Guam,2011,ep,65,0,3,3
Guam,2011,sn,014,7,5,12
Guam,2011,sn,1524,1,0,1
Guam,2011,sn,2534,3,4,7
Guam,2011,sn,3544,1,1,2
Guam,2011,sn,4554,3,5,8
Guam,2011,sn,5564,1,1,2
Guam,2011,sn,65,3,4,7
Guam,2011,sp,014,0,0,0
Guam,2011,sp,1524,1,1,2
Guam,2011,sp,2534,1,0,1
Guam,2011,sp,3544,1,2,3
Guam,2011,sp,4554,0,7,7
Guam,2011,sp,5564,3,4,7
Guam,2011,sp,65,4,4,8
Guam,2012,ep,014,0,0,0
Guam,2012,ep,1524,0,1,1
Guam,2012,ep,2534,0,0,0
Guam,2012,ep,3544,1,1,2
Guam,2012,ep,4554,0,3,3
Guam,2012,ep,5564,0,0,0
Guam,2012,ep,65,1,1,2
Guam,2012,sn,014,10,5,15
Guam,2012,sn,1524,0,4,4
Guam,2012,sn,2534,1,2,3
Guam,2012,sn,3544,1,0,1
Guam,2012,sn,4554,5,1,6
Guam,2012,sn,5564,4,0,4
Guam,2012,sn,65,3,1,4
Guam,2012,sp,014,0,0,0
Guam,2012,sp,1524,0,1,1
Guam,2012,sp,2534,0,0,0
Guam,2012,sp,3544,0,4,4
Guam,2012,sp,4554,2,5,7
Guam,2012,sp,5564,1,2,3
Guam,2012,sp,65,2,6,8
Guam,2013,rel,014,6,5,11
Guam,2013,rel,1524,2,3,5
Guam,2013,rel,2534,2,1,3
Guam,2013,rel,3544,5,2,7
Guam,2013,rel,4554,2,5,7
Guam,2013,rel,5564,2,0,2
Guam,2013,rel,65,3,10,13
Guatemala,1995,sp,014,51,51,102
Guatemala,1995,sp,1524,224,235,459
Guatemala,1995,sp,2534,255,280,535
Guatemala,1995,sp,3544,221,236,457
Guatemala,1995,sp,4554,146,165,311
Guatemala,1995,sp,5564,129,142,271
Guatemala,1995,sp,65,94,139,233
Guatemala,1996,sp,014,48,75,123
Guatemala,1996,sp,1524,214,230,444
Guatemala,1996,sp,2534,250,230,480
Guatemala,1996,sp,3544,212,218,430
Guatemala,1996,sp,4554,172,152,324
Guatemala,1996,sp,5564,134,132,266
Guatemala,1996,sp,65,99,142,241
Guatemala,1997,sp,014,33,45,78
Guatemala,1997,sp,1524,228,246,474
Guatemala,1997,sp,2534,225,217,442
Guatemala,1997,sp,3544,183,229,412
Guatemala,1997,sp,4554,120,161,281
Guatemala,1997,sp,5564,109,155,264
Guatemala,1997,sp,65,117,150,267
Guatemala,1998,sp,014,45,60,105
Guatemala,1998,sp,1524,203,206,409
Guatemala,1998,sp,2534,216,248,464
Guatemala,1998,sp,3544,199,234,433
Guatemala,1998,sp,4554,160,163,323
Guatemala,1998,sp,5564,118,148,266
Guatemala,1998,sp,65,103,152,255
Guatemala,1999,sp,014,24,34,58
Guatemala,1999,sp,1524,229,216,445
Guatemala,1999,sp,2534,230,248,478
Guatemala,1999,sp,3544,194,235,429
Guatemala,1999,sp,4554,174,171,345
Guatemala,1999,sp,5564,121,141,262
Guatemala,1999,sp,65,89,158,247
Guatemala,2000,sp,014,41,36,77
Guatemala,2000,sp,1524,199,220,419
Guatemala,2000,sp,2534,167,236,403
Guatemala,2000,sp,3544,175,216,391
Guatemala,2000,sp,4554,135,177,312
Guatemala,2000,sp,5564,87,112,199
Guatemala,2000,sp,65,111,140,251
Guatemala,2001,sp,014,33,27,60
Guatemala,2001,sp,1524,180,171,351
Guatemala,2001,sp,2534,173,201,374
Guatemala,2001,sp,3544,118,169,287
Guatemala,2001,sp,4554,101,137,238
Guatemala,2001,sp,5564,74,98,172
Guatemala,2001,sp,65,90,97,187
Guatemala,2002,sp,014,42,27,69
Guatemala,2002,sp,1524,192,217,409
Guatemala,2002,sp,2534,171,219,390
Guatemala,2002,sp,3544,147,171,318
Guatemala,2002,sp,4554,116,158,274
Guatemala,2002,sp,5564,68,117,185
Guatemala,2002,sp,65,74,146,220
Guatemala,2003,sp,014,24,29,53
Guatemala,2003,sp,1524,186,175,361
Guatemala,2003,sp,2534,179,200,379
Guatemala,2003,sp,3544,157,169,326
Guatemala,2003,sp,4554,104,156,260
Guatemala,2003,sp,5564,88,125,213
Guatemala,2003,sp,65,75,128,203
Guatemala,2004,sp,014,31,43,74
Guatemala,2004,sp,1524,278,282,560
Guatemala,2004,sp,2534,201,291,492
Guatemala,2004,sp,3544,227,209,436
Guatemala,2004,sp,4554,144,210,354
Guatemala,2004,sp,5564,72,144,216
Guatemala,2004,sp,65,78,129,207
Guatemala,2005,sp,014,38,39,77
Guatemala,2005,sp,1524,339,251,590
Guatemala,2005,sp,2534,245,258,503
Guatemala,2005,sp,3544,277,185,462
Guatemala,2005,sp,4554,176,187,363
Guatemala,2005,sp,5564,88,127,215
Guatemala,2005,sp,65,95,115,210
Guatemala,2007,ep,014,17,24,41
Guatemala,2007,ep,1524,16,21,37
Guatemala,2007,ep,2534,27,23,50
Guatemala,2007,ep,3544,26,28,54
Guatemala,2007,ep,4554,22,16,38
Guatemala,2007,ep,5564,17,15,32
Guatemala,2007,ep,65,14,16,30
Guatemala,2007,sn,014,27,17,44
Guatemala,2007,sn,1524,51,35,86
Guatemala,2007,sn,2534,44,37,81
Guatemala,2007,sn,3544,40,35,75
Guatemala,2007,sn,4554,22,17,39
Guatemala,2007,sn,5564,13,10,23
Guatemala,2007,sn,65,7,21,28
Guatemala,2007,sp,014,183,74,257
Guatemala,2007,sp,1524,163,169,332
Guatemala,2007,sp,2534,246,207,453
Guatemala,2007,sp,3544,145,226,371
Guatemala,2007,sp,4554,153,203,356
Guatemala,2007,sp,5564,143,159,302
Guatemala,2007,sp,65,122,155,277
Guatemala,2008,ep,014,16,16,32
Guatemala,2008,ep,1524,28,23,51
Guatemala,2008,ep,2534,33,55,88
Guatemala,2008,ep,3544,27,36,63
Guatemala,2008,ep,4554,25,31,56
Guatemala,2008,ep,5564,16,16,32
Guatemala,2008,ep,65,13,11,24
Guatemala,2008,sn,014,19,19,38
Guatemala,2008,sn,1524,20,24,44
Guatemala,2008,sn,2534,29,29,58
Guatemala,2008,sn,3544,36,34,70
Guatemala,2008,sn,4554,21,22,43
Guatemala,2008,sn,5564,19,17,36
Guatemala,2008,sn,65,15,22,37
Guatemala,2008,sp,014,22,19,41
Guatemala,2008,sp,1524,199,220,419
Guatemala,2008,sp,2534,189,257,446
Guatemala,2008,sp,3544,162,193,355
Guatemala,2008,sp,4554,154,163,317
Guatemala,2008,sp,5564,100,124,224
Guatemala,2008,sp,65,101,167,268
Guatemala,2009,ep,014,16,13,29
Guatemala,2009,ep,1524,148,144,292
Guatemala,2009,ep,2534,149,168,317
Guatemala,2009,ep,3544,99,117,216
Guatemala,2009,ep,4554,107,122,229
Guatemala,2009,ep,5564,73,91,164
Guatemala,2009,ep,65,66,88,154
Guatemala,2009,sp,014,116,121,237
Guatemala,2009,sp,1524,148,144,292
Guatemala,2009,sp,2534,149,168,317
Guatemala,2009,sp,3544,99,117,216
Guatemala,2009,sp,4554,107,122,229
Guatemala,2009,sp,5564,73,91,164
Guatemala,2009,sp,65,66,88,154
Guatemala,2010,sp,014,29,60,89
Guatemala,2010,sp,1524,194,187,381
Guatemala,2010,sp,2534,190,245,435
Guatemala,2010,sp,3544,179,207,386
Guatemala,2010,sp,4554,139,172,311
Guatemala,2010,sp,5564,108,143,251
Guatemala,2010,sp,65,103,165,268
Guatemala,2011,sp,014,25,18,43
Guatemala,2011,sp,1524,186,197,383
Guatemala,2011,sp,2534,192,205,397
Guatemala,2011,sp,3544,154,172,326
Guatemala,2011,sp,4554,154,162,316
Guatemala,2011,sp,5564,102,136,238
Guatemala,2011,sp,65,106,152,258
Guatemala,2013,rel,014,25,16,41
Guatemala,2013,rel,1524,197,239,436
Guatemala,2013,rel,2534,208,248,456
Guatemala,2013,rel,3544,167,212,379
Guatemala,2013,rel,4554,154,207,361
Guatemala,2013,rel,5564,106,155,261
Guatemala,2013,rel,65,98,164,262
Guinea,1995,sp,014,28,18,46
Guinea,1995,sp,1524,202,244,446
Guinea,1995,sp,2534,255,538,793
Guinea,1995,sp,3544,153,357,510
Guinea,1995,sp,4554,64,189,253
Guinea,1995,sp,5564,37,98,135
Guinea,1995,sp,65,19,61,80
Guinea,1996,sp,014,30,29,59
Guinea,1996,sp,1524,223,319,542
Guinea,1996,sp,2534,338,631,969
Guinea,1996,sp,3544,213,416,629
Guinea,1996,sp,4554,111,214,325
Guinea,1996,sp,5564,52,133,185
Guinea,1996,sp,65,31,104,135
Guinea,1997,sp,014,38,25,63
Guinea,1997,sp,1524,246,326,572
Guinea,1997,sp,2534,383,653,1036
Guinea,1997,sp,3544,189,483,672
Guinea,1997,sp,4554,91,220,311
Guinea,1997,sp,5564,48,147,195
Guinea,1997,sp,65,32,100,132
Guinea,1998,sp,014,37,22,59
Guinea,1998,sp,1524,303,409,712
Guinea,1998,sp,2534,365,763,1128
Guinea,1998,sp,3544,202,494,696
Guinea,1998,sp,4554,115,271,386
Guinea,1998,sp,5564,71,168,239
Guinea,1998,sp,65,25,117,142
Guinea,1999,sp,014,44,30,74
Guinea,1999,sp,1524,345,434,779
Guinea,1999,sp,2534,395,736,1131
Guinea,1999,sp,3544,259,519,778
Guinea,1999,sp,4554,110,294,404
Guinea,1999,sp,5564,78,173,251
Guinea,1999,sp,65,41,104,145
Guinea,2000,sp,014,66,39,105
Guinea,2000,sp,1524,314,551,865
Guinea,2000,sp,2534,446,860,1306
Guinea,2000,sp,3544,245,570,815
Guinea,2000,sp,4554,114,282,396
Guinea,2000,sp,5564,82,203,285
Guinea,2000,sp,65,45,103,148
Guinea,2001,sp,014,59,24,83
Guinea,2001,sp,1524,419,506,925
Guinea,2001,sp,2534,433,876,1309
Guinea,2001,sp,3544,249,612,861
Guinea,2001,sp,4554,127,325,452
Guinea,2001,sp,5564,77,185,262
Guinea,2001,sp,65,46,154,200
Guinea,2002,sp,014,42,24,66
Guinea,2002,sp,1524,399,413,812
Guinea,2002,sp,2534,439,958,1397
Guinea,2002,sp,3544,259,634,893
Guinea,2002,sp,4554,109,336,445
Guinea,2002,sp,5564,77,139,216
Guinea,2002,sp,65,50,149,199
Guinea,2003,sp,014,53,34,87
Guinea,2003,sp,1524,353,617,970
Guinea,2003,sp,2534,451,1052,1503
Guinea,2003,sp,3544,307,671,978
Guinea,2003,sp,4554,137,368,505
Guinea,2003,sp,5564,106,172,278
Guinea,2003,sp,65,40,134,174
Guinea,2004,sp,014,62,38,100
Guinea,2004,sp,1524,470,728,1198
Guinea,2004,sp,2534,521,1091,1612
Guinea,2004,sp,3544,334,726,1060
Guinea,2004,sp,4554,159,389,548
Guinea,2004,sp,5564,100,199,299
Guinea,2004,sp,65,63,135,198
Guinea,2005,sp,014,65,51,116
Guinea,2005,sp,1524,594,749,1343
Guinea,2005,sp,2534,583,1165,1748
Guinea,2005,sp,3544,354,778,1132
Guinea,2005,sp,4554,203,463,666
Guinea,2005,sp,5564,94,195,289
Guinea,2005,sp,65,55,130,185
Guinea,2006,sp,014,85,31,116
Guinea,2006,sp,1524,586,834,1420
Guinea,2006,sp,2534,581,1168,1749
Guinea,2006,sp,3544,396,916,1312
Guinea,2006,sp,4554,187,512,699
Guinea,2006,sp,5564,118,274,392
Guinea,2006,sp,65,53,162,215
Guinea,2007,sp,014,76,46,122
Guinea,2007,sp,1524,631,901,1532
Guinea,2007,sp,2534,613,1315,1928
Guinea,2007,sp,3544,367,936,1303
Guinea,2007,sp,4554,207,503,710
Guinea,2007,sp,5564,106,240,346
Guinea,2007,sp,65,79,204,283
Guinea,2008,sp,014,64,56,120
Guinea,2008,sp,1524,610,970,1580
Guinea,2008,sp,2534,686,1419,2105
Guinea,2008,sp,3544,377,985,1362
Guinea,2008,sp,4554,190,561,751
Guinea,2008,sp,5564,93,264,357
Guinea,2008,sp,65,88,198,286
Guinea,2009,sp,014,68,65,133
Guinea,2009,sp,1524,549,746,1295
Guinea,2009,sp,2534,644,1064,1708
Guinea,2009,sp,3544,429,655,1084
Guinea,2009,sp,4554,225,376,601
Guinea,2009,sp,5564,132,208,340
Guinea,2009,sp,65,66,150,216
Guinea,2010,sp,014,51,61,112
Guinea,2010,sp,1524,549,679,1228
Guinea,2010,sp,2534,739,877,1616
Guinea,2010,sp,3544,751,982,1733
Guinea,2010,sp,4554,405,876,1281
Guinea,2010,sp,5564,145,565,710
Guinea,2010,sp,65,72,289,361
Guinea,2011,ep,014,0,14,14
Guinea,2011,ep,1524,109,343,452
Guinea,2011,ep,2534,241,458,699
Guinea,2011,ep,3544,278,176,454
Guinea,2011,ep,4554,169,201,370
Guinea,2011,ep,5564,112,96,208
Guinea,2011,ep,65,67,20,87
Guinea,2011,sn,014,27,79,106
Guinea,2011,sn,1524,67,207,274
Guinea,2011,sn,2534,180,156,336
Guinea,2011,sn,3544,102,177,279
Guinea,2011,sn,4554,100,134,234
Guinea,2011,sn,5564,67,65,132
Guinea,2011,sn,65,33,52,85
Guinea,2011,sp,014,85,45,130
Guinea,2011,sp,1524,709,1051,1760
Guinea,2011,sp,2534,688,1537,2225
Guinea,2011,sp,3544,432,955,1387
Guinea,2011,sp,4554,219,541,760
Guinea,2011,sp,5564,109,293,402
Guinea,2011,sp,65,73,197,270
Guinea,2012,sp,014,49,28,77
Guinea,2012,sp,1524,505,761,1266
Guinea,2012,sp,2534,509,1104,1613
Guinea,2012,sp,3544,323,791,1114
Guinea,2012,sp,4554,134,383,517
Guinea,2012,sp,5564,61,190,251
Guinea,2012,sp,65,57,120,177
Guinea,2013,rel,014,78,107,185
Guinea,2013,rel,1524,987,1269,2256
Guinea,2013,rel,2534,1056,1690,2746
Guinea,2013,rel,3544,998,1887,2885
Guinea,2013,rel,4554,693,1031,1724
Guinea,2013,rel,5564,214,642,856
Guinea,2013,rel,65,187,474,661
Guinea-Bissau,1996,sp,014,7,9,16
Guinea-Bissau,1996,sp,1524,49,110,159
Guinea-Bissau,1996,sp,2534,80,159,239
Guinea-Bissau,1996,sp,3544,94,113,207
Guinea-Bissau,1996,sp,4554,62,99,161
Guinea-Bissau,1996,sp,5564,31,60,91
Guinea-Bissau,1996,sp,65,13,36,49
Guinea-Bissau,2000,sp,014,4,2,6
Guinea-Bissau,2000,sp,1524,30,52,82
Guinea-Bissau,2000,sp,2534,46,92,138
Guinea-Bissau,2000,sp,3544,47,80,127
Guinea-Bissau,2000,sp,4554,24,64,88
Guinea-Bissau,2000,sp,5564,15,39,54
Guinea-Bissau,2000,sp,65,12,19,31
Guinea-Bissau,2002,sp,014,9,7,16
Guinea-Bissau,2002,sp,1524,80,101,181
Guinea-Bissau,2002,sp,2534,108,146,254
Guinea-Bissau,2002,sp,3544,66,128,194
Guinea-Bissau,2002,sp,4554,49,70,119
Guinea-Bissau,2002,sp,5564,37,52,89
Guinea-Bissau,2002,sp,65,12,34,46
Guinea-Bissau,2003,sp,014,7,9,16
Guinea-Bissau,2003,sp,1524,97,101,198
Guinea-Bissau,2003,sp,2534,82,153,235
Guinea-Bissau,2003,sp,3544,78,118,196
Guinea-Bissau,2003,sp,4554,58,108,166
Guinea-Bissau,2003,sp,5564,38,63,101
Guinea-Bissau,2003,sp,65,24,27,51
Guinea-Bissau,2004,sp,014,11,16,27
Guinea-Bissau,2004,sp,1524,87,86,173
Guinea-Bissau,2004,sp,2534,115,175,290
Guinea-Bissau,2004,sp,3544,103,147,250
Guinea-Bissau,2004,sp,4554,98,130,228
Guinea-Bissau,2004,sp,5564,54,84,138
Guinea-Bissau,2004,sp,65,29,51,80
Guinea-Bissau,2005,sp,014,13,14,27
Guinea-Bissau,2005,sp,1524,78,116,194
Guinea-Bissau,2005,sp,2534,110,167,277
Guinea-Bissau,2005,sp,3544,92,153,245
Guinea-Bissau,2005,sp,4554,82,130,212
Guinea-Bissau,2005,sp,5564,44,72,116
Guinea-Bissau,2005,sp,65,19,42,61
Guinea-Bissau,2006,ep,014,6,13,19
Guinea-Bissau,2006,sn,014,401,554,955
Guinea-Bissau,2006,sp,014,7,8,15
Guinea-Bissau,2006,sp,1524,82,86,168
Guinea-Bissau,2006,sp,2534,116,178,294
Guinea-Bissau,2006,sp,3544,90,143,233
Guinea-Bissau,2006,sp,4554,81,90,171
Guinea-Bissau,2006,sp,5564,36,74,110
Guinea-Bissau,2006,sp,65,15,24,39
Guinea-Bissau,2008,sp,014,12,8,20
Guinea-Bissau,2008,sp,1524,85,119,204
Guinea-Bissau,2008,sp,2534,129,194,323
Guinea-Bissau,2008,sp,3544,123,191,314
Guinea-Bissau,2008,sp,4554,92,109,201
Guinea-Bissau,2008,sp,5564,41,79,120
Guinea-Bissau,2008,sp,65,11,30,41
Guinea-Bissau,2009,sp,014,5,8,13
Guinea-Bissau,2009,sp,1524,88,124,212
Guinea-Bissau,2009,sp,2534,149,230,379
Guinea-Bissau,2009,sp,3544,119,172,291
Guinea-Bissau,2009,sp,4554,92,138,230
Guinea-Bissau,2009,sp,5564,47,82,129
Guinea-Bissau,2009,sp,65,18,38,56
Guinea-Bissau,2010,sp,014,30,18,48
Guinea-Bissau,2010,sp,1524,100,164,264
Guinea-Bissau,2010,sp,2534,161,219,380
Guinea-Bissau,2010,sp,3544,133,183,316
Guinea-Bissau,2010,sp,4554,80,141,221
Guinea-Bissau,2010,sp,5564,38,80,118
Guinea-Bissau,2010,sp,65,19,43,62
Guinea-Bissau,2011,ep,014,10,17,27
Guinea-Bissau,2011,ep,1524,4,6,10
Guinea-Bissau,2011,ep,2534,3,4,7
Guinea-Bissau,2011,ep,3544,2,5,7
Guinea-Bissau,2011,ep,4554,2,6,8
Guinea-Bissau,2011,ep,5564,0,0,0
Guinea-Bissau,2011,ep,65,1,2,3
Guinea-Bissau,2011,sn,014,30,34,64
Guinea-Bissau,2011,sn,1524,40,43,83
Guinea-Bissau,2011,sn,2534,69,77,146
Guinea-Bissau,2011,sn,3544,57,81,138
Guinea-Bissau,2011,sn,4554,29,57,86
Guinea-Bissau,2011,sn,5564,16,32,48
Guinea-Bissau,2011,sn,65,11,17,28
Guinea-Bissau,2011,sp,014,12,6,18
Guinea-Bissau,2011,sp,1524,119,140,259
Guinea-Bissau,2011,sp,2534,122,230,352
Guinea-Bissau,2011,sp,3544,90,181,271
Guinea-Bissau,2011,sp,4554,56,104,160
Guinea-Bissau,2011,sp,5564,44,65,109
Guinea-Bissau,2011,sp,65,25,36,61
Guinea-Bissau,2012,ep,014,2,6,8
Guinea-Bissau,2012,ep,1524,2,6,8
Guinea-Bissau,2012,ep,2534,4,5,9
Guinea-Bissau,2012,ep,3544,4,4,8
Guinea-Bissau,2012,ep,4554,0,4,4
Guinea-Bissau,2012,ep,5564,1,2,3
Guinea-Bissau,2012,ep,65,0,0,0
Guinea-Bissau,2012,sn,014,29,41,70
Guinea-Bissau,2012,sn,1524,26,26,52
Guinea-Bissau,2012,sn,2534,44,61,105
Guinea-Bissau,2012,sn,3544,38,62,100
Guinea-Bissau,2012,sn,4554,39,40,79
Guinea-Bissau,2012,sn,5564,33,37,70
Guinea-Bissau,2012,sn,65,9,12,21
Guinea-Bissau,2012,sp,014,7,7,14
Guinea-Bissau,2012,sp,1524,121,145,266
Guinea-Bissau,2012,sp,2534,157,262,419
Guinea-Bissau,2012,sp,3544,98,183,281
Guinea-Bissau,2012,sp,4554,56,115,171
Guinea-Bissau,2012,sp,5564,33,63,96
Guinea-Bissau,2012,sp,65,25,38,63
Guinea-Bissau,2013,rel,014,36,60,96
Guinea-Bissau,2013,rel,1524,166,204,370
Guinea-Bissau,2013,rel,2534,275,387,662
Guinea-Bissau,2013,rel,3544,145,262,407
Guinea-Bissau,2013,rel,4554,80,169,249
Guinea-Bissau,2013,rel,5564,69,100,169
Guinea-Bissau,2013,rel,65,31,62,93
Guyana,1995,sp,014,3,7,10
Guyana,1995,sp,1524,5,8,13
Guyana,1995,sp,2534,7,5,12
Guyana,1995,sp,3544,6,6,12
Guyana,1995,sp,4554,5,9,14
Guyana,1995,sp,5564,2,6,8
Guyana,1995,sp,65,4,7,11
Guyana,1996,sp,014,4,4,8
Guyana,1996,sp,1524,8,8,16
Guyana,1996,sp,2534,4,14,18
Guyana,1996,sp,3544,4,4,8
Guyana,1996,sp,4554,5,5,10
Guyana,1996,sp,5564,0,4,4
Guyana,1996,sp,65,0,7,7
Guyana,1997,sp,014,3,1,4
Guyana,1997,sp,1524,9,15,24
Guyana,1997,sp,2534,8,19,27
Guyana,1997,sp,3544,8,12,20
Guyana,1997,sp,4554,4,2,6
Guyana,1997,sp,5564,7,5,12
Guyana,1997,sp,65,4,8,12
Guyana,1998,sp,014,13,9,22
Guyana,1998,sp,1524,32,29,61
Guyana,1998,sp,2534,38,56,94
Guyana,1998,sp,3544,26,42,68
Guyana,1998,sp,4554,4,36,40
Guyana,1998,sp,5564,8,2,10
Guyana,1998,sp,65,11,12,23
Guyana,2000,sp,014,1,4,5
Guyana,2000,sp,1524,11,20,31
Guyana,2000,sp,2534,8,19,27
Guyana,2000,sp,3544,7,14,21
Guyana,2000,sp,4554,5,7,12
Guyana,2000,sp,5564,5,6,11
Guyana,2000,sp,65,3,9,12
Guyana,2001,sp,014,0,1,1
Guyana,2001,sp,1524,6,15,21
Guyana,2001,sp,2534,16,47,63
Guyana,2001,sp,3544,16,44,60
Guyana,2001,sp,4554,9,12,21
Guyana,2001,sp,5564,3,2,5
Guyana,2001,sp,65,2,1,3
Guyana,2002,sp,014,26,20,46
Guyana,2002,sp,1524,32,49,81
Guyana,2002,sp,2534,36,90,126
Guyana,2002,sp,3544,34,94,128
Guyana,2002,sp,4554,19,51,70
Guyana,2002,sp,5564,15,19,34
Guyana,2002,sp,65,18,23,41
Guyana,2003,sp,014,12,10,22
Guyana,2003,sp,1524,35,56,91
Guyana,2003,sp,2534,61,111,172
Guyana,2003,sp,3544,56,114,170
Guyana,2003,sp,4554,27,58,85
Guyana,2003,sp,5564,10,27,37
Guyana,2003,sp,65,5,13,18
Guyana,2004,sp,014,15,9,24
Guyana,2004,sp,1524,35,45,80
Guyana,2004,sp,2534,38,113,151
Guyana,2004,sp,3544,29,97,126
Guyana,2004,sp,4554,23,87,110
Guyana,2004,sp,65,15,4,19
Guyana,2005,sp,014,14,12,26
Guyana,2005,sp,1524,41,48,89
Guyana,2005,sp,2534,62,130,192
Guyana,2005,sp,3544,41,116,157
Guyana,2005,sp,4554,30,81,111
Guyana,2005,sp,5564,11,41,52
Guyana,2005,sp,65,9,20,29
Guyana,2006,ep,014,3,4,7
Guyana,2006,ep,1524,1,1,2
Guyana,2006,ep,2534,NA,3,NA
Guyana,2006,ep,3544,3,2,5
Guyana,2006,ep,4554,1,1,2
Guyana,2006,sn,014,13,12,25
Guyana,2006,sn,1524,16,28,44
Guyana,2006,sn,2534,36,76,112
Guyana,2006,sn,3544,29,73,102
Guyana,2006,sn,4554,12,48,60
Guyana,2006,sn,5564,5,12,17
Guyana,2006,sn,65,20,13,33
Guyana,2006,sp,014,1,6,7
Guyana,2006,sp,1524,15,37,52
Guyana,2006,sp,2534,21,61,82
Guyana,2006,sp,3544,20,59,79
Guyana,2006,sp,4554,14,40,54
Guyana,2006,sp,5564,3,15,18
Guyana,2006,sp,65,1,5,6
Guyana,2007,ep,014,4,3,7
Guyana,2007,ep,1524,2,1,3
Guyana,2007,ep,2534,2,9,11
Guyana,2007,ep,3544,2,6,8
Guyana,2007,ep,4554,2,5,7
Guyana,2007,ep,5564,NA,5,NA
Guyana,2007,ep,65,1,1,2
Guyana,2007,sn,014,13,10,23
Guyana,2007,sn,1524,17,20,37
Guyana,2007,sn,2534,32,43,75
Guyana,2007,sn,3544,24,56,80
Guyana,2007,sn,4554,10,30,40
Guyana,2007,sn,5564,4,21,25
Guyana,2007,sn,65,8,13,21
Guyana,2007,sp,014,1,2,3
Guyana,2007,sp,1524,20,15,35
Guyana,2007,sp,2534,19,43,62
Guyana,2007,sp,3544,17,44,61
Guyana,2007,sp,4554,5,41,46
Guyana,2007,sp,5564,3,12,15
Guyana,2007,sp,65,3,8,11
Guyana,2008,ep,014,4,7,11
Guyana,2008,ep,1524,1,5,6
Guyana,2008,ep,2534,7,12,19
Guyana,2008,ep,3544,6,4,10
Guyana,2008,ep,4554,4,7,11
Guyana,2008,ep,5564,2,2,4
Guyana,2008,ep,65,0,0,0
Guyana,2008,sn,014,7,9,16
Guyana,2008,sn,1524,13,20,33
Guyana,2008,sn,2534,23,32,55
Guyana,2008,sn,3544,12,47,59
Guyana,2008,sn,4554,11,30,41
Guyana,2008,sn,5564,5,13,18
Guyana,2008,sn,65,6,14,20
Guyana,2008,sp,014,4,7,11
Guyana,2008,sp,1524,20,29,49
Guyana,2008,sp,2534,23,51,74
Guyana,2008,sp,3544,13,71,84
Guyana,2008,sp,4554,12,47,59
Guyana,2008,sp,5564,3,22,25
Guyana,2008,sp,65,7,11,18
Guyana,2009,ep,014,0,3,3
Guyana,2009,ep,1524,2,3,5
Guyana,2009,ep,2534,6,8,14
Guyana,2009,ep,3544,4,7,11
Guyana,2009,ep,4554,1,5,6
Guyana,2009,ep,5564,1,4,5
Guyana,2009,ep,65,0,2,2
Guyana,2009,sn,014,2,5,7
Guyana,2009,sn,1524,15,26,41
Guyana,2009,sn,2534,16,33,49
Guyana,2009,sn,3544,19,48,67
Guyana,2009,sn,4554,12,33,45
Guyana,2009,sn,5564,9,11,20
Guyana,2009,sn,65,8,15,23
Guyana,2009,sp,014,3,7,10
Guyana,2009,sp,1524,21,21,42
Guyana,2009,sp,2534,26,48,74
Guyana,2009,sp,3544,22,61,83
Guyana,2009,sp,4554,12,60,72
Guyana,2009,sp,5564,8,11,19
Guyana,2009,sp,65,8,20,28
Guyana,2010,ep,014,9,5,14
Guyana,2010,ep,1524,4,11,15
Guyana,2010,ep,2534,4,7,11
Guyana,2010,ep,3544,2,7,9
Guyana,2010,ep,4554,6,12,18
Guyana,2010,ep,5564,1,4,5
Guyana,2010,ep,65,2,1,3
Guyana,2010,sn,014,8,9,17
Guyana,2010,sn,1524,10,23,33
Guyana,2010,sn,2534,28,34,62
Guyana,2010,sn,3544,17,46,63
Guyana,2010,sn,4554,13,33,46
Guyana,2010,sn,5564,11,22,33
Guyana,2010,sn,65,9,11,20
Guyana,2010,sp,014,2,2,4
Guyana,2010,sp,1524,22,32,54
Guyana,2010,sp,2534,25,38,63
Guyana,2010,sp,3544,19,65,84
Guyana,2010,sp,4554,20,49,69
Guyana,2010,sp,5564,10,22,32
Guyana,2010,sp,65,6,13,19
Guyana,2011,ep,014,2,7,9
Guyana,2011,ep,1524,3,7,10
Guyana,2011,ep,2534,5,10,15
Guyana,2011,ep,3544,9,11,20
Guyana,2011,ep,4554,3,8,11
Guyana,2011,ep,5564,4,3,7
Guyana,2011,ep,65,6,0,6
Guyana,2011,sn,014,6,13,19
Guyana,2011,sn,1524,13,17,30
Guyana,2011,sn,2534,23,23,46
Guyana,2011,sn,3544,19,36,55
Guyana,2011,sn,4554,19,47,66
Guyana,2011,sn,5564,13,17,30
Guyana,2011,sn,65,6,30,36
Guyana,2011,sp,014,2,8,10
Guyana,2011,sp,1524,17,26,43
Guyana,2011,sp,2534,19,54,73
Guyana,2011,sp,3544,17,61,78
Guyana,2011,sp,4554,17,54,71
Guyana,2011,sp,5564,7,19,26
Guyana,2011,sp,65,9,13,22
Guyana,2012,ep,014,0,2,2
Guyana,2012,ep,1524,5,8,13
Guyana,2012,ep,2534,5,12,17
Guyana,2012,ep,3544,6,10,16
Guyana,2012,ep,4554,8,8,16
Guyana,2012,ep,5564,2,3,5
Guyana,2012,ep,65,2,6,8
Guyana,2012,sn,014,10,5,15
Guyana,2012,sn,1524,19,11,30
Guyana,2012,sn,2534,21,36,57
Guyana,2012,sn,3544,28,60,88
Guyana,2012,sn,4554,22,48,70
Guyana,2012,sn,5564,26,19,45
Guyana,2012,sn,65,15,19,34
Guyana,2012,sp,014,4,5,9
Guyana,2012,sp,1524,17,30,47
Guyana,2012,sp,2534,10,39,49
Guyana,2012,sp,3544,17,68,85
Guyana,2012,sp,4554,12,64,76
Guyana,2012,sp,5564,7,23,30
Guyana,2012,sp,65,5,8,13
Guyana,2013,rel,014,10,12,22
Guyana,2013,rel,1524,39,56,95
Guyana,2013,rel,2534,50,82,132
Guyana,2013,rel,3544,42,109,151
Guyana,2013,rel,4554,39,112,151
Guyana,2013,rel,5564,19,52,71
Guyana,2013,rel,65,26,31,57
Haiti,1996,sp,014,224,148,372
Haiti,1996,sp,1524,417,358,775
Haiti,1996,sp,2534,492,438,930
Haiti,1996,sp,3544,303,289,592
Haiti,1996,sp,4554,176,160,336
Haiti,1996,sp,5564,62,87,149
Haiti,1996,sp,65,100,97,197
Haiti,1997,sp,014,149,156,305
Haiti,1997,sp,1524,760,683,1443
Haiti,1997,sp,2534,878,817,1695
Haiti,1997,sp,3544,515,453,968
Haiti,1997,sp,4554,250,260,510
Haiti,1997,sp,5564,119,150,269
Haiti,1997,sp,65,97,162,259
Haiti,1998,sp,014,208,188,396
Haiti,1998,sp,1524,827,804,1631
Haiti,1998,sp,2534,958,971,1929
Haiti,1998,sp,3544,620,656,1276
Haiti,1998,sp,4554,300,331,631
Haiti,1998,sp,5564,141,177,318
Haiti,1998,sp,65,119,142,261
Haiti,1999,sp,014,285,286,571
Haiti,1999,sp,1524,919,812,1731
Haiti,1999,sp,2534,918,1059,1977
Haiti,1999,sp,3544,614,672,1286
Haiti,1999,sp,4554,312,348,660
Haiti,1999,sp,5564,162,186,348
Haiti,1999,sp,65,110,145,255
Haiti,2000,sp,014,96,67,163
Haiti,2000,sp,1524,914,836,1750
Haiti,2000,sp,2534,857,898,1755
Haiti,2000,sp,3544,513,613,1126
Haiti,2000,sp,4554,275,350,625
Haiti,2000,sp,5564,132,147,279
Haiti,2000,sp,65,71,118,189
Haiti,2001,sp,014,113,72,185
Haiti,2001,sp,1524,882,752,1634
Haiti,2001,sp,2534,843,785,1628
Haiti,2001,sp,3544,498,587,1085
Haiti,2001,sp,4554,273,319,592
Haiti,2001,sp,5564,109,169,278
Haiti,2001,sp,65,93,112,205
Haiti,2002,sp,014,118,79,197
Haiti,2002,sp,1524,980,903,1883
Haiti,2002,sp,2534,851,904,1755
Haiti,2002,sp,3544,550,572,1122
Haiti,2002,sp,4554,303,377,680
Haiti,2002,sp,5564,120,184,304
Haiti,2002,sp,65,99,148,247
Haiti,2003,sp,014,122,89,211
Haiti,2003,sp,1524,1114,1002,2116
Haiti,2003,sp,2534,1064,981,2045
Haiti,2003,sp,3544,606,625,1231
Haiti,2003,sp,4554,378,406,784
Haiti,2003,sp,5564,165,208,373
Haiti,2003,sp,65,108,147,255
Haiti,2004,sp,014,137,94,231
Haiti,2004,sp,1524,1146,918,2064
Haiti,2004,sp,2534,1045,964,2009
Haiti,2004,sp,3544,688,606,1294
Haiti,2004,sp,4554,386,376,762
Haiti,2004,sp,5564,176,207,383
Haiti,2004,sp,65,125,176,301
Haiti,2005,sp,014,116,69,185
Haiti,2005,sp,1524,1097,1045,2142
Haiti,2005,sp,2534,1099,1035,2134
Haiti,2005,sp,3544,633,701,1334
Haiti,2005,sp,4554,414,451,865
Haiti,2005,sp,5564,170,222,392
Haiti,2005,sp,65,132,156,288
Haiti,2006,ep,014,148,130,278
Haiti,2006,ep,1524,165,160,325
Haiti,2006,ep,2534,164,151,315
Haiti,2006,ep,3544,121,98,219
Haiti,2006,ep,4554,60,87,147
Haiti,2006,ep,5564,43,44,87
Haiti,2006,ep,65,27,38,65
Haiti,2006,sn,014,725,803,1528
Haiti,2006,sn,1524,361,343,704
Haiti,2006,sn,2534,462,406,868
Haiti,2006,sn,3544,312,369,681
Haiti,2006,sn,4554,237,258,495
Haiti,2006,sn,5564,134,140,274
Haiti,2006,sn,65,98,148,246
Haiti,2006,sp,014,137,93,230
Haiti,2006,sp,1524,1113,1110,2223
Haiti,2006,sp,2534,1039,1132,2171
Haiti,2006,sp,3544,638,672,1310
Haiti,2006,sp,4554,387,455,842
Haiti,2006,sp,5564,184,201,385
Haiti,2006,sp,65,126,174,300
Haiti,2007,ep,014,129,134,263
Haiti,2007,ep,1524,152,158,310
Haiti,2007,ep,2534,174,172,346
Haiti,2007,ep,3544,119,122,241
Haiti,2007,ep,4554,68,63,131
Haiti,2007,ep,5564,35,41,76
Haiti,2007,ep,65,29,41,70
Haiti,2007,sn,014,763,860,1623
Haiti,2007,sn,1524,348,298,646
Haiti,2007,sn,2534,378,368,746
Haiti,2007,sn,3544,286,279,565
Haiti,2007,sn,4554,197,211,408
Haiti,2007,sn,5564,132,126,258
Haiti,2007,sn,65,93,133,226
Haiti,2007,sp,014,147,104,251
Haiti,2007,sp,1524,1261,1166,2427
Haiti,2007,sp,2534,1107,1199,2306
Haiti,2007,sp,3544,632,760,1392
Haiti,2007,sp,4554,344,471,815
Haiti,2007,sp,5564,182,219,401
Haiti,2007,sp,65,131,192,323
Haiti,2008,ep,014,128,132,260
Haiti,2008,ep,1524,157,186,343
Haiti,2008,ep,2534,198,156,354
Haiti,2008,ep,3544,98,110,208
Haiti,2008,ep,4554,58,71,129
Haiti,2008,ep,5564,40,46,86
Haiti,2008,ep,65,51,32,83
Haiti,2008,sn,014,638,692,1330
Haiti,2008,sn,1524,392,346,738
Haiti,2008,sn,2534,488,423,911
Haiti,2008,sn,3544,356,333,689
Haiti,2008,sn,4554,220,242,462
Haiti,2008,sn,5564,141,140,281
Haiti,2008,sn,65,126,118,244
Haiti,2008,sp,014,154,90,244
Haiti,2008,sp,1524,1272,1137,2409
Haiti,2008,sp,2534,1204,1337,2541
Haiti,2008,sp,3544,677,696,1373
Haiti,2008,sp,4554,378,491,869
Haiti,2008,sp,5564,179,242,421
Haiti,2008,sp,65,139,175,314
Haiti,2010,ep,014,87,109,196
Haiti,2010,ep,1524,152,142,294
Haiti,2010,ep,2534,166,157,323
Haiti,2010,ep,3544,101,111,212
Haiti,2010,ep,4554,60,70,130
Haiti,2010,ep,5564,42,42,84
Haiti,2010,ep,65,34,34,68
Haiti,2010,sn,014,532,579,1111
Haiti,2010,sn,1524,332,364,696
Haiti,2010,sn,2534,427,456,883
Haiti,2010,sn,3544,317,377,694
Haiti,2010,sn,4554,198,263,461
Haiti,2010,sn,5564,121,153,274
Haiti,2010,sn,65,94,122,216
Haiti,2010,sp,014,158,98,256
Haiti,2010,sp,1524,1268,1225,2493
Haiti,2010,sp,2534,1223,1357,2580
Haiti,2010,sp,3544,608,718,1326
Haiti,2010,sp,4554,358,469,827
Haiti,2010,sp,5564,207,259,466
Haiti,2010,sp,65,134,160,294
Haiti,2011,ep,014,138,184,322
Haiti,2011,ep,1524,156,171,327
Haiti,2011,ep,2534,173,204,377
Haiti,2011,ep,3544,136,129,265
Haiti,2011,ep,4554,75,71,146
Haiti,2011,ep,5564,35,45,80
Haiti,2011,ep,65,41,43,84
Haiti,2011,sn,014,566,612,1178
Haiti,2011,sn,1524,389,439,828
Haiti,2011,sn,2534,523,505,1028
Haiti,2011,sn,3544,381,386,767
Haiti,2011,sn,4554,256,294,550
Haiti,2011,sn,5564,152,151,303
Haiti,2011,sn,65,108,109,217
Haiti,2011,sp,014,170,107,277
Haiti,2011,sp,1524,1356,1239,2595
Haiti,2011,sp,2534,1291,1398,2689
Haiti,2011,sp,3544,601,690,1291
Haiti,2011,sp,4554,397,445,842
Haiti,2011,sp,5564,199,235,434
Haiti,2011,sp,65,138,133,271
Haiti,2012,ep,014,176,203,379
Haiti,2012,ep,1524,202,183,385
Haiti,2012,ep,2534,248,245,493
Haiti,2012,ep,3544,136,156,292
Haiti,2012,ep,4554,73,93,166
Haiti,2012,ep,5564,65,54,119
Haiti,2012,ep,65,37,47,84
Haiti,2012,sn,014,616,704,1320
Haiti,2012,sn,1524,367,364,731
Haiti,2012,sn,2534,430,501,931
Haiti,2012,sn,3544,318,373,691
Haiti,2012,sn,4554,273,261,534
Haiti,2012,sn,5564,123,175,298
Haiti,2012,sn,65,109,105,214
Haiti,2012,sp,014,160,126,286
Haiti,2012,sp,1524,1478,1358,2836
Haiti,2012,sp,2534,1418,1564,2982
Haiti,2012,sp,3544,697,757,1454
Haiti,2012,sp,4554,416,475,891
Haiti,2012,sp,5564,220,271,491
Haiti,2012,sp,65,157,164,321
Haiti,2013,rel,014,956,949,1905
Haiti,2013,rel,1524,2122,1973,4095
Haiti,2013,rel,2534,2241,2563,4804
Haiti,2013,rel,3544,1262,1463,2725
Haiti,2013,rel,4554,779,1011,1790
Haiti,2013,rel,5564,452,545,997
Haiti,2013,rel,65,339,385,724
Honduras,1995,sp,014,54,42,96
Honduras,1995,sp,1524,208,280,488
Honduras,1995,sp,2534,292,540,832
Honduras,1995,sp,3544,134,204,338
Honduras,1995,sp,4554,76,130,206
Honduras,1995,sp,5564,136,236,372
Honduras,1995,sp,65,48,58,106
Honduras,1996,sp,014,43,51,94
Honduras,1996,sp,1524,167,247,414
Honduras,1996,sp,2534,245,389,634
Honduras,1996,sp,3544,106,142,248
Honduras,1996,sp,4554,69,108,177
Honduras,1996,sp,5564,149,190,339
Honduras,1996,sp,65,17,21,38
Honduras,1997,sp,014,38,26,64
Honduras,1997,sp,1524,166,214,380
Honduras,1997,sp,2534,174,321,495
Honduras,1997,sp,3544,80,111,191
Honduras,1997,sp,4554,61,78,139
Honduras,1997,sp,5564,116,140,256
Honduras,1997,sp,65,26,28,54
Honduras,1998,sp,014,103,147,250
Honduras,1998,sp,1524,206,277,483
Honduras,1998,sp,2534,192,256,448
Honduras,1998,sp,3544,158,211,369
Honduras,1998,sp,4554,152,205,357
Honduras,1998,sp,5564,135,181,316
Honduras,1998,sp,65,38,50,88
Honduras,1999,sp,014,100,150,250
Honduras,1999,sp,1524,214,288,502
Honduras,1999,sp,2534,201,268,469
Honduras,1999,sp,3544,164,219,383
Honduras,1999,sp,4554,160,220,380
Honduras,1999,sp,5564,140,190,330
Honduras,1999,sp,65,40,52,92
Honduras,2000,sp,014,25,30,55
Honduras,2000,sp,1524,21,123,144
Honduras,2000,sp,2534,269,371,640
Honduras,2000,sp,3544,258,246,504
Honduras,2000,sp,4554,270,277,547
Honduras,2000,sp,5564,160,214,374
Honduras,2000,sp,65,38,43,81
Honduras,2001,sp,014,13,12,25
Honduras,2001,sp,1524,25,47,72
Honduras,2001,sp,2534,347,509,856
Honduras,2001,sp,3544,352,344,696
Honduras,2001,sp,4554,339,337,676
Honduras,2001,sp,5564,196,257,453
Honduras,2001,sp,65,34,27,61
Honduras,2002,sp,014,65,76,141
Honduras,2002,sp,1524,23,29,52
Honduras,2002,sp,2534,351,519,870
Honduras,2002,sp,3544,339,353,692
Honduras,2002,sp,4554,354,338,692
Honduras,2002,sp,5564,193,257,450
Honduras,2002,sp,65,35,24,59
Honduras,2003,sp,014,42,52,94
Honduras,2003,sp,1524,15,20,35
Honduras,2003,sp,2534,232,344,576
Honduras,2003,sp,3544,225,235,460
Honduras,2003,sp,4554,236,227,463
Honduras,2003,sp,5564,127,161,288
Honduras,2003,sp,65,23,17,40
Honduras,2004,sp,014,40,54,94
Honduras,2004,sp,1524,13,20,33
Honduras,2004,sp,2534,218,379,597
Honduras,2004,sp,3544,211,259,470
Honduras,2004,sp,4554,220,247,467
Honduras,2004,sp,5564,121,189,310
Honduras,2004,sp,65,23,18,41
Honduras,2005,sp,014,27,13,40
Honduras,2005,sp,1524,219,238,457
Honduras,2005,sp,2534,222,280,502
Honduras,2005,sp,3544,125,215,340
Honduras,2005,sp,4554,107,152,259
Honduras,2005,sp,5564,81,134,215
Honduras,2005,sp,65,104,152,256
Honduras,2006,ep,014,9,26,35
Honduras,2006,ep,1524,28,24,52
Honduras,2006,ep,2534,37,36,73
Honduras,2006,ep,3544,29,29,58
Honduras,2006,ep,4554,27,19,46
Honduras,2006,ep,5564,19,11,30
Honduras,2006,ep,65,27,29,56
Honduras,2006,sn,014,63,72,135
Honduras,2006,sn,1524,26,36,62
Honduras,2006,sn,2534,54,81,135
Honduras,2006,sn,3544,46,67,113
Honduras,2006,sn,4554,34,46,80
Honduras,2006,sn,5564,16,40,56
Honduras,2006,sn,65,27,48,75
Honduras,2006,sp,014,28,21,49
Honduras,2006,sp,1524,206,213,419
Honduras,2006,sp,2534,234,297,531
Honduras,2006,sp,3544,123,213,336
Honduras,2006,sp,4554,85,139,224
Honduras,2006,sp,5564,87,96,183
Honduras,2006,sp,65,129,147,276
Honduras,2007,ep,014,23,25,48
Honduras,2007,ep,1524,16,25,41
Honduras,2007,ep,2534,37,45,82
Honduras,2007,ep,3544,26,32,58
Honduras,2007,ep,4554,21,21,42
Honduras,2007,ep,5564,7,12,19
Honduras,2007,ep,65,18,20,38
Honduras,2007,sn,014,28,36,64
Honduras,2007,sn,1524,24,42,66
Honduras,2007,sn,2534,34,62,96
Honduras,2007,sn,3544,18,48,66
Honduras,2007,sn,4554,24,37,61
Honduras,2007,sn,5564,22,20,42
Honduras,2007,sn,65,29,46,75
Honduras,2007,sp,014,29,21,50
Honduras,2007,sp,1524,185,204,389
Honduras,2007,sp,2534,175,293,468
Honduras,2007,sp,3544,110,194,304
Honduras,2007,sp,4554,106,158,264
Honduras,2007,sp,5564,84,123,207
Honduras,2007,sp,65,112,180,292
Honduras,2008,ep,014,16,15,31
Honduras,2008,ep,1524,26,26,52
Honduras,2008,ep,2534,37,40,77
Honduras,2008,ep,3544,28,28,56
Honduras,2008,ep,4554,24,23,47
Honduras,2008,ep,5564,9,19,28
Honduras,2008,ep,65,20,19,39
Honduras,2008,sn,014,32,33,65
Honduras,2008,sn,1524,24,28,52
Honduras,2008,sn,2534,34,55,89
Honduras,2008,sn,3544,30,47,77
Honduras,2008,sn,4554,18,33,51
Honduras,2008,sn,5564,21,35,56
Honduras,2008,sn,65,17,44,61
Honduras,2008,sp,014,26,11,37
Honduras,2008,sp,1524,152,254,406
Honduras,2008,sp,2534,170,263,433
Honduras,2008,sp,3544,114,202,316
Honduras,2008,sp,4554,90,140,230
Honduras,2008,sp,5564,82,103,185
Honduras,2008,sp,65,116,174,290
Honduras,2009,ep,014,17,23,40
Honduras,2009,ep,1524,21,26,47
Honduras,2009,ep,2534,35,36,71
Honduras,2009,ep,3544,18,36,54
Honduras,2009,ep,4554,22,23,45
Honduras,2009,ep,5564,13,18,31
Honduras,2009,ep,65,15,28,43
Honduras,2009,sn,014,37,37,74
Honduras,2009,sn,1524,23,52,75
Honduras,2009,sn,2534,30,58,88
Honduras,2009,sn,3544,25,53,78
Honduras,2009,sn,4554,20,39,59
Honduras,2009,sn,5564,21,40,61
Honduras,2009,sn,65,35,50,85
Honduras,2009,sp,014,17,13,30
Honduras,2009,sp,1524,167,227,394
Honduras,2009,sp,2534,172,269,441
Honduras,2009,sp,3544,124,177,301
Honduras,2009,sp,4554,80,155,235
Honduras,2009,sp,5564,73,131,204
Honduras,2009,sp,65,108,168,276
Honduras,2010,ep,014,17,27,44
Honduras,2010,ep,1524,19,37,56
Honduras,2010,ep,2534,42,44,86
Honduras,2010,ep,3544,39,38,77
Honduras,2010,ep,4554,15,27,42
Honduras,2010,ep,5564,11,20,31
Honduras,2010,ep,65,20,26,46
Honduras,2010,sn,014,32,30,62
Honduras,2010,sn,1524,24,33,57
Honduras,2010,sn,2534,31,53,84
Honduras,2010,sn,3544,34,35,69
Honduras,2010,sn,4554,22,41,63
Honduras,2010,sn,5564,20,30,50
Honduras,2010,sn,65,40,57,97
Honduras,2010,sp,014,28,15,43
Honduras,2010,sp,1524,186,177,363
Honduras,2010,sp,2534,163,246,409
Honduras,2010,sp,3544,106,207,313
Honduras,2010,sp,4554,103,165,268
Honduras,2010,sp,5564,69,113,182
Honduras,2010,sp,65,107,157,264
Honduras,2011,ep,014,20,19,39
Honduras,2011,ep,1524,21,31,52
Honduras,2011,ep,2534,33,39,72
Honduras,2011,ep,3544,25,41,66
Honduras,2011,ep,4554,18,34,52
Honduras,2011,ep,5564,28,26,54
Honduras,2011,ep,65,16,39,55
Honduras,2011,sn,014,53,63,116
Honduras,2011,sn,1524,33,36,69
Honduras,2011,sn,2534,42,73,115
Honduras,2011,sn,3544,25,57,82
Honduras,2011,sn,4554,28,48,76
Honduras,2011,sn,5564,27,35,62
Honduras,2011,sn,65,43,53,96
Honduras,2011,sp,014,19,17,36
Honduras,2011,sp,1524,181,194,375
Honduras,2011,sp,2534,194,291,485
Honduras,2011,sp,3544,138,227,365
Honduras,2011,sp,4554,99,184,283
Honduras,2011,sp,5564,98,120,218
Honduras,2011,sp,65,126,184,310
Honduras,2012,ep,014,15,26,41
Honduras,2012,ep,1524,29,27,56
Honduras,2012,ep,2534,37,46,83
Honduras,2012,ep,3544,25,32,57
Honduras,2012,ep,4554,15,22,37
Honduras,2012,ep,5564,18,18,36
Honduras,2012,ep,65,24,28,52
Honduras,2012,sn,014,41,49,90
Honduras,2012,sn,1524,25,38,63
Honduras,2012,sn,2534,35,62,97
Honduras,2012,sn,3544,21,48,69
Honduras,2012,sn,4554,29,33,62
Honduras,2012,sn,5564,21,24,45
Honduras,2012,sn,65,22,61,83
Honduras,2012,sp,014,15,18,33
Honduras,2012,sp,1524,180,247,427
Honduras,2012,sp,2534,157,285,442
Honduras,2012,sp,3544,115,192,307
Honduras,2012,sp,4554,88,184,272
Honduras,2012,sp,5564,75,129,204
Honduras,2012,sp,65,114,146,260
Honduras,2013,rel,014,90,72,162
Honduras,2013,rel,1524,277,300,577
Honduras,2013,rel,2534,246,391,637
Honduras,2013,rel,3544,173,317,490
Honduras,2013,rel,4554,159,248,407
Honduras,2013,rel,5564,119,191,310
Honduras,2013,rel,65,174,224,398
Hungary,1996,sp,014,2,3,5
Hungary,1996,sp,1524,30,28,58
Hungary,1996,sp,2534,42,139,181
Hungary,1996,sp,3544,51,151,202
Hungary,1996,sp,4554,63,209,272
Hungary,1996,sp,5564,27,140,167
Hungary,1996,sp,65,76,105,181
Hungary,1997,sp,014,1,0,1
Hungary,1997,sp,1524,9,8,17
Hungary,1997,sp,2534,25,51,76
Hungary,1997,sp,3544,35,163,198
Hungary,1997,sp,4554,24,164,188
Hungary,1997,sp,5564,19,90,109
Hungary,1997,sp,65,44,69,113
Hungary,1998,sp,014,0,0,0
Hungary,1998,sp,1524,13,14,27
Hungary,1998,sp,2534,27,64,91
Hungary,1998,sp,3544,34,149,183
Hungary,1998,sp,4554,25,163,188
Hungary,1998,sp,5564,17,62,79
Hungary,1998,sp,65,40,59,99
Hungary,1999,sp,014,4,2,6
Hungary,1999,sp,1524,17,16,33
Hungary,1999,sp,2534,19,48,67
Hungary,1999,sp,3544,37,155,192
Hungary,1999,sp,4554,19,183,202
Hungary,1999,sp,5564,7,74,81
Hungary,1999,sp,65,32,47,79
Hungary,2000,sp,014,1,0,1
Hungary,2000,sp,1524,7,8,15
Hungary,2000,sp,2534,17,24,41
Hungary,2000,sp,3544,19,85,104
Hungary,2000,sp,4554,22,104,126
Hungary,2000,sp,5564,10,58,68
Hungary,2000,sp,65,30,27,57
Hungary,2001,sp,014,0,1,1
Hungary,2001,sp,1524,10,11,21
Hungary,2001,sp,2534,17,42,59
Hungary,2001,sp,3544,31,97,128
Hungary,2001,sp,4554,27,133,160
Hungary,2001,sp,5564,13,73,86
Hungary,2001,sp,65,37,42,79
Hungary,2002,sp,014,1,1,2
Hungary,2002,sp,1524,9,10,19
Hungary,2002,sp,2534,27,41,68
Hungary,2002,sp,3544,36,102,138
Hungary,2002,sp,4554,26,145,171
Hungary,2002,sp,5564,14,61,75
Hungary,2002,sp,65,38,39,77
Hungary,2003,sp,014,0,0,0
Hungary,2003,sp,1524,16,6,22
Hungary,2003,sp,2534,26,30,56
Hungary,2003,sp,3544,27,89,116
Hungary,2003,sp,4554,30,140,170
Hungary,2003,sp,5564,11,70,81
Hungary,2003,sp,65,33,38,71
Hungary,2004,sp,014,2,2,4
Hungary,2004,sp,1524,6,7,13
Hungary,2004,sp,2534,23,38,61
Hungary,2004,sp,3544,25,99,124
Hungary,2004,sp,4554,29,145,174
Hungary,2004,sp,5564,14,64,78
Hungary,2004,sp,65,40,63,103
Hungary,2005,sp,014,1,0,1
Hungary,2005,sp,1524,5,6,11
Hungary,2005,sp,2534,13,24,37
Hungary,2005,sp,3544,11,67,78
Hungary,2005,sp,4554,22,117,139
Hungary,2005,sp,5564,15,67,82
Hungary,2005,sp,65,33,39,72
Hungary,2006,ep,014,1,1,2
Hungary,2006,ep,1524,0,0,0
Hungary,2006,ep,2534,0,7,7
Hungary,2006,ep,3544,7,6,13
Hungary,2006,ep,4554,4,15,19
Hungary,2006,ep,5564,9,10,19
Hungary,2006,ep,65,13,13,26
Hungary,2006,sn,014,1,1,2
Hungary,2006,sn,1524,21,33,54
Hungary,2006,sn,2534,45,53,98
Hungary,2006,sn,3544,55,98,153
Hungary,2006,sn,4554,76,214,290
Hungary,2006,sn,5564,59,161,220
Hungary,2006,sn,65,123,127,250
Hungary,2006,sp,014,3,2,5
Hungary,2006,sp,1524,17,10,27
Hungary,2006,sp,2534,16,31,47
Hungary,2006,sp,3544,19,71,90
Hungary,2006,sp,4554,28,98,126
Hungary,2006,sp,5564,11,54,65
Hungary,2006,sp,65,29,33,62
Hungary,2007,ep,014,0,0,0
Hungary,2007,ep,1524,0,0,0
Hungary,2007,ep,2534,1,5,6
Hungary,2007,ep,3544,7,8,15
Hungary,2007,ep,4554,9,6,15
Hungary,2007,ep,5564,7,8,15
Hungary,2007,ep,65,24,11,35
Hungary,2007,sn,014,1,3,4
Hungary,2007,sn,1524,10,11,21
Hungary,2007,sn,2534,34,33,67
Hungary,2007,sn,3544,48,87,135
Hungary,2007,sn,4554,74,175,249
Hungary,2007,sn,5564,46,147,193
Hungary,2007,sn,65,126,162,288
Hungary,2007,sp,014,3,0,3
Hungary,2007,sp,1524,12,7,19
Hungary,2007,sp,2534,22,31,53
Hungary,2007,sp,3544,18,48,66
Hungary,2007,sp,4554,17,103,120
Hungary,2007,sp,5564,6,50,56
Hungary,2007,sp,65,29,35,64
Hungary,2008,ep,014,0,1,1
Hungary,2008,ep,1524,1,1,2
Hungary,2008,ep,2534,4,4,8
Hungary,2008,ep,3544,1,7,8
Hungary,2008,ep,4554,8,8,16
Hungary,2008,ep,5564,3,8,11
Hungary,2008,ep,65,22,11,33
Hungary,2008,sn,014,2,1,3
Hungary,2008,sn,1524,22,19,41
Hungary,2008,sn,2534,33,39,72
Hungary,2008,sn,3544,42,91,133
Hungary,2008,sn,4554,52,141,193
Hungary,2008,sn,5564,55,146,201
Hungary,2008,sn,65,117,136,253
Hungary,2008,sp,014,0,0,0
Hungary,2008,sp,1524,11,12,23
Hungary,2008,sp,2534,13,23,36
Hungary,2008,sp,3544,15,47,62
Hungary,2008,sp,4554,12,86,98
Hungary,2008,sp,5564,5,72,77
Hungary,2008,sp,65,25,24,49
Hungary,2009,ep,014,3,1,4
Hungary,2009,ep,1524,0,2,2
Hungary,2009,ep,2534,1,2,3
Hungary,2009,ep,3544,3,6,9
Hungary,2009,ep,4554,6,10,16
Hungary,2009,ep,5564,3,4,7
Hungary,2009,ep,65,12,12,24
Hungary,2009,sn,014,0,0,0
Hungary,2009,sn,1524,10,15,25
Hungary,2009,sn,2534,34,28,62
Hungary,2009,sn,3544,40,56,96
Hungary,2009,sn,4554,69,135,204
Hungary,2009,sn,5564,55,121,176
Hungary,2009,sn,65,87,116,203
Hungary,2009,sp,014,1,0,1
Hungary,2009,sp,1524,4,10,14
Hungary,2009,sp,2534,13,14,27
Hungary,2009,sp,3544,21,49,70
Hungary,2009,sp,4554,22,89,111
Hungary,2009,sp,5564,14,56,70
Hungary,2009,sp,65,32,36,68
Hungary,2010,ep,014,2,0,2
Hungary,2010,ep,1524,2,4,6
Hungary,2010,ep,2534,1,4,5
Hungary,2010,ep,3544,2,2,4
Hungary,2010,ep,4554,8,7,15
Hungary,2010,ep,5564,3,10,13
Hungary,2010,ep,65,19,6,25
Hungary,2010,sn,014,4,4,8
Hungary,2010,sn,1524,29,34,63
Hungary,2010,sn,2534,42,41,83
Hungary,2010,sn,3544,65,111,176
Hungary,2010,sn,4554,81,159,240
Hungary,2010,sn,5564,92,170,262
Hungary,2010,sn,65,123,180,303
Hungary,2010,sp,014,0,1,1
Hungary,2010,sp,1524,9,9,18
Hungary,2010,sp,2534,16,14,30
Hungary,2010,sp,3544,14,36,50
Hungary,2010,sp,4554,9,51,60
Hungary,2010,sp,5564,15,50,65
Hungary,2010,sp,65,20,23,43
Hungary,2011,ep,014,0,0,0
Hungary,2011,ep,1524,1,2,3
Hungary,2011,ep,2534,2,3,5
Hungary,2011,ep,3544,5,2,7
Hungary,2011,ep,4554,4,4,8
Hungary,2011,ep,5564,5,7,12
Hungary,2011,ep,65,8,10,18
Hungary,2011,sn,014,1,2,3
Hungary,2011,sn,1524,28,16,44
Hungary,2011,sn,2534,32,52,84
Hungary,2011,sn,3544,42,82,124
Hungary,2011,sn,4554,70,141,211
Hungary,2011,sn,5564,72,135,207
Hungary,2011,sn,65,97,140,237
Hungary,2011,sp,014,0,0,0
Hungary,2011,sp,1524,3,11,14
Hungary,2011,sp,2534,9,18,27
Hungary,2011,sp,3544,8,34,42
Hungary,2011,sp,4554,9,46,55
Hungary,2011,sp,5564,12,53,65
Hungary,2011,sp,65,29,28,57
Hungary,2012,ep,014,0,0,0
Hungary,2012,ep,1524,0,1,1
Hungary,2012,ep,2534,1,1,2
Hungary,2012,ep,3544,3,2,5
Hungary,2012,ep,4554,2,4,6
Hungary,2012,ep,5564,4,6,10
Hungary,2012,ep,65,9,2,11
Hungary,2012,sn,014,1,5,6
Hungary,2012,sn,1524,18,23,41
Hungary,2012,sn,2534,24,29,53
Hungary,2012,sn,3544,43,73,116
Hungary,2012,sn,4554,46,127,173
Hungary,2012,sn,5564,71,152,223
Hungary,2012,sn,65,120,99,219
Hungary,2012,sp,014,0,2,2
Hungary,2012,sp,1524,8,7,15
Hungary,2012,sp,2534,14,15,29
Hungary,2012,sp,3544,15,29,44
Hungary,2012,sp,4554,11,64,75
Hungary,2012,sp,5564,14,41,55
Hungary,2012,sp,65,28,25,53
Hungary,2013,rel,014,1,6,7
Hungary,2013,rel,1524,26,22,48
Hungary,2013,rel,2534,34,54,88
Hungary,2013,rel,3544,60,81,141
Hungary,2013,rel,4554,60,170,230
Hungary,2013,rel,5564,89,194,283
Hungary,2013,rel,65,106,137,243
Iceland,1995,sp,014,0,0,0
Iceland,1995,sp,1524,0,0,0
Iceland,1995,sp,2534,0,0,0
Iceland,1995,sp,3544,0,0,0
Iceland,1995,sp,4554,0,0,0
Iceland,1995,sp,5564,0,0,0
Iceland,1995,sp,65,1,1,2
Iceland,1996,sp,014,0,NA,NA
Iceland,1996,sp,1524,1,NA,NA
Iceland,1996,sp,2534,0,NA,NA
Iceland,1996,sp,3544,0,NA,NA
Iceland,1996,sp,4554,0,NA,NA
Iceland,1996,sp,5564,0,NA,NA
Iceland,1996,sp,65,0,NA,NA
Iceland,1997,sp,014,0,0,0
Iceland,1997,sp,1524,1,0,1
Iceland,1997,sp,2534,0,0,0
Iceland,1997,sp,3544,0,0,0
Iceland,1997,sp,4554,0,0,0
Iceland,1997,sp,5564,1,0,1
Iceland,1997,sp,65,2,1,3
Iceland,1998,sp,014,0,0,0
Iceland,1998,sp,1524,0,0,0
Iceland,1998,sp,2534,0,1,1
Iceland,1998,sp,3544,0,0,0
Iceland,1998,sp,4554,0,0,0
Iceland,1998,sp,5564,0,0,0
Iceland,1998,sp,65,1,0,1
Iceland,1999,sp,014,0,0,0
Iceland,1999,sp,2534,1,NA,NA
Iceland,1999,sp,3544,NA,1,NA
Iceland,2000,sp,014,0,NA,NA
Iceland,2000,sp,2534,1,NA,NA
Iceland,2001,sp,014,0,0,0
Iceland,2001,sp,1524,NA,1,NA
Iceland,2001,sp,3544,1,NA,NA
Iceland,2001,sp,65,NA,1,NA
Iceland,2002,sp,014,0,0,0
Iceland,2002,sp,1524,0,1,1
Iceland,2002,sp,2534,1,0,1
Iceland,2002,sp,3544,0,0,0
Iceland,2002,sp,4554,0,0,0
Iceland,2002,sp,5564,0,0,0
Iceland,2002,sp,65,0,0,0
Iceland,2003,sp,014,0,0,0
Iceland,2003,sp,1524,0,0,0
Iceland,2003,sp,2534,0,0,0
Iceland,2003,sp,3544,0,0,0
Iceland,2003,sp,4554,0,0,0
Iceland,2003,sp,5564,0,0,0
Iceland,2003,sp,65,0,1,1
Iceland,2004,sp,014,0,0,0
Iceland,2004,sp,1524,0,0,0
Iceland,2004,sp,2534,0,0,0
Iceland,2004,sp,3544,0,0,0
Iceland,2004,sp,4554,0,1,1
Iceland,2004,sp,5564,0,1,1
Iceland,2004,sp,65,0,0,0
Iceland,2005,sp,014,0,0,0
Iceland,2005,sp,1524,0,0,0
Iceland,2005,sp,2534,0,0,0
Iceland,2005,sp,3544,0,1,1
Iceland,2005,sp,4554,0,0,0
Iceland,2005,sp,5564,0,0,0
Iceland,2005,sp,65,0,1,1
Iceland,2006,ep,014,0,0,0
Iceland,2006,ep,1524,0,2,2
Iceland,2006,ep,2534,0,1,1
Iceland,2006,ep,3544,1,1,2
Iceland,2006,ep,4554,0,0,0
Iceland,2006,ep,5564,0,1,1
Iceland,2006,ep,65,0,0,0
Iceland,2006,sn,014,0,0,0
Iceland,2006,sn,1524,0,0,0
Iceland,2006,sn,2534,0,0,0
Iceland,2006,sn,3544,2,1,3
Iceland,2006,sn,4554,0,0,0
Iceland,2006,sn,5564,0,0,0
Iceland,2006,sn,65,0,0,0
Iceland,2006,sp,014,0,0,0
Iceland,2006,sp,1524,0,0,0
Iceland,2006,sp,2534,2,0,2
Iceland,2006,sp,3544,0,0,0
Iceland,2006,sp,4554,0,0,0
Iceland,2006,sp,5564,0,0,0
Iceland,2006,sp,65,1,1,2
Iceland,2007,ep,014,0,0,0
Iceland,2007,ep,1524,0,NA,NA
Iceland,2007,ep,2534,2,0,2
Iceland,2007,ep,3544,2,0,2
Iceland,2007,ep,4554,0,2,2
Iceland,2007,ep,5564,2,0,2
Iceland,2007,ep,65,0,2,2
Iceland,2007,sn,014,0,0,0
Iceland,2007,sn,1524,0,0,0
Iceland,2007,sn,2534,7,0,7
Iceland,2007,sn,3544,3,2,5
Iceland,2007,sn,4554,0,1,1
Iceland,2007,sn,5564,1,0,1
Iceland,2007,sn,65,0,1,1
Iceland,2007,sp,014,0,0,0
Iceland,2007,sp,1524,0,0,0
Iceland,2007,sp,2534,0,0,0
Iceland,2007,sp,3544,2,0,2
Iceland,2007,sp,4554,0,0,0
Iceland,2007,sp,5564,0,0,0
Iceland,2007,sp,65,2,0,2
Iceland,2008,ep,014,0,0,0
Iceland,2008,ep,1524,0,1,1
Iceland,2008,ep,2534,0,1,1
Iceland,2008,ep,3544,0,0,0
Iceland,2008,ep,4554,1,0,1
Iceland,2008,ep,5564,0,0,0
Iceland,2008,ep,65,0,0,0
Iceland,2008,sn,014,0,0,0
Iceland,2008,sn,1524,0,0,0
Iceland,2008,sn,2534,1,0,1
Iceland,2008,sn,3544,0,0,0
Iceland,2008,sn,4554,0,0,0
Iceland,2008,sn,5564,0,0,0
Iceland,2008,sn,65,0,0,0
Iceland,2008,sp,014,0,0,0
Iceland,2008,sp,1524,0,0,0
Iceland,2008,sp,2534,0,1,1
Iceland,2008,sp,3544,0,1,1
Iceland,2008,sp,4554,0,0,0
Iceland,2008,sp,5564,0,0,0
Iceland,2008,sp,65,0,0,0
Iceland,2009,ep,014,0,0,0
Iceland,2009,ep,1524,0,1,1
Iceland,2009,ep,2534,0,0,0
Iceland,2009,ep,3544,1,0,1
Iceland,2009,ep,4554,0,0,0
Iceland,2009,ep,5564,0,0,0
Iceland,2009,ep,65,0,0,0
Iceland,2009,sn,014,0,1,1
Iceland,2009,sn,1524,0,1,1
Iceland,2009,sn,2534,0,0,0
Iceland,2009,sn,3544,0,0,0
Iceland,2009,sn,4554,0,0,0
Iceland,2009,sn,5564,0,0,0
Iceland,2009,sn,65,0,0,0
Iceland,2009,sp,014,0,0,0
Iceland,2009,sp,1524,1,0,1
Iceland,2009,sp,2534,0,0,0
Iceland,2009,sp,3544,0,1,1
Iceland,2009,sp,4554,0,1,1
Iceland,2009,sp,5564,0,0,0
Iceland,2009,sp,65,0,0,0
Iceland,2010,ep,014,0,0,0
Iceland,2010,ep,1524,0,0,0
Iceland,2010,ep,2534,1,1,2
Iceland,2010,ep,3544,2,0,2
Iceland,2010,ep,4554,0,0,0
Iceland,2010,ep,5564,0,0,0
Iceland,2010,ep,65,0,0,0
Iceland,2010,sn,014,0,0,0
Iceland,2010,sn,1524,3,2,5
Iceland,2010,sn,2534,3,0,3
Iceland,2010,sn,3544,2,0,2
Iceland,2010,sn,4554,0,1,1
Iceland,2010,sn,5564,0,0,0
Iceland,2010,sn,65,1,0,1
Iceland,2010,sp,014,0,0,0
Iceland,2010,sp,1524,0,0,0
Iceland,2010,sp,2534,1,1,2
Iceland,2010,sp,3544,1,0,1
Iceland,2010,sp,4554,0,3,3
Iceland,2010,sp,5564,0,0,0
Iceland,2010,sp,65,0,0,0
Iceland,2011,ep,014,0,0,0
Iceland,2011,ep,1524,1,0,1
Iceland,2011,ep,2534,3,0,3
Iceland,2011,ep,3544,0,0,0
Iceland,2011,ep,4554,0,0,0
Iceland,2011,ep,5564,1,0,1
Iceland,2011,ep,65,0,0,0
Iceland,2011,sn,014,0,1,1
Iceland,2011,sn,1524,0,0,0
Iceland,2011,sn,2534,0,1,1
Iceland,2011,sn,3544,0,0,0
Iceland,2011,sn,4554,0,0,0
Iceland,2011,sn,5564,0,0,0
Iceland,2011,sn,65,0,0,0
Iceland,2011,sp,014,0,0,0
Iceland,2011,sp,1524,0,0,0
Iceland,2011,sp,2534,0,0,0
Iceland,2011,sp,3544,0,0,0
Iceland,2011,sp,4554,0,0,0
Iceland,2011,sp,5564,0,0,0
Iceland,2011,sp,65,1,0,1
Iceland,2012,ep,014,0,0,0
Iceland,2012,ep,1524,0,0,0
Iceland,2012,ep,2534,0,0,0
Iceland,2012,ep,3544,1,0,1
Iceland,2012,ep,4554,1,0,1
Iceland,2012,ep,5564,1,0,1
Iceland,2012,ep,65,0,0,0
Iceland,2012,sn,014,0,0,0
Iceland,2012,sn,1524,1,0,1
Iceland,2012,sn,2534,1,0,1
Iceland,2012,sn,3544,0,0,0
Iceland,2012,sn,4554,1,2,3
Iceland,2012,sn,5564,0,0,0
Iceland,2012,sn,65,0,0,0
Iceland,2012,sp,014,0,0,0
Iceland,2012,sp,1524,0,0,0
Iceland,2012,sp,2534,1,0,1
Iceland,2012,sp,3544,0,0,0
Iceland,2012,sp,4554,0,1,1
Iceland,2012,sp,5564,0,0,0
Iceland,2012,sp,65,0,0,0
Iceland,2013,rel,014,0,0,0
Iceland,2013,rel,1524,0,1,1
Iceland,2013,rel,2534,2,2,4
Iceland,2013,rel,3544,1,1,2
Iceland,2013,rel,4554,0,0,0
Iceland,2013,rel,5564,0,1,1
Iceland,2013,rel,65,3,0,3
India,1995,sp,014,32,16,48
India,1995,sp,1524,179,334,513
India,1995,sp,2534,169,391,560
India,1995,sp,3544,80,287,367
India,1995,sp,4554,49,216,265
India,1995,sp,5564,30,123,153
India,1995,sp,65,11,68,79
India,1996,sp,014,79,47,126
India,1996,sp,1524,618,966,1584
India,1996,sp,2534,571,1143,1714
India,1996,sp,3544,281,934,1215
India,1996,sp,4554,167,666,833
India,1996,sp,5564,103,424,527
India,1996,sp,65,42,213,255
India,1997,sp,014,125,50,175
India,1997,sp,1524,861,1257,2118
India,1997,sp,2534,799,1351,2150
India,1997,sp,3544,369,1056,1425
India,1997,sp,4554,187,753,940
India,1997,sp,5564,102,499,601
India,1997,sp,65,54,245,299
India,1998,sp,014,190,84,274
India,1998,sp,1524,1375,1773,3148
India,1998,sp,2534,1121,2013,3134
India,1998,sp,3544,670,1851,2521
India,1998,sp,4554,349,1389,1738
India,1998,sp,5564,200,885,1085
India,1998,sp,65,102,419,521
India,1999,sp,014,785,327,1112
India,1999,sp,1524,5497,7058,12555
India,1999,sp,2534,4848,8856,13704
India,1999,sp,3544,2773,7900,10673
India,1999,sp,4554,1504,6172,7676
India,1999,sp,5564,898,3864,4762
India,1999,sp,65,436,1982,2418
India,2000,sp,014,2250,1588,3838
India,2000,sp,1524,14495,20963,35458
India,2000,sp,2534,17287,31090,48377
India,2000,sp,3544,11768,30829,42597
India,2000,sp,4554,7516,24230,31746
India,2000,sp,5564,4594,15308,19902
India,2000,sp,65,2697,8534,11231
India,2001,sp,014,2125,1063,3188
India,2001,sp,1524,15973,22483,38456
India,2001,sp,2534,16743,30007,46750
India,2001,sp,3544,10103,29649,39752
India,2001,sp,4554,5633,23961,29594
India,2001,sp,5564,3353,14879,18232
India,2001,sp,65,1526,7779,9305
India,2002,sp,014,4200,2551,6751
India,2002,sp,1524,28573,39923,68496
India,2002,sp,2534,31946,54719,86665
India,2002,sp,3544,21378,55829,77207
India,2002,sp,4554,13233,44532,57765
India,2002,sp,5564,7636,28199,35835
India,2002,sp,65,3814,14960,18774
India,2003,sp,014,4745,2411,7156
India,2003,sp,1524,34511,47251,81762
India,2003,sp,2534,36317,61758,98075
India,2003,sp,3544,23320,63587,86907
India,2003,sp,4554,14055,52865,66920
India,2003,sp,5564,8322,33739,42061
India,2003,sp,65,3985,18018,22003
India,2004,sp,014,5860,3018,8878
India,2004,sp,1524,41017,57208,98225
India,2004,sp,2534,42808,72132,114940
India,2004,sp,3544,27000,74450,101450
India,2004,sp,4554,16121,62173,78294
India,2004,sp,5564,9705,40769,50474
India,2004,sp,65,5016,22388,27404
India,2005,sp,014,6292,3185,9477
India,2005,sp,1524,45136,62620,107756
India,2005,sp,2534,45629,74678,120307
India,2005,sp,3544,28577,76870,105447
India,2005,sp,4554,17042,64843,81885
India,2005,sp,5564,10513,43038,53551
India,2005,sp,65,5408,24726,30134
India,2006,sp,014,6963,3566,10529
India,2006,sp,1524,47702,68346,116048
India,2006,sp,2534,47420,79037,126457
India,2006,sp,3544,31128,82939,114067
India,2006,sp,4554,18870,71621,90491
India,2006,sp,5564,11752,49320,61072
India,2006,sp,65,6417,28716,35133
India,2007,ep,3544,101015,105825,206840
India,2007,sn,3544,148811,250051,398862
India,2007,sp,014,7575,4305,11880
India,2007,sp,1524,50289,73947,124236
India,2007,sp,2534,49519,83850,133369
India,2007,sp,3544,32407,88045,120452
India,2007,sp,4554,20316,76408,96724
India,2007,sp,5564,13195,53414,66609
India,2007,sp,65,7395,31922,39317
India,2008,sp,014,8319,4648,12967
India,2008,sp,1524,51485,77121,128606
India,2008,sp,2534,49887,83798,133685
India,2008,sp,3544,33664,90498,124162
India,2008,sp,4554,21486,78815,100301
India,2008,sp,5564,14407,56928,71335
India,2008,sp,65,8357,36079,44436
India,2009,sp,014,8576,5001,13577
India,2009,sp,1524,51945,78177,130122
India,2009,sp,2534,49747,84003,133750
India,2009,sp,3544,33754,90830,124584
India,2009,sp,4554,22032,80097,102129
India,2009,sp,5564,14929,59163,74092
India,2009,sp,65,8944,37419,46363
India,2010,sp,014,8544,4871,13415
India,2010,sp,1524,53415,78278,131693
India,2010,sp,2534,49425,82757,132182
India,2010,sp,3544,34035,90440,124475
India,2010,sp,4554,22719,81210,103929
India,2010,sp,5564,15527,60766,76293
India,2010,sp,65,9735,38442,48177
India,2011,sp,014,8336,4649,12985
India,2011,sp,1524,53958,78096,132054
India,2011,sp,2534,49227,82762,131989
India,2011,sp,3544,34698,89706,124404
India,2011,sp,4554,23977,82921,106898
India,2011,sp,5564,17182,63625,80807
India,2011,sp,65,10731,42443,53174
India,2012,sp,014,8260,4697,12957
India,2012,sp,1524,53975,75502,129477
India,2012,sp,2534,47511,79594,127105
India,2012,sp,3544,33378,88111,121489
India,2012,sp,4554,23267,82356,105623
India,2012,sp,5564,17300,63814,81114
India,2012,sp,65,10502,41322,51824
Indonesia,1995,sp,014,16,6,22
Indonesia,1995,sp,1524,160,203,363
Indonesia,1995,sp,2534,244,297,541
Indonesia,1995,sp,3544,282,306,588
Indonesia,1995,sp,4554,192,302,494
Indonesia,1995,sp,5564,90,228,318
Indonesia,1995,sp,65,33,109,142
Indonesia,1996,sp,014,54,28,82
Indonesia,1996,sp,1524,860,781,1641
Indonesia,1996,sp,2534,1175,1349,2524
Indonesia,1996,sp,3544,1091,1443,2534
Indonesia,1996,sp,4554,915,1305,2220
Indonesia,1996,sp,5564,586,1037,1623
Indonesia,1996,sp,65,247,510,757
Indonesia,1997,sp,014,65,46,111
Indonesia,1997,sp,1524,1305,1320,2625
Indonesia,1997,sp,2534,1671,2139,3810
Indonesia,1997,sp,3544,1751,2221,3972
Indonesia,1997,sp,4554,1365,2122,3487
Indonesia,1997,sp,5564,788,1461,2249
Indonesia,1997,sp,65,357,753,1110
Indonesia,1998,sp,014,108,78,186
Indonesia,1998,sp,1524,2674,2732,5406
Indonesia,1998,sp,2534,3412,3873,7285
Indonesia,1998,sp,3544,3130,4054,7184
Indonesia,1998,sp,4554,2335,3486,5821
Indonesia,1998,sp,5564,1610,2654,4264
Indonesia,1998,sp,65,617,1517,2134
Indonesia,1999,sp,014,140,106,246
Indonesia,1999,sp,1524,3595,3741,7336
Indonesia,1999,sp,2534,12859,5277,18136
Indonesia,1999,sp,3544,3624,4999,8623
Indonesia,1999,sp,4554,2812,4401,7213
Indonesia,1999,sp,5564,1909,3267,5176
Indonesia,1999,sp,65,745,1697,2442
Indonesia,2001,sp,014,354,298,652
Indonesia,2001,sp,1524,5213,5400,10613
Indonesia,2001,sp,2534,6040,7279,13319
Indonesia,2001,sp,3544,4849,6241,11090
Indonesia,2001,sp,4554,3537,5538,9075
Indonesia,2001,sp,5564,2381,4076,6457
Indonesia,2001,sp,65,845,1914,2759
Indonesia,2002,sp,014,650,569,1219
Indonesia,2002,sp,1524,7366,7826,15192
Indonesia,2002,sp,2534,8794,10248,19042
Indonesia,2002,sp,3544,6773,8760,15533
Indonesia,2002,sp,4554,4943,7668,12611
Indonesia,2002,sp,5564,3118,5332,8450
Indonesia,2002,sp,65,1292,2891,4183
Indonesia,2003,sp,014,608,532,1140
Indonesia,2003,sp,1524,8734,9570,18304
Indonesia,2003,sp,2534,10127,12647,22774
Indonesia,2003,sp,3544,7889,10925,18814
Indonesia,2003,sp,4554,6085,9558,15643
Indonesia,2003,sp,5564,3907,6720,10627
Indonesia,2003,sp,65,1649,3615,5264
Indonesia,2004,sp,014,803,697,1500
Indonesia,2004,sp,1524,11509,12546,24055
Indonesia,2004,sp,2534,13597,17137,30734
Indonesia,2004,sp,3544,10953,14881,25834
Indonesia,2004,sp,4554,9586,14772,24358
Indonesia,2004,sp,5564,5422,9669,15091
Indonesia,2004,sp,65,2212,5197,7409
Indonesia,2005,sp,014,946,846,1792
Indonesia,2005,sp,1524,13916,15215,29131
Indonesia,2005,sp,2534,16393,20906,37299
Indonesia,2005,sp,3544,13022,18401,31423
Indonesia,2005,sp,4554,10927,17847,28774
Indonesia,2005,sp,5564,7539,13509,21048
Indonesia,2005,sp,65,2783,6390,9173
Indonesia,2006,sp,014,985,899,1884
Indonesia,2006,sp,1524,14377,16285,30662
Indonesia,2006,sp,2534,17628,22752,40380
Indonesia,2006,sp,3544,14421,20332,34753
Indonesia,2006,sp,4554,12376,20059,32435
Indonesia,2006,sp,5564,8786,15869,24655
Indonesia,2006,sp,65,3203,7348,10551
Indonesia,2007,ep,014,732,741,1473
Indonesia,2007,ep,1524,1387,924,2311
Indonesia,2007,ep,2534,1256,897,2153
Indonesia,2007,ep,3544,532,401,933
Indonesia,2007,ep,4554,299,318,617
Indonesia,2007,ep,5564,172,159,331
Indonesia,2007,ep,65,87,143,230
Indonesia,2007,sn,014,8689,9828,18517
Indonesia,2007,sn,1524,8119,8171,16290
Indonesia,2007,sn,2534,9237,11436,20673
Indonesia,2007,sn,3544,6490,8070,14560
Indonesia,2007,sn,4554,5866,7652,13518
Indonesia,2007,sn,5564,4700,7076,11776
Indonesia,2007,sn,65,2603,4676,7279
Indonesia,2007,sp,014,920,849,1769
Indonesia,2007,sp,1524,13371,14835,28206
Indonesia,2007,sp,2534,16055,21297,37352
Indonesia,2007,sp,3544,13211,18606,31817
Indonesia,2007,sp,4554,11391,18283,29674
Indonesia,2007,sp,5564,7965,14176,22141
Indonesia,2007,sp,65,2896,6762,9658
Indonesia,2008,ep,014,1047,1204,2251
Indonesia,2008,ep,1524,1452,1065,2517
Indonesia,2008,ep,2534,1348,1009,2357
Indonesia,2008,ep,3544,677,512,1189
Indonesia,2008,ep,4554,349,349,698
Indonesia,2008,ep,5564,207,229,436
Indonesia,2008,ep,65,78,147,225
Indonesia,2008,sn,014,13794,15518,29312
Indonesia,2008,sn,1524,8097,7891,15988
Indonesia,2008,sn,2534,9290,10913,20203
Indonesia,2008,sn,3544,7148,8421,15569
Indonesia,2008,sn,4554,6493,8313,14806
Indonesia,2008,sn,5564,5170,7871,13041
Indonesia,2008,sn,65,2656,5275,7931
Indonesia,2008,sp,014,1015,871,1886
Indonesia,2008,sp,1524,13987,15339,29326
Indonesia,2008,sp,2534,16292,22325,38617
Indonesia,2008,sp,3544,13513,19224,32737
Indonesia,2008,sp,4554,11899,18545,30444
Indonesia,2008,sp,5564,8485,14907,23392
Indonesia,2008,sp,65,3143,6831,9974
Indonesia,2009,ep,014,1139,1479,2618
Indonesia,2009,ep,1524,1540,1192,2732
Indonesia,2009,ep,2534,1484,1211,2695
Indonesia,2009,ep,3544,793,672,1465
Indonesia,2009,ep,4554,458,410,868
Indonesia,2009,ep,5564,253,301,554
Indonesia,2009,ep,65,115,168,283
Indonesia,2009,sn,014,12392,13787,26179
Indonesia,2009,sn,1524,7370,7318,14688
Indonesia,2009,sn,2534,8671,10334,19005
Indonesia,2009,sn,3544,6564,7976,14540
Indonesia,2009,sn,4554,6157,8049,14206
Indonesia,2009,sn,5564,4821,7585,12406
Indonesia,2009,sn,65,2587,5005,7592
Indonesia,2009,sp,014,1054,811,1865
Indonesia,2009,sp,1524,14039,15721,29760
Indonesia,2009,sp,2534,16914,23011,39925
Indonesia,2009,sp,3544,13481,19523,33004
Indonesia,2009,sp,4554,12087,19026,31113
Indonesia,2009,sp,5564,8558,15091,23649
Indonesia,2009,sp,65,3142,6755,9897
Indonesia,2010,ep,014,1098,1268,2366
Indonesia,2010,ep,1524,1749,1220,2969
Indonesia,2010,ep,2534,1679,1245,2924
Indonesia,2010,ep,3544,821,714,1535
Indonesia,2010,ep,4554,507,454,961
Indonesia,2010,ep,5564,266,323,589
Indonesia,2010,ep,65,116,199,315
Indonesia,2010,sn,014,11585,12831,24416
Indonesia,2010,sn,1524,6542,6941,13483
Indonesia,2010,sn,2534,8002,9711,17713
Indonesia,2010,sn,3544,5854,7406,13260
Indonesia,2010,sn,4554,5617,7688,13305
Indonesia,2010,sn,5564,4603,7244,11847
Indonesia,2010,sn,65,2429,4794,7223
Indonesia,2010,sp,014,816,714,1530
Indonesia,2010,sp,1524,14800,16501,31301
Indonesia,2010,sp,2534,17838,24645,42483
Indonesia,2010,sp,3544,14629,21090,35719
Indonesia,2010,sp,4554,13142,20977,34119
Indonesia,2010,sp,5564,9524,17329,26853
Indonesia,2010,sp,65,3451,7910,11361
Indonesia,2011,ep,014,1258,1518,2776
Indonesia,2011,ep,1524,2063,1554,3617
Indonesia,2011,ep,2534,2007,1539,3546
Indonesia,2011,ep,3544,1061,825,1886
Indonesia,2011,ep,4554,537,532,1069
Indonesia,2011,ep,5564,348,401,749
Indonesia,2011,ep,65,164,247,411
Indonesia,2011,sn,014,11129,12340,23469
Indonesia,2011,sn,1524,6916,6828,13744
Indonesia,2011,sn,2534,7585,9696,17281
Indonesia,2011,sn,3544,6044,7588,13632
Indonesia,2011,sn,4554,5793,7541,13334
Indonesia,2011,sn,5564,4848,7734,12582
Indonesia,2011,sn,65,2525,5183,7708
Indonesia,2011,sp,014,927,787,1714
Indonesia,2011,sp,1524,15840,17406,33246
Indonesia,2011,sp,2534,18703,25429,44132
Indonesia,2011,sp,3544,15900,22353,38253
Indonesia,2011,sp,4554,14533,22885,37418
Indonesia,2011,sp,5564,10556,19404,29960
Indonesia,2011,sp,65,3985,9089,13074
Indonesia,2012,ep,014,1276,1408,2684
Indonesia,2012,ep,1524,2382,1700,4082
Indonesia,2012,ep,2534,2223,1742,3965
Indonesia,2012,ep,3544,1242,946,2188
Indonesia,2012,ep,4554,768,634,1402
Indonesia,2012,ep,5564,357,512,869
Indonesia,2012,ep,65,203,304,507
Indonesia,2012,sn,014,10883,12073,22956
Indonesia,2012,sn,1524,7092,7233,14325
Indonesia,2012,sn,2534,7898,9736,17634
Indonesia,2012,sn,3544,6127,8059,14186
Indonesia,2012,sn,4554,6055,8240,14295
Indonesia,2012,sn,5564,5072,8125,13197
Indonesia,2012,sn,65,2856,5417,8273
Indonesia,2012,sp,014,879,824,1703
Indonesia,2012,sp,1524,15875,17304,33179
Indonesia,2012,sp,2534,18484,25460,43944
Indonesia,2012,sp,3544,16146,23057,39203
Indonesia,2012,sp,4554,15215,23751,38966
Indonesia,2012,sp,5564,11321,20204,31525
Indonesia,2012,sp,65,4245,9554,13799
Indonesia,2013,rel,014,12638,13416,26054
Indonesia,2013,rel,1524,25691,26056,51747
Indonesia,2013,rel,2534,28125,37102,65227
Indonesia,2013,rel,3544,23714,32925,56639
Indonesia,2013,rel,4554,22172,33737,55909
Indonesia,2013,rel,5564,16978,30440,47418
Indonesia,2013,rel,65,7290,15298,22588
Iran (Islamic Republic of),1995,sp,014,234,118,352
Iran (Islamic Republic of),1995,sp,1524,1039,751,1790
Iran (Islamic Republic of),1995,sp,2534,890,754,1644
Iran (Islamic Republic of),1995,sp,3544,664,636,1300
Iran (Islamic Republic of),1995,sp,4554,613,494,1107
Iran (Islamic Republic of),1995,sp,5564,685,737,1422
Iran (Islamic Republic of),1995,sp,65,788,921,1709
Iran (Islamic Republic of),1996,sp,014,113,63,176
Iran (Islamic Republic of),1996,sp,1524,599,390,989
Iran (Islamic Republic of),1996,sp,2534,412,449,861
Iran (Islamic Republic of),1996,sp,3544,347,431,778
Iran (Islamic Republic of),1996,sp,4554,323,274,597
Iran (Islamic Republic of),1996,sp,5564,452,450,902
Iran (Islamic Republic of),1996,sp,65,534,577,1111
Iran (Islamic Republic of),1997,sp,014,92,54,146
Iran (Islamic Republic of),1997,sp,1524,518,391,909
Iran (Islamic Republic of),1997,sp,2534,393,470,863
Iran (Islamic Republic of),1997,sp,3544,361,420,781
Iran (Islamic Republic of),1997,sp,4554,342,304,646
Iran (Islamic Republic of),1997,sp,5564,341,395,736
Iran (Islamic Republic of),1997,sp,65,582,608,1190
Iran (Islamic Republic of),1998,sp,014,87,35,122
Iran (Islamic Republic of),1998,sp,1524,561,426,987
Iran (Islamic Republic of),1998,sp,2534,403,492,895
Iran (Islamic Republic of),1998,sp,3544,307,400,707
Iran (Islamic Republic of),1998,sp,4554,290,245,535
Iran (Islamic Republic of),1998,sp,5564,431,363,794
Iran (Islamic Republic of),1998,sp,65,522,579,1101
Iran (Islamic Republic of),1999,sp,014,51,27,78
Iran (Islamic Republic of),1999,sp,1524,551,370,921
Iran (Islamic Republic of),1999,sp,2534,360,460,820
Iran (Islamic Republic of),1999,sp,3544,277,383,660
Iran (Islamic Republic of),1999,sp,4554,279,260,539
Iran (Islamic Republic of),1999,sp,5564,396,335,731
Iran (Islamic Republic of),1999,sp,65,637,591,1228
Iran (Islamic Republic of),2000,sp,014,77,29,106
Iran (Islamic Republic of),2000,sp,1524,593,438,1031
Iran (Islamic Republic of),2000,sp,2534,410,467,877
Iran (Islamic Republic of),2000,sp,3544,322,387,709
Iran (Islamic Republic of),2000,sp,4554,320,295,615
Iran (Islamic Republic of),2000,sp,5564,407,344,751
Iran (Islamic Republic of),2000,sp,65,647,642,1289
Iran (Islamic Republic of),2001,sp,014,104,37,141
Iran (Islamic Republic of),2001,sp,1524,621,469,1090
Iran (Islamic Republic of),2001,sp,2534,401,529,930
Iran (Islamic Republic of),2001,sp,3544,278,371,649
Iran (Islamic Republic of),2001,sp,4554,327,309,636
Iran (Islamic Republic of),2001,sp,5564,442,299,741
Iran (Islamic Republic of),2001,sp,65,693,649,1342
Iran (Islamic Republic of),2002,sp,014,77,29,106
Iran (Islamic Republic of),2002,sp,1524,558,457,1015
Iran (Islamic Republic of),2002,sp,2534,332,502,834
Iran (Islamic Republic of),2002,sp,3544,275,375,650
Iran (Islamic Republic of),2002,sp,4554,298,322,620
Iran (Islamic Republic of),2002,sp,5564,439,302,741
Iran (Islamic Republic of),2002,sp,65,732,668,1400
Iran (Islamic Republic of),2003,sp,014,76,32,108
Iran (Islamic Republic of),2003,sp,1524,442,413,855
Iran (Islamic Republic of),2003,sp,2534,282,528,810
Iran (Islamic Republic of),2003,sp,3544,254,396,650
Iran (Islamic Republic of),2003,sp,4554,300,282,582
Iran (Islamic Republic of),2003,sp,5564,440,294,734
Iran (Islamic Republic of),2003,sp,65,776,673,1449
Iran (Islamic Republic of),2004,sp,014,65,16,81
Iran (Islamic Republic of),2004,sp,1524,419,360,779
Iran (Islamic Republic of),2004,sp,2534,301,542,843
Iran (Islamic Republic of),2004,sp,3544,213,357,570
Iran (Islamic Republic of),2004,sp,4554,293,305,598
Iran (Islamic Republic of),2004,sp,5564,378,298,676
Iran (Islamic Republic of),2004,sp,65,710,640,1350
Iran (Islamic Republic of),2005,sp,014,45,16,61
Iran (Islamic Republic of),2005,sp,1524,394,352,746
Iran (Islamic Republic of),2005,sp,2534,205,531,736
Iran (Islamic Republic of),2005,sp,3544,186,338,524
Iran (Islamic Republic of),2005,sp,4554,260,281,541
Iran (Islamic Republic of),2005,sp,5564,382,260,642
Iran (Islamic Republic of),2005,sp,65,701,630,1331
Iran (Islamic Republic of),2006,ep,014,80,69,149
Iran (Islamic Republic of),2006,ep,1524,250,212,462
Iran (Islamic Republic of),2006,ep,2534,245,237,482
Iran (Islamic Republic of),2006,ep,3544,234,179,413
Iran (Islamic Republic of),2006,ep,4554,195,152,347
Iran (Islamic Republic of),2006,ep,5564,115,95,210
Iran (Islamic Republic of),2006,ep,65,136,187,323
Iran (Islamic Republic of),2006,sn,014,43,36,79
Iran (Islamic Republic of),2006,sn,1524,106,84,190
Iran (Islamic Republic of),2006,sn,2534,77,155,232
Iran (Islamic Republic of),2006,sn,3544,94,127,221
Iran (Islamic Republic of),2006,sn,4554,123,101,224
Iran (Islamic Republic of),2006,sn,5564,175,117,292
Iran (Islamic Republic of),2006,sn,65,328,300,628
Iran (Islamic Republic of),2006,sp,014,48,12,60
Iran (Islamic Republic of),2006,sp,1524,430,357,787
Iran (Islamic Republic of),2006,sp,2534,236,495,731
Iran (Islamic Republic of),2006,sp,3544,185,365,550
Iran (Islamic Republic of),2006,sp,4554,292,318,610
Iran (Islamic Republic of),2006,sp,5564,336,249,585
Iran (Islamic Republic of),2006,sp,65,793,686,1479
Iran (Islamic Republic of),2007,ep,014,84,62,146
Iran (Islamic Republic of),2007,ep,1524,270,180,450
Iran (Islamic Republic of),2007,ep,2534,289,219,508
Iran (Islamic Republic of),2007,ep,3544,221,175,396
Iran (Islamic Republic of),2007,ep,4554,222,151,373
Iran (Islamic Republic of),2007,ep,5564,144,110,254
Iran (Islamic Republic of),2007,ep,65,171,217,388
Iran (Islamic Republic of),2007,sn,014,51,52,103
Iran (Islamic Republic of),2007,sn,1524,126,67,193
Iran (Islamic Republic of),2007,sn,2534,71,136,207
Iran (Islamic Republic of),2007,sn,3544,67,119,186
Iran (Islamic Republic of),2007,sn,4554,109,118,227
Iran (Islamic Republic of),2007,sn,5564,156,121,277
Iran (Islamic Republic of),2007,sn,65,325,312,637
Iran (Islamic Republic of),2007,sp,014,42,10,52
Iran (Islamic Republic of),2007,sp,1524,394,311,705
Iran (Islamic Republic of),2007,sp,2534,236,511,747
Iran (Islamic Republic of),2007,sp,3544,173,330,503
Iran (Islamic Republic of),2007,sp,4554,268,285,553
Iran (Islamic Republic of),2007,sp,5564,387,261,648
Iran (Islamic Republic of),2007,sp,65,813,680,1493
Iran (Islamic Republic of),2008,ep,014,79,55,134
Iran (Islamic Republic of),2008,ep,1524,292,179,471
Iran (Islamic Republic of),2008,ep,2534,310,243,553
Iran (Islamic Republic of),2008,ep,3544,251,183,434
Iran (Islamic Republic of),2008,ep,4554,218,135,353
Iran (Islamic Republic of),2008,ep,5564,146,121,267
Iran (Islamic Republic of),2008,ep,65,144,213,357
Iran (Islamic Republic of),2008,sn,014,50,59,109
Iran (Islamic Republic of),2008,sn,1524,112,90,202
Iran (Islamic Republic of),2008,sn,2534,77,131,208
Iran (Islamic Republic of),2008,sn,3544,62,120,182
Iran (Islamic Republic of),2008,sn,4554,129,103,232
Iran (Islamic Republic of),2008,sn,5564,141,124,265
Iran (Islamic Republic of),2008,sn,65,343,324,667
Iran (Islamic Republic of),2008,sp,014,42,11,53
Iran (Islamic Republic of),2008,sp,1524,386,292,678
Iran (Islamic Republic of),2008,sp,2534,254,466,720
Iran (Islamic Republic of),2008,sp,3544,137,330,467
Iran (Islamic Republic of),2008,sp,4554,263,322,585
Iran (Islamic Republic of),2008,sp,5564,367,267,634
Iran (Islamic Republic of),2008,sp,65,879,706,1585
Iran (Islamic Republic of),2009,ep,014,87,74,161
Iran (Islamic Republic of),2009,ep,1524,245,177,422
Iran (Islamic Republic of),2009,ep,2534,307,227,534
Iran (Islamic Republic of),2009,ep,3544,259,184,443
Iran (Islamic Republic of),2009,ep,4554,251,159,410
Iran (Islamic Republic of),2009,ep,5564,170,128,298
Iran (Islamic Republic of),2009,ep,65,190,227,417
Iran (Islamic Republic of),2009,sn,014,71,47,118
Iran (Islamic Republic of),2009,sn,1524,118,92,210
Iran (Islamic Republic of),2009,sn,2534,83,139,222
Iran (Islamic Republic of),2009,sn,3544,86,128,214
Iran (Islamic Republic of),2009,sn,4554,99,100,199
Iran (Islamic Republic of),2009,sn,5564,158,137,295
Iran (Islamic Republic of),2009,sn,65,352,316,668
Iran (Islamic Republic of),2009,sp,014,46,15,61
Iran (Islamic Republic of),2009,sp,1524,455,302,757
Iran (Islamic Republic of),2009,sp,2534,276,509,785
Iran (Islamic Republic of),2009,sp,3544,210,305,515
Iran (Islamic Republic of),2009,sp,4554,273,335,608
Iran (Islamic Republic of),2009,sp,5564,396,326,722
Iran (Islamic Republic of),2009,sp,65,951,753,1704
Iran (Islamic Republic of),2010,ep,014,73,79,152
Iran (Islamic Republic of),2010,ep,1524,255,191,446
Iran (Islamic Republic of),2010,ep,2534,354,247,601
Iran (Islamic Republic of),2010,ep,3544,287,231,518
Iran (Islamic Republic of),2010,ep,4554,234,158,392
Iran (Islamic Republic of),2010,ep,5564,186,139,325
Iran (Islamic Republic of),2010,ep,65,194,241,435
Iran (Islamic Republic of),2010,sn,014,69,59,128
Iran (Islamic Republic of),2010,sn,1524,125,93,218
Iran (Islamic Republic of),2010,sn,2534,102,134,236
Iran (Islamic Republic of),2010,sn,3544,77,109,186
Iran (Islamic Republic of),2010,sn,4554,106,118,224
Iran (Islamic Republic of),2010,sn,5564,162,123,285
Iran (Islamic Republic of),2010,sn,65,377,331,708
Iran (Islamic Republic of),2010,sp,014,54,18,72
Iran (Islamic Republic of),2010,sp,1524,433,292,725
Iran (Islamic Republic of),2010,sp,2534,288,487,775
Iran (Islamic Republic of),2010,sp,3544,208,354,562
Iran (Islamic Republic of),2010,sp,4554,276,296,572
Iran (Islamic Republic of),2010,sp,5564,398,310,708
Iran (Islamic Republic of),2010,sp,65,1014,760,1774
Iran (Islamic Republic of),2011,ep,014,95,82,177
Iran (Islamic Republic of),2011,ep,1524,272,204,476
Iran (Islamic Republic of),2011,ep,2534,428,262,690
Iran (Islamic Republic of),2011,ep,3544,304,180,484
Iran (Islamic Republic of),2011,ep,4554,271,196,467
Iran (Islamic Republic of),2011,ep,5564,200,148,348
Iran (Islamic Republic of),2011,ep,65,178,256,434
Iran (Islamic Republic of),2011,sn,014,57,61,118
Iran (Islamic Republic of),2011,sn,1524,107,86,193
Iran (Islamic Republic of),2011,sn,2534,97,162,259
Iran (Islamic Republic of),2011,sn,3544,70,124,194
Iran (Islamic Republic of),2011,sn,4554,119,113,232
Iran (Islamic Republic of),2011,sn,5564,149,142,291
Iran (Islamic Republic of),2011,sn,65,362,331,693
Iran (Islamic Republic of),2011,sp,014,37,13,50
Iran (Islamic Republic of),2011,sp,1524,473,289,762
Iran (Islamic Republic of),2011,sp,2534,313,543,856
Iran (Islamic Republic of),2011,sp,3544,184,398,582
Iran (Islamic Republic of),2011,sp,4554,296,315,611
Iran (Islamic Republic of),2011,sp,5564,441,351,792
Iran (Islamic Republic of),2011,sp,65,1009,877,1886
Iran (Islamic Republic of),2012,ep,014,81,97,178
Iran (Islamic Republic of),2012,ep,1524,258,182,440
Iran (Islamic Republic of),2012,ep,2534,410,286,696
Iran (Islamic Republic of),2012,ep,3544,323,222,545
Iran (Islamic Republic of),2012,ep,4554,260,174,434
Iran (Islamic Republic of),2012,ep,5564,231,170,401
Iran (Islamic Republic of),2012,ep,65,169,242,411
Iran (Islamic Republic of),2012,sn,014,74,90,164
Iran (Islamic Republic of),2012,sn,1524,115,88,203
Iran (Islamic Republic of),2012,sn,2534,113,187,300
Iran (Islamic Republic of),2012,sn,3544,80,141,221
Iran (Islamic Republic of),2012,sn,4554,116,109,225
Iran (Islamic Republic of),2012,sn,5564,200,141,341
Iran (Islamic Republic of),2012,sn,65,385,352,737
Iran (Islamic Republic of),2012,sp,014,43,16,59
Iran (Islamic Republic of),2012,sp,1524,434,288,722
Iran (Islamic Republic of),2012,sp,2534,318,601,919
Iran (Islamic Republic of),2012,sp,3544,206,442,648
Iran (Islamic Republic of),2012,sp,4554,252,303,555
Iran (Islamic Republic of),2012,sp,5564,374,317,691
Iran (Islamic Republic of),2012,sp,65,965,850,1815
Iran (Islamic Republic of),2013,rel,014,227,193,420
Iran (Islamic Republic of),2013,rel,1524,795,541,1336
Iran (Islamic Republic of),2013,rel,2534,827,1174,2001
Iran (Islamic Republic of),2013,rel,3544,553,892,1445
Iran (Islamic Republic of),2013,rel,4554,616,652,1268
Iran (Islamic Republic of),2013,rel,5564,783,658,1441
Iran (Islamic Republic of),2013,rel,65,1653,1488,3141
Iraq,1995,sp,014,725,1125,1850
Iraq,1995,sp,1524,304,862,1166
Iraq,1995,sp,2534,1208,1409,2617
Iraq,1995,sp,3544,915,1085,2000
Iraq,1995,sp,4554,800,863,1663
Iraq,1995,sp,5564,886,900,1786
Iraq,1995,sp,65,200,271,471
Iraq,1997,sp,014,384,416,800
Iraq,1997,sp,1524,738,791,1529
Iraq,1997,sp,2534,665,708,1373
Iraq,1997,sp,3544,499,541,1040
Iraq,1997,sp,4554,722,832,1554
Iraq,1997,sp,5564,641,664,1305
Iraq,1997,sp,65,192,208,400
Iraq,1998,sp,014,426,453,879
Iraq,1998,sp,1524,806,879,1685
Iraq,1998,sp,2534,740,781,1521
Iraq,1998,sp,3544,542,583,1125
Iraq,1998,sp,4554,806,913,1719
Iraq,1998,sp,5564,712,735,1447
Iraq,1998,sp,65,232,242,474
Iraq,1999,sp,014,509,519,1028
Iraq,1999,sp,1524,1208,1434,2642
Iraq,1999,sp,2534,978,1246,2224
Iraq,1999,sp,3544,824,1081,1905
Iraq,1999,sp,4554,571,704,1275
Iraq,1999,sp,5564,527,632,1159
Iraq,1999,sp,65,202,376,578
Iraq,2000,sp,014,37,21,58
Iraq,2000,sp,1524,338,627,965
Iraq,2000,sp,2534,241,317,558
Iraq,2000,sp,3544,136,297,433
Iraq,2000,sp,4554,134,205,339
Iraq,2000,sp,5564,103,135,238
Iraq,2000,sp,65,87,101,188
Iraq,2001,sp,014,26,10,36
Iraq,2001,sp,1524,362,722,1084
Iraq,2001,sp,2534,295,737,1032
Iraq,2001,sp,3544,147,275,422
Iraq,2001,sp,4554,171,260,431
Iraq,2001,sp,5564,126,200,326
Iraq,2001,sp,65,86,142,228
Iraq,2002,sp,014,45,47,92
Iraq,2002,sp,1524,338,706,1044
Iraq,2002,sp,2534,288,923,1211
Iraq,2002,sp,3544,172,308,480
Iraq,2002,sp,4554,176,284,460
Iraq,2002,sp,5564,129,205,334
Iraq,2002,sp,65,116,158,274
Iraq,2003,sp,014,43,30,73
Iraq,2003,sp,1524,258,659,917
Iraq,2003,sp,2534,241,876,1117
Iraq,2003,sp,3544,154,355,509
Iraq,2003,sp,4554,160,293,453
Iraq,2003,sp,5564,143,168,311
Iraq,2003,sp,65,34,143,177
Iraq,2004,sp,014,57,28,85
Iraq,2004,sp,1524,334,615,949
Iraq,2004,sp,2534,243,770,1013
Iraq,2004,sp,3544,139,288,427
Iraq,2004,sp,4554,162,244,406
Iraq,2004,sp,5564,113,183,296
Iraq,2004,sp,65,80,125,205
Iraq,2005,sp,014,44,13,57
Iraq,2005,sp,1524,305,424,729
Iraq,2005,sp,2534,260,644,904
Iraq,2005,sp,3544,151,261,412
Iraq,2005,sp,4554,197,245,442
Iraq,2005,sp,5564,135,189,324
Iraq,2005,sp,65,80,148,228
Iraq,2006,ep,014,123,120,243
Iraq,2006,ep,1524,281,310,591
Iraq,2006,ep,2534,291,321,612
Iraq,2006,ep,3544,188,162,350
Iraq,2006,ep,4554,142,121,263
Iraq,2006,ep,5564,91,69,160
Iraq,2006,ep,65,79,77,156
Iraq,2006,sn,014,122,75,197
Iraq,2006,sn,1524,201,165,366
Iraq,2006,sn,2534,158,237,395
Iraq,2006,sn,3544,127,140,267
Iraq,2006,sn,4554,167,141,308
Iraq,2006,sn,5564,136,167,303
Iraq,2006,sn,65,147,196,343
Iraq,2006,sp,014,38,14,52
Iraq,2006,sp,1524,338,409,747
Iraq,2006,sp,2534,264,593,857
Iraq,2006,sp,3544,133,278,411
Iraq,2006,sp,4554,154,230,384
Iraq,2006,sp,5564,111,147,258
Iraq,2006,sp,65,70,107,177
Iraq,2007,ep,014,90,120,210
Iraq,2007,ep,1524,286,279,565
Iraq,2007,ep,2534,270,292,562
Iraq,2007,ep,3544,180,178,358
Iraq,2007,ep,4554,120,125,245
Iraq,2007,ep,5564,101,86,187
Iraq,2007,ep,65,72,91,163
Iraq,2007,sn,014,93,80,173
Iraq,2007,sn,1524,195,177,372
Iraq,2007,sn,2534,155,249,404
Iraq,2007,sn,3544,123,159,282
Iraq,2007,sn,4554,187,154,341
Iraq,2007,sn,5564,155,183,338
Iraq,2007,sn,65,152,231,383
Iraq,2007,sp,014,34,20,54
Iraq,2007,sp,1524,289,319,608
Iraq,2007,sp,2534,228,531,759
Iraq,2007,sp,3544,154,276,430
Iraq,2007,sp,4554,134,223,357
Iraq,2007,sp,5564,130,188,318
Iraq,2007,sp,65,74,126,200
Iraq,2008,ep,014,161,146,307
Iraq,2008,ep,1524,331,286,617
Iraq,2008,ep,2534,312,286,598
Iraq,2008,ep,3544,206,179,385
Iraq,2008,ep,4554,191,114,305
Iraq,2008,ep,5564,155,130,285
Iraq,2008,ep,65,102,119,221
Iraq,2008,sn,014,107,110,217
Iraq,2008,sn,1524,243,233,476
Iraq,2008,sn,2534,201,246,447
Iraq,2008,sn,3544,152,154,306
Iraq,2008,sn,4554,172,168,340
Iraq,2008,sn,5564,210,205,415
Iraq,2008,sn,65,201,325,526
Iraq,2008,sp,014,54,18,72
Iraq,2008,sp,1524,377,348,725
Iraq,2008,sp,2534,281,525,806
Iraq,2008,sp,3544,125,317,442
Iraq,2008,sp,4554,175,273,448
Iraq,2008,sp,5564,161,224,385
Iraq,2008,sp,65,125,147,272
Iraq,2009,ep,014,162,175,337
Iraq,2009,ep,1524,317,329,646
Iraq,2009,ep,2534,334,315,649
Iraq,2009,ep,3544,217,211,428
Iraq,2009,ep,4554,215,150,365
Iraq,2009,ep,5564,139,120,259
Iraq,2009,ep,65,122,98,220
Iraq,2009,sn,014,125,111,236
Iraq,2009,sn,1524,218,216,434
Iraq,2009,sn,2534,154,225,379
Iraq,2009,sn,3544,167,203,370
Iraq,2009,sn,4554,201,170,371
Iraq,2009,sn,5564,180,189,369
Iraq,2009,sn,65,222,285,507
Iraq,2009,sp,014,63,33,96
Iraq,2009,sp,1524,361,377,738
Iraq,2009,sp,2534,294,506,800
Iraq,2009,sp,3544,186,340,526
Iraq,2009,sp,4554,216,263,479
Iraq,2009,sp,5564,158,213,371
Iraq,2009,sp,65,141,196,337
Iraq,2010,ep,014,156,191,347
Iraq,2010,ep,1524,335,297,632
Iraq,2010,ep,2534,328,342,670
Iraq,2010,ep,3544,267,210,477
Iraq,2010,ep,4554,211,133,344
Iraq,2010,ep,5564,174,124,298
Iraq,2010,ep,65,107,134,241
Iraq,2010,sn,014,121,108,229
Iraq,2010,sn,1524,201,189,390
Iraq,2010,sn,2534,186,204,390
Iraq,2010,sn,3544,153,176,329
Iraq,2010,sn,4554,210,170,380
Iraq,2010,sn,5564,206,215,421
Iraq,2010,sn,65,257,297,554
Iraq,2010,sp,014,73,42,115
Iraq,2010,sp,1524,394,370,764
Iraq,2010,sp,2534,294,482,776
Iraq,2010,sp,3544,198,384,582
Iraq,2010,sp,4554,205,276,481
Iraq,2010,sp,5564,220,286,506
Iraq,2010,sp,65,166,228,394
Iraq,2011,ep,014,172,213,385
Iraq,2011,ep,1524,326,294,620
Iraq,2011,ep,2534,323,274,597
Iraq,2011,ep,3544,245,174,419
Iraq,2011,ep,4554,202,145,347
Iraq,2011,ep,5564,183,129,312
Iraq,2011,ep,65,152,125,277
Iraq,2011,sn,014,124,117,241
Iraq,2011,sn,1524,216,165,381
Iraq,2011,sn,2534,156,168,324
Iraq,2011,sn,3544,157,146,303
Iraq,2011,sn,4554,163,114,277
Iraq,2011,sn,5564,213,233,446
Iraq,2011,sn,65,222,269,491
Iraq,2011,sp,014,66,35,101
Iraq,2011,sp,1524,368,304,672
Iraq,2011,sp,2534,258,395,653
Iraq,2011,sp,3544,164,313,477
Iraq,2011,sp,4554,159,237,396
Iraq,2011,sp,5564,201,223,424
Iraq,2011,sp,65,153,183,336
Iraq,2012,ep,014,188,185,373
Iraq,2012,ep,1524,390,271,661
Iraq,2012,ep,2534,350,288,638
Iraq,2012,ep,3544,310,198,508
Iraq,2012,ep,4554,269,151,420
Iraq,2012,ep,5564,195,142,337
Iraq,2012,ep,65,198,126,324
Iraq,2012,sn,014,113,98,211
Iraq,2012,sn,1524,202,154,356
Iraq,2012,sn,2534,156,152,308
Iraq,2012,sn,3544,123,133,256
Iraq,2012,sn,4554,134,147,281
Iraq,2012,sn,5564,195,182,377
Iraq,2012,sn,65,257,269,526
Iraq,2012,sp,014,36,27,63
Iraq,2012,sp,1524,340,283,623
Iraq,2012,sp,2534,225,317,542
Iraq,2012,sp,3544,154,263,417
Iraq,2012,sp,4554,186,203,389
Iraq,2012,sp,5564,174,203,377
Iraq,2012,sp,65,169,180,349
Iraq,2013,rel,014,350,321,671
Iraq,2013,rel,1524,819,693,1512
Iraq,2013,rel,2534,781,772,1553
Iraq,2013,rel,3544,592,675,1267
Iraq,2013,rel,4554,614,588,1202
Iraq,2013,rel,5564,577,555,1132
Iraq,2013,rel,65,605,612,1217
Ireland,1998,sp,014,0,1,1
Ireland,1998,sp,1524,5,11,16
Ireland,1998,sp,2534,11,8,19
Ireland,1998,sp,3544,1,21,22
Ireland,1998,sp,4554,1,8,9
Ireland,1998,sp,5564,4,8,12
Ireland,1998,sp,65,13,19,32
Ireland,1999,sp,014,0,0,0
Ireland,1999,sp,1524,9,7,16
Ireland,1999,sp,2534,9,15,24
Ireland,1999,sp,3544,3,10,13
Ireland,1999,sp,4554,8,12,20
Ireland,1999,sp,5564,3,7,10
Ireland,1999,sp,65,13,19,32
Ireland,2000,sp,014,0,0,0
Ireland,2000,sp,1524,13,10,23
Ireland,2000,sp,2534,8,7,15
Ireland,2000,sp,3544,13,7,20
Ireland,2000,sp,4554,6,6,12
Ireland,2000,sp,5564,7,4,11
Ireland,2000,sp,65,15,12,27
Ireland,2001,sp,014,0,0,0
Ireland,2001,sp,1524,4,6,10
Ireland,2001,sp,2534,6,12,18
Ireland,2001,sp,3544,3,14,17
Ireland,2001,sp,4554,1,8,9
Ireland,2001,sp,5564,1,7,8
Ireland,2001,sp,65,5,7,12
Ireland,2002,sp,014,0,0,0
Ireland,2002,sp,1524,4,7,11
Ireland,2002,sp,2534,3,18,21
Ireland,2002,sp,3544,5,13,18
Ireland,2002,sp,4554,2,14,16
Ireland,2002,sp,5564,0,12,12
Ireland,2002,sp,65,4,6,10
Ireland,2003,sp,014,0,0,0
Ireland,2003,sp,1524,4,10,14
Ireland,2003,sp,2534,7,11,18
Ireland,2003,sp,3544,6,13,19
Ireland,2003,sp,4554,4,14,18
Ireland,2003,sp,5564,1,7,8
Ireland,2003,sp,65,10,11,21
Ireland,2004,sp,014,0,1,1
Ireland,2004,sp,1524,10,4,14
Ireland,2004,sp,2534,9,17,26
Ireland,2004,sp,3544,2,10,12
Ireland,2004,sp,4554,2,12,14
Ireland,2004,sp,5564,3,7,10
Ireland,2004,sp,65,6,10,16
Ireland,2005,sp,014,0,1,1
Ireland,2005,sp,1524,9,6,15
Ireland,2005,sp,2534,10,10,20
Ireland,2005,sp,3544,3,21,24
Ireland,2005,sp,4554,3,10,13
Ireland,2005,sp,5564,0,7,7
Ireland,2005,sp,65,8,6,14
Ireland,2006,ep,014,3,2,5
Ireland,2006,ep,1524,4,4,8
Ireland,2006,ep,2534,11,19,30
Ireland,2006,ep,3544,6,15,21
Ireland,2006,ep,4554,3,7,10
Ireland,2006,ep,5564,2,6,8
Ireland,2006,ep,65,8,9,17
Ireland,2006,sn,014,5,8,13
Ireland,2006,sn,1524,20,12,32
Ireland,2006,sn,2534,19,21,40
Ireland,2006,sn,3544,10,14,24
Ireland,2006,sn,4554,4,11,15
Ireland,2006,sn,5564,4,11,15
Ireland,2006,sn,65,14,26,40
Ireland,2006,sp,014,0,0,0
Ireland,2006,sp,1524,11,8,19
Ireland,2006,sp,2534,20,18,38
Ireland,2006,sp,3544,8,17,25
Ireland,2006,sp,4554,4,11,15
Ireland,2006,sp,5564,3,16,19
Ireland,2006,sp,65,3,13,16
Ireland,2007,ep,014,2,0,2
Ireland,2007,ep,1524,14,16,30
Ireland,2007,ep,2534,28,46,74
Ireland,2007,ep,3544,24,28,52
Ireland,2007,ep,4554,6,8,14
Ireland,2007,ep,5564,10,14,24
Ireland,2007,ep,65,10,16,26
Ireland,2007,sn,014,39,41,80
Ireland,2007,sn,1524,21,32,53
Ireland,2007,sn,2534,53,53,106
Ireland,2007,sn,3544,28,52,80
Ireland,2007,sn,4554,13,14,27
Ireland,2007,sn,5564,9,20,29
Ireland,2007,sn,65,35,51,86
Ireland,2007,sp,014,0,0,0
Ireland,2007,sp,1524,14,26,40
Ireland,2007,sp,2534,28,49,77
Ireland,2007,sp,3544,22,32,54
Ireland,2007,sp,4554,14,28,42
Ireland,2007,sp,5564,2,26,28
Ireland,2007,sp,65,4,26,30
Ireland,2008,ep,014,2,0,2
Ireland,2008,ep,1524,6,8,14
Ireland,2008,ep,2534,13,10,23
Ireland,2008,ep,3544,5,15,20
Ireland,2008,ep,4554,6,4,10
Ireland,2008,ep,5564,2,3,5
Ireland,2008,ep,65,5,2,7
Ireland,2008,sn,014,6,4,10
Ireland,2008,sn,1524,8,4,12
Ireland,2008,sn,2534,12,15,27
Ireland,2008,sn,3544,2,14,16
Ireland,2008,sn,4554,3,12,15
Ireland,2008,sn,5564,3,13,16
Ireland,2008,sn,65,9,19,28
Ireland,2008,sp,014,0,2,2
Ireland,2008,sp,1524,12,9,21
Ireland,2008,sp,2534,16,18,34
Ireland,2008,sp,3544,8,6,14
Ireland,2008,sp,4554,3,21,24
Ireland,2008,sp,5564,3,10,13
Ireland,2008,sp,65,2,13,15
Ireland,2009,ep,014,1,4,5
Ireland,2009,ep,1524,11,9,20
Ireland,2009,ep,2534,11,27,38
Ireland,2009,ep,3544,11,12,23
Ireland,2009,ep,4554,5,10,15
Ireland,2009,ep,5564,4,7,11
Ireland,2009,ep,65,4,9,13
Ireland,2009,sn,014,5,4,9
Ireland,2009,sn,1524,2,8,10
Ireland,2009,sn,2534,13,15,28
Ireland,2009,sn,3544,13,11,24
Ireland,2009,sn,4554,6,13,19
Ireland,2009,sn,5564,7,11,18
Ireland,2009,sn,65,8,14,22
Ireland,2009,sp,014,3,0,3
Ireland,2009,sp,1524,5,5,10
Ireland,2009,sp,2534,13,19,32
Ireland,2009,sp,3544,7,13,20
Ireland,2009,sp,4554,1,12,13
Ireland,2009,sp,5564,3,10,13
Ireland,2009,sp,65,3,12,15
Ireland,2010,ep,014,2,4,6
Ireland,2010,ep,1524,9,7,16
Ireland,2010,ep,2534,12,20,32
Ireland,2010,ep,3544,9,20,29
Ireland,2010,ep,4554,4,5,9
Ireland,2010,ep,5564,1,3,4
Ireland,2010,ep,65,6,13,19
Ireland,2010,sn,014,1,10,11
Ireland,2010,sn,1524,13,8,21
Ireland,2010,sn,2534,8,21,29
Ireland,2010,sn,3544,7,15,22
Ireland,2010,sn,4554,5,7,12
Ireland,2010,sn,5564,4,5,9
Ireland,2010,sn,65,13,10,23
Ireland,2010,sp,014,0,0,0
Ireland,2010,sp,1524,8,8,16
Ireland,2010,sp,2534,8,17,25
Ireland,2010,sp,3544,2,4,6
Ireland,2010,sp,4554,2,13,15
Ireland,2010,sp,5564,2,5,7
Ireland,2010,sp,65,3,13,16
Ireland,2011,ep,014,5,0,5
Ireland,2011,ep,1524,3,8,11
Ireland,2011,ep,2534,15,15,30
Ireland,2011,ep,3544,7,9,16
Ireland,2011,ep,4554,4,6,10
Ireland,2011,ep,5564,2,1,3
Ireland,2011,ep,65,1,7,8
Ireland,2011,sn,014,6,2,8
Ireland,2011,sn,1524,3,5,8
Ireland,2011,sn,2534,12,21,33
Ireland,2011,sn,3544,6,14,20
Ireland,2011,sn,4554,7,10,17
Ireland,2011,sn,5564,7,4,11
Ireland,2011,sn,65,4,10,14
Ireland,2011,sp,014,0,0,0
Ireland,2011,sp,1524,8,7,15
Ireland,2011,sp,2534,7,9,16
Ireland,2011,sp,3544,7,12,19
Ireland,2011,sp,4554,8,12,20
Ireland,2011,sp,5564,2,7,9
Ireland,2011,sp,65,1,6,7
Ireland,2012,ep,014,2,1,3
Ireland,2012,ep,1524,5,3,8
Ireland,2012,ep,2534,10,13,23
Ireland,2012,ep,3544,6,10,16
Ireland,2012,ep,4554,3,3,6
Ireland,2012,ep,5564,0,7,7
Ireland,2012,ep,65,3,8,11
Ireland,2012,sn,014,0,3,3
Ireland,2012,sn,1524,13,5,18
Ireland,2012,sn,2534,9,9,18
Ireland,2012,sn,3544,6,12,18
Ireland,2012,sn,4554,6,8,14
Ireland,2012,sn,5564,5,6,11
Ireland,2012,sn,65,6,9,15
Ireland,2012,sp,014,1,1,2
Ireland,2012,sp,1524,5,7,12
Ireland,2012,sp,2534,6,9,15
Ireland,2012,sp,3544,6,9,15
Ireland,2012,sp,4554,4,9,13
Ireland,2012,sp,5564,2,12,14
Ireland,2012,sp,65,2,4,6
Ireland,2013,rel,014,5,4,9
Ireland,2013,rel,1524,28,19,47
Ireland,2013,rel,2534,32,55,87
Ireland,2013,rel,3544,34,41,75
Ireland,2013,rel,4554,11,38,49
Ireland,2013,rel,5564,7,32,39
Ireland,2013,rel,65,13,35,48
Israel,1996,sp,014,2,1,3
Israel,1996,sp,1524,8,5,13
Israel,1996,sp,2534,4,18,22
Israel,1996,sp,3544,2,21,23
Israel,1996,sp,4554,4,15,19
Israel,1996,sp,5564,5,11,16
Israel,1996,sp,65,18,33,51
Israel,1997,sp,014,2,5,7
Israel,1997,sp,1524,16,9,25
Israel,1997,sp,2534,10,27,37
Israel,1997,sp,3544,18,20,38
Israel,1997,sp,4554,7,17,24
Israel,1997,sp,5564,3,19,22
Israel,1997,sp,65,27,43,70
Israel,1998,sp,014,1,1,2
Israel,1998,sp,1524,9,20,29
Israel,1998,sp,2534,10,29,39
Israel,1998,sp,3544,7,35,42
Israel,1998,sp,4554,9,19,28
Israel,1998,sp,5564,9,16,25
Israel,1998,sp,65,26,30,56
Israel,1999,ep,014,5,11,16
Israel,1999,ep,1524,5,3,8
Israel,1999,ep,2534,5,7,12
Israel,1999,ep,3544,7,10,17
Israel,1999,ep,4554,11,5,16
Israel,1999,ep,5564,11,7,18
Israel,1999,ep,65,25,20,45
Israel,1999,sn,014,15,11,26
Israel,1999,sn,1524,6,11,17
Israel,1999,sn,2534,18,19,37
Israel,1999,sn,3544,5,13,18
Israel,1999,sn,4554,5,13,18
Israel,1999,sn,5564,5,11,16
Israel,1999,sn,65,24,21,45
Israel,1999,sp,014,2,3,5
Israel,1999,sp,1524,8,19,27
Israel,1999,sp,2534,15,20,35
Israel,1999,sp,3544,7,28,35
Israel,1999,sp,4554,7,19,26
Israel,1999,sp,5564,5,13,18
Israel,1999,sp,65,26,36,62
Israel,2000,ep,014,6,6,12
Israel,2000,ep,1524,3,0,3
Israel,2000,ep,2534,7,8,15
Israel,2000,ep,3544,7,5,12
Israel,2000,ep,4554,7,5,12
Israel,2000,ep,5564,6,2,8
Israel,2000,ep,65,26,12,38
Israel,2000,sn,014,19,18,37
Israel,2000,sn,1524,7,6,13
Israel,2000,sn,2534,10,17,27
Israel,2000,sn,3544,12,26,38
Israel,2000,sn,4554,6,14,20
Israel,2000,sn,5564,11,16,27
Israel,2000,sn,65,21,30,51
Israel,2000,sp,014,3,0,3
Israel,2000,sp,1524,10,20,30
Israel,2000,sp,2534,16,26,42
Israel,2000,sp,3544,6,23,29
Israel,2000,sp,4554,3,23,26
Israel,2000,sp,5564,3,13,16
Israel,2000,sp,65,32,38,70
Israel,2001,ep,014,7,3,10
Israel,2001,ep,1524,0,3,3
Israel,2001,ep,2534,6,6,12
Israel,2001,ep,3544,2,7,9
Israel,2001,ep,4554,2,5,7
Israel,2001,ep,5564,2,6,8
Israel,2001,ep,65,14,16,30
Israel,2001,sn,014,11,8,19
Israel,2001,sn,1524,5,12,17
Israel,2001,sn,2534,17,27,44
Israel,2001,sn,3544,13,14,27
Israel,2001,sn,4554,8,16,24
Israel,2001,sn,5564,9,12,21
Israel,2001,sn,65,31,37,68
Israel,2001,sp,014,1,2,3
Israel,2001,sp,1524,9,13,22
Israel,2001,sp,2534,15,24,39
Israel,2001,sp,3544,14,24,38
Israel,2001,sp,4554,5,20,25
Israel,2001,sp,5564,2,17,19
Israel,2001,sp,65,24,36,60
Israel,2002,ep,014,4,2,6
Israel,2002,ep,1524,7,5,12
Israel,2002,ep,2534,6,3,9
Israel,2002,ep,3544,6,3,9
Israel,2002,ep,4554,8,3,11
Israel,2002,ep,5564,6,5,11
Israel,2002,ep,65,22,19,41
Israel,2002,sn,014,8,9,17
Israel,2002,sn,1524,11,4,15
Israel,2002,sn,2534,16,17,33
Israel,2002,sn,3544,4,10,14
Israel,2002,sn,4554,9,6,15
Israel,2002,sn,5564,6,12,18
Israel,2002,sn,65,17,32,49
Israel,2002,sp,014,3,4,7
Israel,2002,sp,1524,21,10,31
Israel,2002,sp,2534,18,24,42
Israel,2002,sp,3544,13,13,26
Israel,2002,sp,4554,5,17,22
Israel,2002,sp,5564,6,13,19
Israel,2002,sp,65,20,25,45
Israel,2003,ep,014,6,0,6
Israel,2003,ep,1524,3,3,6
Israel,2003,ep,2534,7,7,14
Israel,2003,ep,3544,8,12,20
Israel,2003,ep,4554,8,3,11
Israel,2003,ep,5564,7,5,12
Israel,2003,ep,65,17,13,30
Israel,2003,sn,014,4,10,14
Israel,2003,sn,1524,3,4,7
Israel,2003,sn,2534,20,19,39
Israel,2003,sn,3544,14,12,26
Israel,2003,sn,4554,7,7,14
Israel,2003,sn,5564,9,7,16
Israel,2003,sn,65,28,25,53
Israel,2003,sp,014,2,2,4
Israel,2003,sp,1524,17,9,26
Israel,2003,sp,2534,16,14,30
Israel,2003,sp,3544,18,30,48
Israel,2003,sp,4554,7,12,19
Israel,2003,sp,5564,5,10,15
Israel,2003,sp,65,14,33,47
Israel,2004,ep,014,4,0,4
Israel,2004,ep,1524,3,5,8
Israel,2004,ep,2534,11,5,16
Israel,2004,ep,3544,9,6,15
Israel,2004,ep,4554,7,7,14
Israel,2004,ep,5564,6,2,8
Israel,2004,ep,65,21,9,30
Israel,2004,sn,014,8,11,19
Israel,2004,sn,1524,4,7,11
Israel,2004,sn,2534,18,17,35
Israel,2004,sn,3544,8,13,21
Israel,2004,sn,4554,19,15,34
Israel,2004,sn,5564,9,14,23
Israel,2004,sn,65,22,32,54
Israel,2004,sp,014,1,1,2
Israel,2004,sp,1524,7,5,12
Israel,2004,sp,2534,12,14,26
Israel,2004,sp,3544,12,21,33
Israel,2004,sp,4554,8,17,25
Israel,2004,sp,5564,3,8,11
Israel,2004,sp,65,16,26,42
Israel,2005,ep,014,2,5,7
Israel,2005,ep,1524,1,0,1
Israel,2005,ep,2534,4,2,6
Israel,2005,ep,3544,3,4,7
Israel,2005,ep,4554,6,4,10
Israel,2005,ep,5564,4,2,6
Israel,2005,ep,65,10,8,18
Israel,2005,sn,014,10,11,21
Israel,2005,sn,1524,6,3,9
Israel,2005,sn,2534,16,11,27
Israel,2005,sn,3544,8,15,23
Israel,2005,sn,4554,4,12,16
Israel,2005,sn,5564,9,16,25
Israel,2005,sn,65,23,24,47
Israel,2005,sp,014,0,1,1
Israel,2005,sp,1524,6,4,10
Israel,2005,sp,2534,14,15,29
Israel,2005,sp,3544,7,18,25
Israel,2005,sp,4554,7,15,22
Israel,2005,sp,5564,5,5,10
Israel,2005,sp,65,19,26,45
Israel,2006,ep,014,1,1,2
Israel,2006,ep,1524,5,0,5
Israel,2006,ep,2534,2,3,5
Israel,2006,ep,3544,5,2,7
Israel,2006,ep,4554,5,2,7
Israel,2006,ep,5564,6,2,8
Israel,2006,ep,65,11,4,15
Israel,2006,sn,014,10,17,27
Israel,2006,sn,1524,7,4,11
Israel,2006,sn,2534,14,15,29
Israel,2006,sn,3544,7,19,26
Israel,2006,sn,4554,7,17,24
Israel,2006,sn,5564,4,6,10
Israel,2006,sn,65,22,29,51
Israel,2006,sp,014,0,1,1
Israel,2006,sp,1524,3,4,7
Israel,2006,sp,2534,10,19,29
Israel,2006,sp,3544,7,17,24
Israel,2006,sp,4554,5,6,11
Israel,2006,sp,5564,2,9,11
Israel,2006,sp,65,14,11,25
Israel,2007,ep,014,1,1,2
Israel,2007,ep,1524,4,1,5
Israel,2007,ep,2534,3,5,8
Israel,2007,ep,3544,2,5,7
Israel,2007,ep,4554,4,4,8
Israel,2007,ep,5564,3,2,5
Israel,2007,ep,65,5,6,11
Israel,2007,sn,014,10,13,23
Israel,2007,sn,1524,7,10,17
Israel,2007,sn,2534,23,20,43
Israel,2007,sn,3544,16,19,35
Israel,2007,sn,4554,10,14,24
Israel,2007,sn,5564,7,15,22
Israel,2007,sn,65,22,31,53
Israel,2007,sp,014,1,1,2
Israel,2007,sp,1524,2,7,9
Israel,2007,sp,2534,17,16,33
Israel,2007,sp,3544,3,22,25
Israel,2007,sp,4554,6,11,17
Israel,2007,sp,5564,3,8,11
Israel,2007,sp,65,12,17,29
Israel,2008,ep,014,3,2,5
Israel,2008,ep,1524,1,2,3
Israel,2008,ep,2534,11,12,23
Israel,2008,ep,3544,2,4,6
Israel,2008,ep,4554,5,2,7
Israel,2008,ep,5564,3,3,6
Israel,2008,ep,65,10,16,26
Israel,2008,sn,014,5,3,8
Israel,2008,sn,1524,2,10,12
Israel,2008,sn,2534,10,26,36
Israel,2008,sn,3544,8,13,21
Israel,2008,sn,4554,5,13,18
Israel,2008,sn,5564,5,9,14
Israel,2008,sn,65,17,21,38
Israel,2008,sp,014,1,0,1
Israel,2008,sp,1524,5,13,18
Israel,2008,sp,2534,5,12,17
Israel,2008,sp,3544,7,12,19
Israel,2008,sp,4554,6,7,13
Israel,2008,sp,5564,0,6,6
Israel,2008,sp,65,11,10,21
Israel,2009,ep,014,2,0,2
Israel,2009,ep,1524,5,3,8
Israel,2009,ep,2534,14,12,26
Israel,2009,ep,3544,6,6,12
Israel,2009,ep,4554,6,4,10
Israel,2009,ep,5564,4,8,12
Israel,2009,ep,65,7,12,19
Israel,2009,sn,014,3,3,6
Israel,2009,sn,1524,4,12,16
Israel,2009,sn,2534,5,15,20
Israel,2009,sn,3544,9,13,22
Israel,2009,sn,4554,3,16,19
Israel,2009,sn,5564,5,9,14
Israel,2009,sn,65,15,18,33
Israel,2009,sp,014,0,2,2
Israel,2009,sp,1524,4,7,11
Israel,2009,sp,2534,13,21,34
Israel,2009,sp,3544,10,13,23
Israel,2009,sp,4554,9,10,19
Israel,2009,sp,5564,2,1,3
Israel,2009,sp,65,12,15,27
Israel,2010,ep,014,0,3,3
Israel,2010,ep,1524,3,8,11
Israel,2010,ep,2534,7,16,23
Israel,2010,ep,3544,6,3,9
Israel,2010,ep,4554,4,2,6
Israel,2010,ep,5564,4,2,6
Israel,2010,ep,65,6,10,16
Israel,2010,sn,014,6,9,15
Israel,2010,sn,1524,4,18,22
Israel,2010,sn,2534,7,33,40
Israel,2010,sn,3544,9,17,26
Israel,2010,sn,4554,6,5,11
Israel,2010,sn,5564,3,14,17
Israel,2010,sn,65,17,13,30
Israel,2010,sp,014,0,1,1
Israel,2010,sp,1524,1,13,14
Israel,2010,sp,2534,8,28,36
Israel,2010,sp,3544,10,12,22
Israel,2010,sp,4554,2,8,10
Israel,2010,sp,5564,0,4,4
Israel,2010,sp,65,10,6,16
Israel,2011,ep,014,1,2,3
Israel,2011,ep,1524,1,14,15
Israel,2011,ep,2534,7,13,20
Israel,2011,ep,3544,6,8,14
Israel,2011,ep,4554,1,3,4
Israel,2011,ep,5564,2,1,3
Israel,2011,ep,65,6,1,7
Israel,2011,sn,014,11,6,17
Israel,2011,sn,1524,5,39,44
Israel,2011,sn,2534,14,54,68
Israel,2011,sn,3544,4,15,19
Israel,2011,sn,4554,4,13,17
Israel,2011,sn,5564,7,11,18
Israel,2011,sn,65,7,17,24
Israel,2011,sp,014,0,0,0
Israel,2011,sp,1524,10,29,39
Israel,2011,sp,2534,10,30,40
Israel,2011,sp,3544,7,11,18
Israel,2011,sp,4554,4,5,9
Israel,2011,sp,5564,4,9,13
Israel,2011,sp,65,7,9,16
Israel,2012,ep,014,2,0,2
Israel,2012,ep,1524,5,11,16
Israel,2012,ep,2534,9,30,39
Israel,2012,ep,3544,6,8,14
Israel,2012,ep,4554,5,3,8
Israel,2012,ep,5564,6,2,8
Israel,2012,ep,65,10,5,15
Israel,2012,sn,014,8,9,17
Israel,2012,sn,1524,11,40,51
Israel,2012,sn,2534,22,70,92
Israel,2012,sn,3544,7,27,34
Israel,2012,sn,4554,4,16,20
Israel,2012,sn,5564,1,11,12
Israel,2012,sn,65,12,16,28
Israel,2012,sp,014,0,0,0
Israel,2012,sp,1524,4,9,13
Israel,2012,sp,2534,20,33,53
Israel,2012,sp,3544,11,20,31
Israel,2012,sp,4554,4,3,7
Israel,2012,sp,5564,2,6,8
Israel,2012,sp,65,17,13,30
Israel,2013,rel,014,7,8,15
Israel,2013,rel,1524,15,34,49
Israel,2013,rel,2534,30,81,111
Israel,2013,rel,3544,17,34,51
Israel,2013,rel,4554,6,14,20
Israel,2013,rel,5564,6,14,20
Israel,2013,rel,65,18,24,42
Italy,1995,sp,014,7,9,16
Italy,1995,sp,1524,52,59,111
Italy,1995,sp,2534,93,202,295
Italy,1995,sp,3544,57,157,214
Italy,1995,sp,4554,40,94,134
Italy,1995,sp,5564,51,124,175
Italy,1995,sp,65,168,289,457
Italy,1996,sp,014,2,12,14
Italy,1996,sp,1524,53,72,125
Italy,1996,sp,2534,116,196,312
Italy,1996,sp,3544,60,168,228
Italy,1996,sp,4554,33,125,158
Italy,1996,sp,5564,56,155,211
Italy,1996,sp,65,172,319,491
Italy,1997,sp,014,5,14,19
Italy,1997,sp,1524,74,93,167
Italy,1997,sp,2534,129,228,357
Italy,1997,sp,3544,90,244,334
Italy,1997,sp,4554,48,168,216
Italy,1997,sp,5564,68,187,255
Italy,1997,sp,65,201,381,582
Italy,1998,sp,014,10,15,25
Italy,1998,sp,1524,105,128,233
Italy,1998,sp,2534,150,327,477
Italy,1998,sp,3544,110,248,358
Italy,1998,sp,4554,58,189,247
Italy,1998,sp,5564,75,226,301
Italy,1998,sp,65,283,429,712
Italy,1999,sp,014,8,7,15
Italy,1999,sp,1524,49,78,127
Italy,1999,sp,2534,63,155,218
Italy,1999,sp,3544,63,137,200
Italy,1999,sp,4554,35,114,149
Italy,1999,sp,5564,32,104,136
Italy,1999,sp,65,141,247,388
Italy,2000,sp,014,6,12,18
Italy,2000,sp,1524,38,63,101
Italy,2000,sp,2534,58,96,154
Italy,2000,sp,3544,33,75,108
Italy,2000,sp,4554,13,58,71
Italy,2000,sp,5564,19,54,73
Italy,2000,sp,65,39,112,151
Italy,2001,sp,014,4,4,8
Italy,2001,sp,1524,37,43,80
Italy,2001,sp,2534,77,130,207
Italy,2001,sp,3544,46,98,144
Italy,2001,sp,4554,24,63,87
Italy,2001,sp,5564,14,50,64
Italy,2001,sp,65,54,99,153
Italy,2002,sp,014,6,6,12
Italy,2002,sp,1524,51,51,102
Italy,2002,sp,2534,94,139,233
Italy,2002,sp,3544,55,127,182
Italy,2002,sp,4554,18,74,92
Italy,2002,sp,5564,28,68,96
Italy,2002,sp,65,85,134,219
Italy,2003,sp,014,6,19,25
Italy,2003,sp,1524,63,79,142
Italy,2003,sp,2534,121,219,340
Italy,2003,sp,3544,77,168,245
Italy,2003,sp,4554,24,80,104
Italy,2003,sp,5564,13,61,74
Italy,2003,sp,65,91,146,237
Italy,2004,sp,014,16,34,50
Italy,2004,sp,1524,48,52,100
Italy,2004,sp,2534,73,130,203
Italy,2004,sp,3544,39,115,154
Italy,2004,sp,4554,21,64,85
Italy,2004,sp,5564,19,43,62
Italy,2004,sp,65,56,123,179
Italy,2005,sp,014,3,8,11
Italy,2005,sp,1524,80,93,173
Italy,2005,sp,2534,145,191,336
Italy,2005,sp,3544,56,137,193
Italy,2005,sp,4554,25,101,126
Italy,2005,sp,5564,19,61,80
Italy,2005,sp,65,70,115,185
Italy,2006,ep,014,35,22,57
Italy,2006,ep,1524,52,71,123
Italy,2006,ep,2534,112,171,283
Italy,2006,ep,3544,81,162,243
Italy,2006,ep,4554,57,58,115
Italy,2006,ep,5564,46,66,112
Italy,2006,ep,65,200,146,346
Italy,2006,sn,014,44,40,84
Italy,2006,sn,1524,70,90,160
Italy,2006,sn,2534,120,142,262
Italy,2006,sn,3544,97,132,229
Italy,2006,sn,4554,52,107,159
Italy,2006,sn,5564,43,91,134
Italy,2006,sn,65,151,254,405
Italy,2006,sp,014,9,7,16
Italy,2006,sp,1524,88,113,201
Italy,2006,sp,2534,165,201,366
Italy,2006,sp,3544,82,197,279
Italy,2006,sp,4554,48,105,153
Italy,2006,sp,5564,16,75,91
Italy,2006,sp,65,88,152,240
Italy,2007,ep,014,14,12,26
Italy,2007,ep,1524,43,47,90
Italy,2007,ep,2534,92,108,200
Italy,2007,ep,3544,77,110,187
Italy,2007,ep,4554,47,62,109
Italy,2007,ep,5564,35,34,69
Italy,2007,ep,65,123,121,244
Italy,2007,sn,014,28,25,53
Italy,2007,sn,1524,45,38,83
Italy,2007,sn,2534,95,117,212
Italy,2007,sn,3544,69,103,172
Italy,2007,sn,4554,50,90,140
Italy,2007,sn,5564,32,75,107
Italy,2007,sn,65,123,189,312
Italy,2007,sp,014,7,3,10
Italy,2007,sp,1524,74,75,149
Italy,2007,sp,2534,94,170,264
Italy,2007,sp,3544,58,113,171
Italy,2007,sp,4554,31,87,118
Italy,2007,sp,5564,19,48,67
Italy,2007,sp,65,76,106,182
Italy,2008,ep,014,19,23,42
Italy,2008,ep,1524,44,70,114
Italy,2008,ep,2534,90,119,209
Italy,2008,ep,3544,61,99,160
Italy,2008,ep,4554,31,59,90
Italy,2008,ep,5564,23,45,68
Italy,2008,ep,65,97,117,214
Italy,2008,sn,014,77,69,146
Italy,2008,sn,1524,73,102,175
Italy,2008,sn,2534,141,176,317
Italy,2008,sn,3544,95,165,260
Italy,2008,sn,4554,70,95,165
Italy,2008,sn,5564,55,91,146
Italy,2008,sn,65,160,197,357
Italy,2008,sp,014,10,13,23
Italy,2008,sp,1524,65,78,143
Italy,2008,sp,2534,106,148,254
Italy,2008,sp,3544,56,137,193
Italy,2008,sp,4554,24,72,96
Italy,2008,sp,5564,21,42,63
Italy,2008,sp,65,56,104,160
Italy,2009,ep,014,15,26,41
Italy,2009,ep,1524,29,52,81
Italy,2009,ep,2534,83,109,192
Italy,2009,ep,3544,48,81,129
Italy,2009,ep,4554,48,44,92
Italy,2009,ep,5564,26,29,55
Italy,2009,ep,65,107,89,196
Italy,2009,sn,014,43,38,81
Italy,2009,sn,1524,52,50,102
Italy,2009,sn,2534,82,99,181
Italy,2009,sn,3544,57,61,118
Italy,2009,sn,4554,29,72,101
Italy,2009,sn,5564,20,40,60
Italy,2009,sn,65,87,124,211
Italy,2009,sp,014,3,4,7
Italy,2009,sp,1524,68,89,157
Italy,2009,sp,2534,93,168,261
Italy,2009,sp,3544,46,108,154
Italy,2009,sp,4554,31,75,106
Italy,2009,sp,5564,16,34,50
Italy,2009,sp,65,62,83,145
Italy,2010,ep,014,32,18,50
Italy,2010,ep,1524,52,46,98
Italy,2010,ep,2534,92,115,207
Italy,2010,ep,3544,68,106,174
Italy,2010,ep,4554,43,44,87
Italy,2010,ep,5564,23,31,54
Italy,2010,ep,65,105,78,183
Italy,2010,sn,014,60,49,109
Italy,2010,sn,1524,46,66,112
Italy,2010,sn,2534,94,109,203
Italy,2010,sn,3544,75,81,156
Italy,2010,sn,4554,32,63,95
Italy,2010,sn,5564,25,40,65
Italy,2010,sn,65,70,96,166
Italy,2010,sp,014,11,15,26
Italy,2010,sp,1524,80,87,167
Italy,2010,sp,2534,94,161,255
Italy,2010,sp,3544,66,133,199
Italy,2010,sp,4554,29,87,116
Italy,2010,sp,5564,21,42,63
Italy,2010,sp,65,48,89,137
Italy,2011,ep,014,15,9,24
Italy,2011,ep,1524,33,27,60
Italy,2011,ep,2534,72,77,149
Italy,2011,ep,3544,53,67,120
Italy,2011,ep,4554,39,40,79
Italy,2011,ep,5564,22,34,56
Italy,2011,ep,65,79,73,152
Italy,2011,sn,014,40,52,92
Italy,2011,sn,1524,45,53,98
Italy,2011,sn,2534,67,74,141
Italy,2011,sn,3544,57,82,139
Italy,2011,sn,4554,32,49,81
Italy,2011,sn,5564,25,49,74
Italy,2011,sn,65,71,85,156
Italy,2011,sp,014,5,0,5
Italy,2011,sp,1524,41,51,92
Italy,2011,sp,2534,73,88,161
Italy,2011,sp,3544,37,81,118
Italy,2011,sp,4554,18,52,70
Italy,2011,sp,5564,14,24,38
Italy,2011,sp,65,43,59,102
Italy,2012,ep,014,12,11,23
Italy,2012,ep,1524,24,27,51
Italy,2012,ep,2534,67,86,153
Italy,2012,ep,3544,55,70,125
Italy,2012,ep,4554,26,31,57
Italy,2012,ep,5564,18,33,51
Italy,2012,ep,65,65,56,121
Italy,2012,sn,014,36,28,64
Italy,2012,sn,1524,15,34,49
Italy,2012,sn,2534,40,51,91
Italy,2012,sn,3544,49,31,80
Italy,2012,sn,4554,32,33,65
Italy,2012,sn,5564,12,31,43
Italy,2012,sn,65,56,61,117
Italy,2012,sp,014,1,1,2
Italy,2012,sp,1524,27,43,70
Italy,2012,sp,2534,62,90,152
Italy,2012,sp,3544,39,83,122
Italy,2012,sp,4554,14,46,60
Italy,2012,sp,5564,12,13,25
Italy,2012,sp,65,38,52,90
Italy,2013,rel,014,61,63,124
Italy,2013,rel,1524,159,149,308
Italy,2013,rel,2534,217,335,552
Italy,2013,rel,3544,178,258,436
Italy,2013,rel,4554,126,170,296
Italy,2013,rel,5564,81,144,225
Italy,2013,rel,65,249,244,493
Jamaica,1995,sp,014,2,2,4
Jamaica,1995,sp,1524,7,9,16
Jamaica,1995,sp,2534,6,14,20
Jamaica,1995,sp,3544,5,9,14
Jamaica,1995,sp,4554,5,11,16
Jamaica,1995,sp,5564,2,8,10
Jamaica,1995,sp,65,2,9,11
Jamaica,1996,sp,014,1,1,2
Jamaica,1996,sp,1524,5,9,14
Jamaica,1996,sp,2534,3,10,13
Jamaica,1996,sp,3544,5,12,17
Jamaica,1996,sp,4554,2,12,14
Jamaica,1996,sp,5564,3,8,11
Jamaica,1996,sp,65,1,3,4
Jamaica,1997,sp,014,0,1,1
Jamaica,1997,sp,1524,5,2,7
Jamaica,1997,sp,2534,6,9,15
Jamaica,1997,sp,3544,4,16,20
Jamaica,1997,sp,4554,3,12,15
Jamaica,1997,sp,5564,1,8,9
Jamaica,1997,sp,65,3,1,4
Jamaica,1998,sp,014,1,0,1
Jamaica,1998,sp,1524,8,3,11
Jamaica,1998,sp,2534,3,19,22
Jamaica,1998,sp,3544,8,9,17
Jamaica,1998,sp,4554,1,10,11
Jamaica,1998,sp,5564,4,7,11
Jamaica,1998,sp,65,2,7,9
Jamaica,1999,sp,014,2,2,4
Jamaica,1999,sp,1524,5,10,15
Jamaica,1999,sp,2534,9,16,25
Jamaica,1999,sp,3544,3,6,9
Jamaica,1999,sp,4554,4,6,10
Jamaica,1999,sp,5564,5,15,20
Jamaica,1999,sp,65,3,6,9
Jamaica,2000,sp,014,1,0,1
Jamaica,2000,sp,1524,8,6,14
Jamaica,2000,sp,2534,8,13,21
Jamaica,2000,sp,3544,7,13,20
Jamaica,2000,sp,4554,2,15,17
Jamaica,2000,sp,5564,5,6,11
Jamaica,2000,sp,65,1,5,6
Jamaica,2001,sp,014,2,3,5
Jamaica,2001,sp,1524,2,10,12
Jamaica,2001,sp,2534,7,9,16
Jamaica,2001,sp,3544,6,21,27
Jamaica,2001,sp,4554,3,5,8
Jamaica,2001,sp,5564,2,1,3
Jamaica,2001,sp,65,3,1,4
Jamaica,2002,sp,014,1,0,1
Jamaica,2002,sp,1524,3,9,12
Jamaica,2002,sp,2534,3,11,14
Jamaica,2002,sp,3544,3,8,11
Jamaica,2002,sp,4554,1,7,8
Jamaica,2002,sp,5564,3,7,10
Jamaica,2002,sp,65,0,4,4
Jamaica,2003,sp,014,2,1,3
Jamaica,2003,sp,1524,7,11,18
Jamaica,2003,sp,2534,8,9,17
Jamaica,2003,sp,3544,2,14,16
Jamaica,2003,sp,4554,3,12,15
Jamaica,2003,sp,5564,0,4,4
Jamaica,2003,sp,65,2,6,8
Jamaica,2004,sp,014,0,0,0
Jamaica,2004,sp,1524,4,9,13
Jamaica,2004,sp,2534,6,7,13
Jamaica,2004,sp,3544,4,4,8
Jamaica,2004,sp,4554,1,13,14
Jamaica,2004,sp,5564,2,8,10
Jamaica,2004,sp,65,1,10,11
Jamaica,2005,sp,014,0,0,0
Jamaica,2005,sp,1524,1,4,5
Jamaica,2005,sp,2534,5,6,11
Jamaica,2005,sp,3544,4,6,10
Jamaica,2005,sp,4554,0,10,10
Jamaica,2005,sp,5564,1,6,7
Jamaica,2005,sp,65,3,7,10
Jamaica,2006,ep,014,0,4,4
Jamaica,2006,ep,1524,0,2,2
Jamaica,2006,ep,2534,1,1,2
Jamaica,2006,ep,3544,0,2,2
Jamaica,2006,ep,4554,0,1,1
Jamaica,2006,ep,5564,0,2,2
Jamaica,2006,ep,65,0,0,0
Jamaica,2006,sn,014,1,0,1
Jamaica,2006,sn,1524,1,2,3
Jamaica,2006,sn,2534,2,0,2
Jamaica,2006,sn,3544,2,2,4
Jamaica,2006,sn,4554,3,3,6
Jamaica,2006,sn,5564,0,2,2
Jamaica,2006,sn,65,0,1,1
Jamaica,2006,sp,014,0,0,0
Jamaica,2006,sp,1524,2,9,11
Jamaica,2006,sp,2534,5,10,15
Jamaica,2006,sp,3544,3,9,12
Jamaica,2006,sp,4554,1,6,7
Jamaica,2006,sp,5564,0,6,6
Jamaica,2006,sp,65,1,9,10
Jamaica,2007,ep,1524,0,0,0
Jamaica,2007,ep,2534,1,0,1
Jamaica,2007,ep,3544,1,1,2
Jamaica,2007,ep,4554,0,1,1
Jamaica,2007,ep,5564,0,0,0
Jamaica,2007,ep,65,0,0,0
Jamaica,2007,sn,1524,0,0,0
Jamaica,2007,sn,2534,2,3,5
Jamaica,2007,sn,3544,0,2,2
Jamaica,2007,sn,4554,2,2,4
Jamaica,2007,sn,5564,0,0,0
Jamaica,2007,sn,65,1,0,1
Jamaica,2007,sp,014,2,NA,NA
Jamaica,2007,sp,1524,5,12,17
Jamaica,2007,sp,2534,2,10,12
Jamaica,2007,sp,3544,6,7,13
Jamaica,2007,sp,4554,2,17,19
Jamaica,2007,sp,5564,2,7,9
Jamaica,2007,sp,65,3,3,6
Jamaica,2008,ep,014,0,0,0
Jamaica,2008,ep,1524,0,0,0
Jamaica,2008,ep,2534,0,1,1
Jamaica,2008,ep,3544,0,1,1
Jamaica,2008,ep,4554,0,0,0
Jamaica,2008,ep,5564,0,0,0
Jamaica,2008,ep,65,0,0,0
Jamaica,2008,sn,014,3,2,5
Jamaica,2008,sn,1524,1,2,3
Jamaica,2008,sn,2534,0,2,2
Jamaica,2008,sn,3544,0,1,1
Jamaica,2008,sn,4554,1,3,4
Jamaica,2008,sn,5564,1,3,4
Jamaica,2008,sn,65,0,3,3
Jamaica,2008,sp,014,1,3,4
Jamaica,2008,sp,1524,8,2,10
Jamaica,2008,sp,2534,3,10,13
Jamaica,2008,sp,3544,3,10,13
Jamaica,2008,sp,4554,1,11,12
Jamaica,2008,sp,5564,1,11,12
Jamaica,2008,sp,65,6,5,11
Jamaica,2009,ep,014,0,0,0
Jamaica,2009,ep,1524,0,0,0
Jamaica,2009,ep,2534,1,1,2
Jamaica,2009,ep,3544,0,0,0
Jamaica,2009,ep,4554,1,1,2
Jamaica,2009,ep,5564,0,1,1
Jamaica,2009,ep,65,0,0,0
Jamaica,2009,sn,014,0,2,2
Jamaica,2009,sn,1524,3,4,7
Jamaica,2009,sn,2534,6,2,8
Jamaica,2009,sn,3544,3,8,11
Jamaica,2009,sn,4554,0,4,4
Jamaica,2009,sn,5564,2,8,10
Jamaica,2009,sn,65,2,4,6
Jamaica,2009,sp,014,7,1,8
Jamaica,2009,sp,1524,7,5,12
Jamaica,2009,sp,2534,8,8,16
Jamaica,2009,sp,3544,7,10,17
Jamaica,2009,sp,4554,4,7,11
Jamaica,2009,sp,5564,3,4,7
Jamaica,2009,sp,65,1,5,6
Jamaica,2010,ep,014,2,0,2
Jamaica,2010,ep,1524,0,0,0
Jamaica,2010,ep,2534,1,1,2
Jamaica,2010,ep,3544,0,1,1
Jamaica,2010,ep,4554,0,0,0
Jamaica,2010,ep,5564,1,0,1
Jamaica,2010,ep,65,0,0,0
Jamaica,2010,sn,014,3,11,14
Jamaica,2010,sn,1524,1,0,1
Jamaica,2010,sn,2534,2,5,7
Jamaica,2010,sn,3544,1,3,4
Jamaica,2010,sn,4554,1,5,6
Jamaica,2010,sn,5564,0,5,5
Jamaica,2010,sn,65,2,7,9
Jamaica,2010,sp,014,0,1,1
Jamaica,2010,sp,1524,5,7,12
Jamaica,2010,sp,2534,4,15,19
Jamaica,2010,sp,3544,5,15,20
Jamaica,2010,sp,4554,1,8,9
Jamaica,2010,sp,5564,0,6,6
Jamaica,2010,sp,65,2,7,9
Jamaica,2011,ep,014,0,0,0
Jamaica,2011,ep,1524,1,2,3
Jamaica,2011,ep,2534,2,0,2
Jamaica,2011,ep,3544,0,0,0
Jamaica,2011,ep,4554,0,0,0
Jamaica,2011,ep,5564,1,0,1
Jamaica,2011,ep,65,1,0,1
Jamaica,2011,sn,014,5,6,11
Jamaica,2011,sn,1524,1,1,2
Jamaica,2011,sn,2534,1,0,1
Jamaica,2011,sn,3544,0,5,5
Jamaica,2011,sn,4554,3,2,5
Jamaica,2011,sn,5564,1,5,6
Jamaica,2011,sn,65,0,6,6
Jamaica,2011,sp,014,1,0,1
Jamaica,2011,sp,1524,3,2,5
Jamaica,2011,sp,2534,4,6,10
Jamaica,2011,sp,3544,0,3,3
Jamaica,2011,sp,4554,3,4,7
Jamaica,2011,sp,5564,1,4,5
Jamaica,2011,sp,65,1,3,4
Jamaica,2012,ep,014,0,0,0
Jamaica,2012,ep,1524,0,0,0
Jamaica,2012,ep,2534,1,2,3
Jamaica,2012,ep,3544,1,0,1
Jamaica,2012,ep,4554,0,4,4
Jamaica,2012,ep,5564,0,0,0
Jamaica,2012,ep,65,1,0,1
Jamaica,2012,sn,014,6,3,9
Jamaica,2012,sn,1524,2,0,2
Jamaica,2012,sn,2534,6,3,9
Jamaica,2012,sn,3544,0,1,1
Jamaica,2012,sn,4554,1,3,4
Jamaica,2012,sn,5564,0,4,4
Jamaica,2012,sn,65,0,4,4
Jamaica,2012,sp,014,1,1,2
Jamaica,2012,sp,1524,1,10,11
Jamaica,2012,sp,2534,5,8,13
Jamaica,2012,sp,3544,4,3,7
Jamaica,2012,sp,4554,2,5,7
Jamaica,2012,sp,5564,0,5,5
Jamaica,2012,sp,65,0,1,1
Jamaica,2013,rel,014,6,4,10
Jamaica,2013,rel,1524,6,12,18
Jamaica,2013,rel,2534,4,18,22
Jamaica,2013,rel,3544,6,11,17
Jamaica,2013,rel,4554,7,11,18
Jamaica,2013,rel,5564,1,6,7
Jamaica,2013,rel,65,2,1,3
Japan,1995,sp,014,14,15,29
Japan,1995,sp,1524,258,342,600
Japan,1995,sp,2534,476,627,1103
Japan,1995,sp,3544,298,995,1293
Japan,1995,sp,4554,476,1847,2323
Japan,1995,sp,5564,637,2059,2696
Japan,1995,sp,65,2234,4089,6323
Japan,1996,sp,014,7,16,23
Japan,1996,sp,1524,224,309,533
Japan,1996,sp,2534,409,621,1030
Japan,1996,sp,3544,262,843,1105
Japan,1996,sp,4554,364,1756,2120
Japan,1996,sp,5564,565,1878,2443
Japan,1996,sp,65,1974,3639,5613
Japan,1997,sp,014,11,8,19
Japan,1997,sp,1524,248,304,552
Japan,1997,sp,2534,455,625,1080
Japan,1997,sp,3544,237,798,1035
Japan,1997,sp,4554,405,1793,2198
Japan,1997,sp,5564,547,1908,2455
Japan,1997,sp,65,2177,4055,6232
Japan,1998,sp,014,6,2,8
Japan,1998,sp,1524,243,306,549
Japan,1998,sp,2534,418,597,1015
Japan,1998,sp,3544,233,724,957
Japan,1998,sp,4554,329,1571,1900
Japan,1998,sp,5564,417,1660,2077
Japan,1998,sp,65,1884,3545,5429
Japan,1999,sp,014,7,6,13
Japan,1999,sp,1524,236,290,526
Japan,1999,sp,2534,459,623,1082
Japan,1999,sp,3544,253,706,959
Japan,1999,sp,4554,292,1605,1897
Japan,1999,sp,5564,419,1768,2187
Japan,1999,sp,65,2128,4117,6245
Japan,2000,sp,014,5,2,7
Japan,2000,sp,1524,222,246,468
Japan,2000,sp,2534,464,572,1036
Japan,2000,sp,3544,213,676,889
Japan,2000,sp,4554,292,1494,1786
Japan,2000,sp,5564,384,1509,1893
Japan,2000,sp,65,1958,3816,5774
Japan,2001,sp,014,5,3,8
Japan,2001,sp,1524,175,220,395
Japan,2001,sp,2534,437,576,1013
Japan,2001,sp,3544,228,632,860
Japan,2001,sp,4554,250,1319,1569
Japan,2001,sp,5564,330,1513,1843
Japan,2001,sp,65,1880,3840,5720
Japan,2002,sp,014,3,2,5
Japan,2002,sp,1524,192,191,383
Japan,2002,sp,2534,395,549,944
Japan,2002,sp,3544,259,579,838
Japan,2002,sp,4554,248,1192,1440
Japan,2002,sp,5564,308,1334,1642
Japan,2002,sp,65,1808,3747,5555
Japan,2003,sp,014,2,1,3
Japan,2003,sp,1524,203,210,413
Japan,2003,sp,2534,395,521,916
Japan,2003,sp,3544,246,550,796
Japan,2003,sp,4554,254,1063,1317
Japan,2003,sp,5564,313,1388,1701
Japan,2003,sp,65,1966,3731,5697
Japan,2004,sp,014,6,2,8
Japan,2004,sp,1524,182,193,375
Japan,2004,sp,2534,364,462,826
Japan,2004,sp,3544,230,599,829
Japan,2004,sp,4554,222,934,1156
Japan,2004,sp,5564,294,1363,1657
Japan,2004,sp,65,1861,3759,5620
Japan,2005,sp,014,5,9,14
Japan,2005,sp,1524,187,197,384
Japan,2005,sp,2534,428,488,916
Japan,2005,sp,3544,249,605,854
Japan,2005,sp,4554,224,868,1092
Japan,2005,sp,5564,309,1418,1727
Japan,2005,sp,65,2077,3867,5944
Japan,2006,ep,014,12,15,27
Japan,2006,ep,1524,79,79,158
Japan,2006,ep,2534,179,173,352
Japan,2006,ep,3544,148,220,368
Japan,2006,ep,4554,147,208,355
Japan,2006,ep,5564,272,397,669
Japan,2006,ep,65,1499,1775,3274
Japan,2006,sn,014,24,23,47
Japan,2006,sn,1524,284,271,555
Japan,2006,sn,2534,566,631,1197
Japan,2006,sn,3544,379,556,935
Japan,2006,sn,4554,229,643,872
Japan,2006,sn,5564,329,991,1320
Japan,2006,sn,65,1452,2720,4172
Japan,2006,sp,014,5,3,8
Japan,2006,sp,1524,179,175,354
Japan,2006,sp,2534,361,436,797
Japan,2006,sp,3544,280,529,809
Japan,2006,sp,4554,213,743,956
Japan,2006,sp,5564,256,1388,1644
Japan,2006,sp,65,1863,3728,5591
Japan,2007,ep,014,13,12,25
Japan,2007,ep,1524,62,84,146
Japan,2007,ep,2534,158,196,354
Japan,2007,ep,3544,168,211,379
Japan,2007,ep,4554,127,191,318
Japan,2007,ep,5564,271,351,622
Japan,2007,ep,65,1558,1740,3298
Japan,2007,sn,014,35,28,63
Japan,2007,sn,1524,278,271,549
Japan,2007,sn,2534,554,591,1145
Japan,2007,sn,3544,367,536,903
Japan,2007,sn,4554,256,549,805
Japan,2007,sn,5564,359,1000,1359
Japan,2007,sn,65,1479,2748,4227
Japan,2007,sp,014,3,1,4
Japan,2007,sp,1524,134,142,276
Japan,2007,sp,2534,318,372,690
Japan,2007,sp,3544,231,512,743
Japan,2007,sp,4554,156,668,824
Japan,2007,sp,5564,212,1174,1386
Japan,2007,sp,65,1832,3678,5510
Japan,2008,ep,014,14,21,35
Japan,2008,ep,1524,51,62,113
Japan,2008,ep,2534,157,147,304
Japan,2008,ep,3544,158,199,357
Japan,2008,ep,4554,136,185,321
Japan,2008,ep,5564,287,350,637
Japan,2008,ep,65,1554,1752,3306
Japan,2008,sn,014,27,27,54
Japan,2008,sn,1524,280,269,549
Japan,2008,sn,2534,528,609,1137
Japan,2008,sn,3544,398,535,933
Japan,2008,sn,4554,261,532,793
Japan,2008,sn,5564,283,922,1205
Japan,2008,sn,65,1497,2688,4185
Japan,2008,sp,014,1,2,3
Japan,2008,sp,1524,115,117,232
Japan,2008,sp,2534,293,339,632
Japan,2008,sp,3544,230,456,686
Japan,2008,sp,4554,173,599,772
Japan,2008,sp,5564,253,1063,1316
Japan,2008,sp,65,1872,3482,5354
Japan,2009,ep,014,13,12,25
Japan,2009,ep,1524,51,58,109
Japan,2009,ep,2534,142,161,303
Japan,2009,ep,3544,148,182,330
Japan,2009,ep,4554,155,152,307
Japan,2009,ep,5564,283,316,599
Japan,2009,ep,65,1575,1727,3302
Japan,2009,sn,014,24,14,38
Japan,2009,sn,1524,250,266,516
Japan,2009,sn,2534,498,533,1031
Japan,2009,sn,3544,396,511,907
Japan,2009,sn,4554,253,506,759
Japan,2009,sn,5564,294,879,1173
Japan,2009,sn,65,1499,2668,4167
Japan,2009,sp,014,3,1,4
Japan,2009,sp,1524,105,134,239
Japan,2009,sp,2534,287,328,615
Japan,2009,sp,3544,254,410,664
Japan,2009,sp,4554,169,580,749
Japan,2009,sp,5564,221,946,1167
Japan,2009,sp,65,2009,3406,5415
Japan,2010,ep,014,9,15,24
Japan,2010,ep,1524,52,65,117
Japan,2010,ep,2534,134,131,265
Japan,2010,ep,3544,131,164,295
Japan,2010,ep,4554,117,155,272
Japan,2010,ep,5564,238,309,547
Japan,2010,ep,65,1518,1594,3112
Japan,2010,sn,014,31,23,54
Japan,2010,sn,1524,250,291,541
Japan,2010,sn,2534,421,533,954
Japan,2010,sn,3544,391,522,913
Japan,2010,sn,4554,244,501,745
Japan,2010,sn,5564,304,849,1153
Japan,2010,sn,65,1528,2742,4270
Japan,2010,sp,014,6,1,7
Japan,2010,sp,1524,89,128,217
Japan,2010,sp,2534,232,252,484
Japan,2010,sp,3544,194,382,576
Japan,2010,sp,4554,155,469,624
Japan,2010,sp,5564,183,911,1094
Japan,2010,sp,65,1909,3326,5235
Japan,2011,ep,014,5,17,22
Japan,2011,ep,1524,43,54,97
Japan,2011,ep,2534,121,112,233
Japan,2011,ep,3544,162,171,333
Japan,2011,ep,4554,132,169,301
Japan,2011,ep,5564,248,268,516
Japan,2011,ep,65,1590,1734,3324
Japan,2011,sn,014,35,18,53
Japan,2011,sn,1524,227,240,467
Japan,2011,sn,2534,435,436,871
Japan,2011,sn,3544,353,501,854
Japan,2011,sn,4554,270,479,749
Japan,2011,sn,5564,307,748,1055
Japan,2011,sn,65,1531,2651,4182
Japan,2011,sp,014,5,0,5
Japan,2011,sp,1524,94,96,190
Japan,2011,sp,2534,213,215,428
Japan,2011,sp,3544,203,367,570
Japan,2011,sp,4554,148,465,613
Japan,2011,sp,5564,223,812,1035
Japan,2011,sp,65,1840,3256,5096
Japan,2012,ep,014,8,8,16
Japan,2012,ep,1524,50,60,110
Japan,2012,ep,2534,119,98,217
Japan,2012,ep,3544,131,169,300
Japan,2012,ep,4554,115,146,261
Japan,2012,ep,5564,244,279,523
Japan,2012,ep,65,1584,1598,3182
Japan,2012,sn,014,17,23,40
Japan,2012,sn,1524,197,212,409
Japan,2012,sn,2534,366,389,755
Japan,2012,sn,3544,325,471,796
Japan,2012,sn,4554,228,427,655
Japan,2012,sn,5564,276,656,932
Japan,2012,sn,65,1561,2527,4088
Japan,2012,sp,014,2,2,4
Japan,2012,sp,1524,79,94,173
Japan,2012,sp,2534,180,209,389
Japan,2012,sp,3544,169,309,478
Japan,2012,sp,4554,111,415,526
Japan,2012,sp,5564,175,741,916
Japan,2012,sp,65,1947,3230,5177
Japan,2013,rel,014,35,31,66
Japan,2013,rel,1524,313,388,701
Japan,2013,rel,2534,627,674,1301
Japan,2013,rel,3544,618,849,1467
Japan,2013,rel,4554,510,974,1484
Japan,2013,rel,5564,636,1613,2249
Japan,2013,rel,65,5252,7975,13227
Jordan,1995,sp,014,1,0,1
Jordan,1995,sp,1524,15,19,34
Jordan,1995,sp,2534,4,37,41
Jordan,1995,sp,3544,10,17,27
Jordan,1995,sp,4554,14,20,34
Jordan,1995,sp,5564,12,26,38
Jordan,1995,sp,65,7,11,18
Jordan,1996,sp,014,1,2,3
Jordan,1996,sp,1524,8,22,30
Jordan,1996,sp,2534,11,30,41
Jordan,1996,sp,3544,8,17,25
Jordan,1996,sp,4554,16,13,29
Jordan,1996,sp,5564,8,21,29
Jordan,1996,sp,65,4,9,13
Jordan,1997,sp,014,3,5,8
Jordan,1997,sp,1524,8,14,22
Jordan,1997,sp,2534,6,18,24
Jordan,1997,sp,3544,4,11,15
Jordan,1997,sp,4554,4,10,14
Jordan,1997,sp,5564,5,19,24
Jordan,1997,sp,65,7,22,29
Jordan,1998,sp,014,0,0,0
Jordan,1998,sp,1524,7,22,29
Jordan,1998,sp,2534,6,26,32
Jordan,1998,sp,3544,3,7,10
Jordan,1998,sp,4554,3,12,15
Jordan,1998,sp,5564,7,10,17
Jordan,1998,sp,65,1,6,7
Jordan,1999,sp,014,0,0,0
Jordan,1999,sp,1524,8,16,24
Jordan,1999,sp,2534,7,19,26
Jordan,1999,sp,3544,2,16,18
Jordan,1999,sp,4554,2,10,12
Jordan,1999,sp,5564,7,8,15
Jordan,1999,sp,65,5,2,7
Jordan,2000,sp,014,0,0,0
Jordan,2000,sp,1524,8,8,16
Jordan,2000,sp,2534,9,16,25
Jordan,2000,sp,3544,1,13,14
Jordan,2000,sp,4554,2,9,11
Jordan,2000,sp,5564,2,14,16
Jordan,2000,sp,65,5,2,7
Jordan,2001,sp,014,0,2,2
Jordan,2001,sp,1524,8,7,15
Jordan,2001,sp,2534,6,22,28
Jordan,2001,sp,3544,1,10,11
Jordan,2001,sp,4554,0,10,10
Jordan,2001,sp,5564,9,8,17
Jordan,2001,sp,65,4,7,11
Jordan,2002,sp,014,0,0,0
Jordan,2002,sp,1524,9,8,17
Jordan,2002,sp,2534,4,9,13
Jordan,2002,sp,3544,3,11,14
Jordan,2002,sp,4554,2,12,14
Jordan,2002,sp,5564,12,11,23
Jordan,2002,sp,65,5,5,10
Jordan,2003,sp,014,1,0,1
Jordan,2003,sp,1524,6,19,25
Jordan,2003,sp,2534,7,20,27
Jordan,2003,sp,3544,2,17,19
Jordan,2003,sp,4554,3,8,11
Jordan,2003,sp,5564,12,13,25
Jordan,2003,sp,65,0,0,0
Jordan,2004,sp,014,0,0,0
Jordan,2004,sp,1524,10,8,18
Jordan,2004,sp,2534,4,12,16
Jordan,2004,sp,3544,3,14,17
Jordan,2004,sp,4554,5,6,11
Jordan,2004,sp,5564,12,17,29
Jordan,2004,sp,65,0,0,0
Jordan,2005,sp,014,1,0,1
Jordan,2005,sp,1524,6,8,14
Jordan,2005,sp,2534,6,17,23
Jordan,2005,sp,3544,6,9,15
Jordan,2005,sp,4554,5,4,9
Jordan,2005,sp,5564,8,6,14
Jordan,2005,sp,65,5,5,10
Jordan,2006,ep,014,9,22,31
Jordan,2006,ep,1524,26,11,37
Jordan,2006,ep,2534,22,13,35
Jordan,2006,ep,3544,20,7,27
Jordan,2006,ep,4554,13,4,17
Jordan,2006,ep,5564,14,1,15
Jordan,2006,ep,65,9,10,19
Jordan,2006,sn,014,8,13,21
Jordan,2006,sn,1524,6,3,9
Jordan,2006,sn,2534,3,5,8
Jordan,2006,sn,3544,3,4,7
Jordan,2006,sn,4554,3,6,9
Jordan,2006,sn,5564,2,3,5
Jordan,2006,sn,65,5,6,11
Jordan,2006,sp,014,0,0,0
Jordan,2006,sp,1524,8,9,17
Jordan,2006,sp,2534,11,23,34
Jordan,2006,sp,3544,3,16,19
Jordan,2006,sp,4554,5,7,12
Jordan,2006,sp,5564,2,4,6
Jordan,2006,sp,65,6,10,16
Jordan,2007,ep,014,9,17,26
Jordan,2007,ep,1524,20,6,26
Jordan,2007,ep,2534,21,19,40
Jordan,2007,ep,3544,7,10,17
Jordan,2007,ep,4554,12,3,15
Jordan,2007,ep,5564,11,8,19
Jordan,2007,ep,65,7,4,11
Jordan,2007,sn,014,5,2,7
Jordan,2007,sn,1524,6,9,15
Jordan,2007,sn,2534,9,8,17
Jordan,2007,sn,3544,6,6,12
Jordan,2007,sn,4554,5,0,5
Jordan,2007,sn,5564,3,4,7
Jordan,2007,sn,65,3,4,7
Jordan,2007,sp,014,0,0,0
Jordan,2007,sp,1524,9,7,16
Jordan,2007,sp,2534,12,20,32
Jordan,2007,sp,3544,6,14,20
Jordan,2007,sp,4554,1,9,10
Jordan,2007,sp,5564,12,7,19
Jordan,2007,sp,65,7,5,12
Jordan,2008,ep,014,10,16,26
Jordan,2008,ep,1524,25,10,35
Jordan,2008,ep,2534,17,12,29
Jordan,2008,ep,3544,18,8,26
Jordan,2008,ep,4554,7,8,15
Jordan,2008,ep,5564,12,5,17
Jordan,2008,ep,65,10,7,17
Jordan,2008,sn,014,4,6,10
Jordan,2008,sn,1524,8,4,12
Jordan,2008,sn,2534,10,8,18
Jordan,2008,sn,3544,3,5,8
Jordan,2008,sn,4554,1,3,4
Jordan,2008,sn,5564,4,7,11
Jordan,2008,sn,65,2,3,5
Jordan,2008,sp,014,0,0,0
Jordan,2008,sp,1524,20,13,33
Jordan,2008,sp,2534,15,10,25
Jordan,2008,sp,3544,6,3,9
Jordan,2008,sp,4554,4,5,9
Jordan,2008,sp,5564,7,13,20
Jordan,2008,sp,65,3,5,8
Jordan,2009,ep,014,13,19,32
Jordan,2009,ep,1524,24,18,42
Jordan,2009,ep,2534,30,13,43
Jordan,2009,ep,3544,11,7,18
Jordan,2009,ep,4554,15,6,21
Jordan,2009,ep,5564,7,5,12
Jordan,2009,ep,65,17,5,22
Jordan,2009,sn,014,6,1,7
Jordan,2009,sn,1524,5,1,6
Jordan,2009,sn,2534,10,11,21
Jordan,2009,sn,3544,6,3,9
Jordan,2009,sn,4554,1,2,3
Jordan,2009,sn,5564,3,7,10
Jordan,2009,sn,65,4,4,8
Jordan,2009,sp,014,0,1,1
Jordan,2009,sp,1524,7,5,12
Jordan,2009,sp,2534,14,15,29
Jordan,2009,sp,3544,8,14,22
Jordan,2009,sp,4554,3,10,13
Jordan,2009,sp,5564,7,7,14
Jordan,2009,sp,65,12,6,18
Jordan,2010,ep,014,17,15,32
Jordan,2010,ep,1524,18,7,25
Jordan,2010,ep,2534,23,6,29
Jordan,2010,ep,3544,20,8,28
Jordan,2010,ep,4554,12,3,15
Jordan,2010,ep,5564,7,4,11
Jordan,2010,ep,65,8,2,10
Jordan,2010,sn,014,11,3,14
Jordan,2010,sn,1524,3,4,7
Jordan,2010,sn,2534,10,3,13
Jordan,2010,sn,3544,6,5,11
Jordan,2010,sn,4554,4,3,7
Jordan,2010,sn,5564,4,2,6
Jordan,2010,sn,65,6,5,11
Jordan,2010,sp,014,3,2,5
Jordan,2010,sp,1524,14,5,19
Jordan,2010,sp,2534,24,14,38
Jordan,2010,sp,3544,4,10,14
Jordan,2010,sp,4554,3,12,15
Jordan,2010,sp,5564,5,12,17
Jordan,2010,sp,65,3,6,9
Jordan,2011,ep,014,30,15,45
Jordan,2011,ep,1524,16,10,26
Jordan,2011,ep,2534,11,5,16
Jordan,2011,ep,3544,11,3,14
Jordan,2011,ep,4554,2,5,7
Jordan,2011,ep,5564,9,2,11
Jordan,2011,ep,65,4,5,9
Jordan,2011,sn,014,3,3,6
Jordan,2011,sn,1524,11,3,14
Jordan,2011,sn,2534,9,9,18
Jordan,2011,sn,3544,3,9,12
Jordan,2011,sn,4554,2,3,5
Jordan,2011,sn,5564,4,7,11
Jordan,2011,sn,65,7,8,15
Jordan,2011,sp,014,0,0,0
Jordan,2011,sp,1524,8,9,17
Jordan,2011,sp,2534,11,10,21
Jordan,2011,sp,3544,8,13,21
Jordan,2011,sp,4554,4,8,12
Jordan,2011,sp,5564,8,13,21
Jordan,2011,sp,65,6,5,11
Jordan,2012,ep,014,13,16,29
Jordan,2012,ep,1524,21,6,27
Jordan,2012,ep,2534,26,11,37
Jordan,2012,ep,3544,23,9,32
Jordan,2012,ep,4554,14,6,20
Jordan,2012,ep,5564,11,5,16
Jordan,2012,ep,65,9,2,11
Jordan,2012,sn,014,3,2,5
Jordan,2012,sn,1524,9,6,15
Jordan,2012,sn,2534,7,10,17
Jordan,2012,sn,3544,7,5,12
Jordan,2012,sn,4554,4,2,6
Jordan,2012,sn,5564,4,5,9
Jordan,2012,sn,65,3,6,9
Jordan,2012,sp,014,1,0,1
Jordan,2012,sp,1524,9,8,17
Jordan,2012,sp,2534,12,12,24
Jordan,2012,sp,3544,7,8,15
Jordan,2012,sp,4554,1,5,6
Jordan,2012,sp,5564,3,7,10
Jordan,2012,sp,65,5,7,12
Jordan,2013,rel,014,8,12,20
Jordan,2013,rel,1524,43,19,62
Jordan,2013,rel,2534,49,39,88
Jordan,2013,rel,3544,30,37,67
Jordan,2013,rel,4554,19,19,38
Jordan,2013,rel,5564,11,10,21
Jordan,2013,rel,65,9,21,30
Kazakhstan,1997,sp,014,47,22,69
Kazakhstan,1997,sp,1524,78,68,146
Kazakhstan,1997,sp,2534,673,827,1500
Kazakhstan,1997,sp,3544,423,725,1148
Kazakhstan,1997,sp,4554,141,475,616
Kazakhstan,1997,sp,5564,142,485,627
Kazakhstan,1997,sp,65,115,211,326
Kazakhstan,1998,sp,014,62,34,96
Kazakhstan,1998,sp,1524,625,795,1420
Kazakhstan,1998,sp,2534,713,1009,1722
Kazakhstan,1998,sp,3544,457,817,1274
Kazakhstan,1998,sp,4554,204,628,832
Kazakhstan,1998,sp,5564,174,515,689
Kazakhstan,1998,sp,65,69,78,147
Kazakhstan,1999,sp,014,60,34,94
Kazakhstan,1999,sp,1524,822,778,1600
Kazakhstan,1999,sp,2534,872,1217,2089
Kazakhstan,1999,sp,3544,452,1026,1478
Kazakhstan,1999,sp,4554,226,560,786
Kazakhstan,1999,sp,5564,171,368,539
Kazakhstan,1999,sp,65,136,165,301
Kazakhstan,2000,sp,014,84,36,120
Kazakhstan,2000,sp,1524,999,1057,2056
Kazakhstan,2000,sp,2534,1079,1409,2488
Kazakhstan,2000,sp,3544,599,1379,1978
Kazakhstan,2000,sp,4554,275,923,1198
Kazakhstan,2000,sp,5564,202,439,641
Kazakhstan,2000,sp,65,204,218,422
Kazakhstan,2001,sp,014,88,38,126
Kazakhstan,2001,sp,1524,1040,1038,2078
Kazakhstan,2001,sp,2534,1062,1477,2539
Kazakhstan,2001,sp,3544,570,1485,2055
Kazakhstan,2001,sp,4554,263,1011,1274
Kazakhstan,2001,sp,5564,194,429,623
Kazakhstan,2001,sp,65,173,211,384
Kazakhstan,2002,sp,014,68,33,101
Kazakhstan,2002,sp,1524,1035,1067,2102
Kazakhstan,2002,sp,2534,1086,1565,2651
Kazakhstan,2002,sp,3544,669,1490,2159
Kazakhstan,2002,sp,4554,348,1042,1390
Kazakhstan,2002,sp,5564,194,435,629
Kazakhstan,2002,sp,65,208,212,420
Kazakhstan,2004,sp,014,62,24,86
Kazakhstan,2004,sp,1524,844,989,1833
Kazakhstan,2004,sp,2534,912,1291,2203
Kazakhstan,2004,sp,3544,517,1183,1700
Kazakhstan,2004,sp,4554,307,899,1206
Kazakhstan,2004,sp,5564,178,336,514
Kazakhstan,2004,sp,65,189,196,385
Kazakhstan,2005,sp,014,46,31,77
Kazakhstan,2005,sp,1524,751,917,1668
Kazakhstan,2005,sp,2534,767,1142,1909
Kazakhstan,2005,sp,3544,436,983,1419
Kazakhstan,2005,sp,4554,286,795,1081
Kazakhstan,2005,sp,5564,121,274,395
Kazakhstan,2005,sp,65,187,175,362
Kazakhstan,2006,ep,014,1495,1515,3010
Kazakhstan,2006,ep,1524,580,638,1218
Kazakhstan,2006,ep,2534,396,332,728
Kazakhstan,2006,ep,3544,281,248,529
Kazakhstan,2006,ep,4554,185,180,365
Kazakhstan,2006,ep,5564,93,89,182
Kazakhstan,2006,ep,65,85,80,165
Kazakhstan,2006,sn,014,1080,1025,2105
Kazakhstan,2006,sn,1524,1800,1717,3517
Kazakhstan,2006,sn,2534,1644,1608,3252
Kazakhstan,2006,sn,3544,914,1250,2164
Kazakhstan,2006,sn,4554,551,988,1539
Kazakhstan,2006,sn,5564,193,445,638
Kazakhstan,2006,sn,65,134,237,371
Kazakhstan,2006,sp,014,30,11,41
Kazakhstan,2006,sp,1524,741,888,1629
Kazakhstan,2006,sp,2534,636,981,1617
Kazakhstan,2006,sp,3544,370,848,1218
Kazakhstan,2006,sp,4554,234,744,978
Kazakhstan,2006,sp,5564,116,287,403
Kazakhstan,2006,sp,65,150,169,319
Kazakhstan,2007,ep,014,2,483,485
Kazakhstan,2007,ep,1524,410,499,909
Kazakhstan,2007,ep,2534,272,290,562
Kazakhstan,2007,ep,3544,207,187,394
Kazakhstan,2007,ep,4554,132,137,269
Kazakhstan,2007,ep,5564,53,49,102
Kazakhstan,2007,ep,65,51,51,102
Kazakhstan,2007,sn,014,678,669,1347
Kazakhstan,2007,sn,1524,1773,1690,3463
Kazakhstan,2007,sn,2534,1477,1579,3056
Kazakhstan,2007,sn,3544,816,1096,1912
Kazakhstan,2007,sn,4554,487,855,1342
Kazakhstan,2007,sn,5564,184,423,607
Kazakhstan,2007,sn,65,119,209,328
Kazakhstan,2007,sp,014,38,14,52
Kazakhstan,2007,sp,1524,782,881,1663
Kazakhstan,2007,sp,2534,605,976,1581
Kazakhstan,2007,sp,3544,367,859,1226
Kazakhstan,2007,sp,4554,249,714,963
Kazakhstan,2007,sp,5564,124,279,403
Kazakhstan,2007,sp,65,157,150,307
Kazakhstan,2008,ep,014,271,329,600
Kazakhstan,2008,ep,1524,347,392,739
Kazakhstan,2008,ep,2534,260,301,561
Kazakhstan,2008,ep,3544,207,185,392
Kazakhstan,2008,ep,4554,112,130,242
Kazakhstan,2008,ep,5564,53,61,114
Kazakhstan,2008,ep,65,66,40,106
Kazakhstan,2008,sn,014,203,120,323
Kazakhstan,2008,sn,1524,1854,1759,3613
Kazakhstan,2008,sn,2534,1360,1440,2800
Kazakhstan,2008,sn,3544,792,1049,1841
Kazakhstan,2008,sn,4554,454,803,1257
Kazakhstan,2008,sn,5564,171,418,589
Kazakhstan,2008,sn,65,127,187,314
Kazakhstan,2008,sp,014,44,14,58
Kazakhstan,2008,sp,1524,710,897,1607
Kazakhstan,2008,sp,2534,659,968,1627
Kazakhstan,2008,sp,3544,320,811,1131
Kazakhstan,2008,sp,4554,230,752,982
Kazakhstan,2008,sp,5564,137,306,443
Kazakhstan,2008,sp,65,185,160,345
Kazakhstan,2009,ep,014,210,261,471
Kazakhstan,2009,ep,1524,262,332,594
Kazakhstan,2009,ep,2534,270,244,514
Kazakhstan,2009,ep,3544,142,147,289
Kazakhstan,2009,ep,4554,97,117,214
Kazakhstan,2009,ep,5564,63,58,121
Kazakhstan,2009,ep,65,40,37,77
Kazakhstan,2009,sn,014,171,133,304
Kazakhstan,2009,sn,1524,1629,1588,3217
Kazakhstan,2009,sn,2534,1251,1249,2500
Kazakhstan,2009,sn,3544,672,800,1472
Kazakhstan,2009,sn,4554,375,738,1113
Kazakhstan,2009,sn,5564,145,329,474
Kazakhstan,2009,sn,65,93,145,238
Kazakhstan,2009,sp,014,37,6,43
Kazakhstan,2009,sp,1524,662,765,1427
Kazakhstan,2009,sp,2534,519,812,1331
Kazakhstan,2009,sp,3544,337,676,1013
Kazakhstan,2009,sp,4554,200,573,773
Kazakhstan,2009,sp,5564,122,252,374
Kazakhstan,2009,sp,65,135,116,251
Kazakhstan,2010,ep,014,194,236,430
Kazakhstan,2010,ep,1524,255,317,572
Kazakhstan,2010,ep,2534,221,213,434
Kazakhstan,2010,ep,3544,147,140,287
Kazakhstan,2010,ep,4554,111,97,208
Kazakhstan,2010,ep,5564,58,61,119
Kazakhstan,2010,ep,65,41,36,77
Kazakhstan,2010,sn,014,162,93,255
Kazakhstan,2010,sn,1524,1424,1430,2854
Kazakhstan,2010,sn,2534,1235,1122,2357
Kazakhstan,2010,sn,3544,583,774,1357
Kazakhstan,2010,sn,4554,384,636,1020
Kazakhstan,2010,sn,5564,167,364,531
Kazakhstan,2010,sn,65,82,135,217
Kazakhstan,2010,sp,014,33,15,48
Kazakhstan,2010,sp,1524,566,675,1241
Kazakhstan,2010,sp,2534,520,754,1274
Kazakhstan,2010,sp,3544,263,595,858
Kazakhstan,2010,sp,4554,205,511,716
Kazakhstan,2010,sp,5564,122,251,373
Kazakhstan,2010,sp,65,132,127,259
Kazakhstan,2011,ep,014,176,191,367
Kazakhstan,2011,ep,1524,200,271,471
Kazakhstan,2011,ep,2534,216,223,439
Kazakhstan,2011,ep,3544,145,134,279
Kazakhstan,2011,ep,4554,89,113,202
Kazakhstan,2011,ep,5564,76,71,147
Kazakhstan,2011,ep,65,51,40,91
Kazakhstan,2011,sn,014,139,95,234
Kazakhstan,2011,sn,1524,1355,1281,2636
Kazakhstan,2011,sn,2534,1143,1126,2269
Kazakhstan,2011,sn,3544,583,775,1358
Kazakhstan,2011,sn,4554,353,569,922
Kazakhstan,2011,sn,5564,144,323,467
Kazakhstan,2011,sn,65,90,118,208
Kazakhstan,2011,sp,014,15,6,21
Kazakhstan,2011,sp,1524,439,602,1041
Kazakhstan,2011,sp,2534,495,716,1211
Kazakhstan,2011,sp,3544,260,516,776
Kazakhstan,2011,sp,4554,190,515,705
Kazakhstan,2011,sp,5564,109,235,344
Kazakhstan,2011,sp,65,117,91,208
Kazakhstan,2012,ep,014,150,158,308
Kazakhstan,2012,ep,1524,197,208,405
Kazakhstan,2012,ep,2534,194,244,438
Kazakhstan,2012,ep,3544,121,139,260
Kazakhstan,2012,ep,4554,91,114,205
Kazakhstan,2012,ep,5564,75,70,145
Kazakhstan,2012,ep,65,50,33,83
Kazakhstan,2012,sn,014,151,92,243
Kazakhstan,2012,sn,1524,1199,1164,2363
Kazakhstan,2012,sn,2534,1109,1009,2118
Kazakhstan,2012,sn,3544,514,798,1312
Kazakhstan,2012,sn,4554,330,590,920
Kazakhstan,2012,sn,5564,138,355,493
Kazakhstan,2012,sn,65,109,118,227
Kazakhstan,2012,sp,014,16,9,25
Kazakhstan,2012,sp,1524,415,508,923
Kazakhstan,2012,sp,2534,411,586,997
Kazakhstan,2012,sp,3544,241,514,755
Kazakhstan,2012,sp,4554,177,479,656
Kazakhstan,2012,sp,5564,97,233,330
Kazakhstan,2012,sp,65,100,98,198
Kazakhstan,2013,rel,014,276,235,511
Kazakhstan,2013,rel,1524,1712,1991,3703
Kazakhstan,2013,rel,2534,2005,2957,4962
Kazakhstan,2013,rel,3544,1154,2604,3758
Kazakhstan,2013,rel,4554,798,2104,2902
Kazakhstan,2013,rel,5564,580,1337,1917
Kazakhstan,2013,rel,65,594,611,1205
Kenya,1995,sp,014,187,154,341
Kenya,1995,sp,1524,1802,2072,3874
Kenya,1995,sp,2534,1759,3073,4832
Kenya,1995,sp,3544,741,1675,2416
Kenya,1995,sp,4554,411,920,1331
Kenya,1995,sp,5564,242,485,727
Kenya,1995,sp,65,117,296,413
Kenya,1996,sp,014,252,151,403
Kenya,1996,sp,1524,2290,2492,4782
Kenya,1996,sp,2534,2327,3820,6147
Kenya,1996,sp,3544,926,2097,3023
Kenya,1996,sp,4554,462,993,1455
Kenya,1996,sp,5564,245,498,743
Kenya,1996,sp,65,114,311,425
Kenya,1997,sp,014,242,53,295
Kenya,1997,sp,1524,2573,2881,5454
Kenya,1997,sp,2534,2604,4374,6978
Kenya,1997,sp,3544,1086,2333,3419
Kenya,1997,sp,4554,499,1100,1599
Kenya,1997,sp,5564,242,482,724
Kenya,1997,sp,65,103,284,387
Kenya,1998,sp,014,318,210,528
Kenya,1998,sp,1524,3315,3372,6687
Kenya,1998,sp,2534,3469,5477,8946
Kenya,1998,sp,3544,1378,2983,4361
Kenya,1998,sp,4554,656,1378,2034
Kenya,1998,sp,5564,324,626,950
Kenya,1998,sp,65,141,382,523
Kenya,1999,sp,014,373,237,610
Kenya,1999,sp,1524,3850,3835,7685
Kenya,1999,sp,2534,3997,6078,10075
Kenya,1999,sp,3544,1596,3349,4945
Kenya,1999,sp,4554,760,1545,2305
Kenya,1999,sp,5564,348,645,993
Kenya,1999,sp,65,179,405,584
Kenya,2000,sp,014,416,264,680
Kenya,2000,sp,1524,3916,3739,7655
Kenya,2000,sp,2534,4363,6653,11016
Kenya,2000,sp,3544,1874,3548,5422
Kenya,2000,sp,4554,831,1630,2461
Kenya,2000,sp,5564,347,630,977
Kenya,2000,sp,65,148,414,562
Kenya,2001,sp,014,464,299,763
Kenya,2001,sp,1524,4116,4083,8199
Kenya,2001,sp,2534,4822,7070,11892
Kenya,2001,sp,3544,2063,3903,5966
Kenya,2001,sp,4554,935,1771,2706
Kenya,2001,sp,5564,394,723,1117
Kenya,2001,sp,65,221,443,664
Kenya,2002,sp,014,392,299,691
Kenya,2002,sp,1524,4542,4445,8987
Kenya,2002,sp,2534,5465,7708,13173
Kenya,2002,sp,3544,2267,4306,6573
Kenya,2002,sp,4554,996,2023,3019
Kenya,2002,sp,5564,445,807,1252
Kenya,2002,sp,65,190,433,623
Kenya,2003,sp,014,487,341,828
Kenya,2003,sp,1524,5003,4918,9921
Kenya,2003,sp,2534,6023,8515,14538
Kenya,2003,sp,3544,2618,4560,7178
Kenya,2003,sp,4554,1171,2167,3338
Kenya,2003,sp,5564,551,928,1479
Kenya,2003,sp,65,309,567,876
Kenya,2004,sp,014,519,391,910
Kenya,2004,sp,1524,5458,5388,10846
Kenya,2004,sp,2534,6326,9016,15342
Kenya,2004,sp,3544,2850,5142,7992
Kenya,2004,sp,4554,1236,2404,3640
Kenya,2004,sp,5564,558,973,1531
Kenya,2004,sp,65,312,576,888
Kenya,2005,sp,014,577,359,936
Kenya,2005,sp,1524,5144,4790,9934
Kenya,2005,sp,2534,6521,8832,15353
Kenya,2005,sp,3544,2781,5069,7850
Kenya,2005,sp,4554,1266,2521,3787
Kenya,2005,sp,5564,593,1031,1624
Kenya,2005,sp,65,315,590,905
Kenya,2006,sp,014,583,387,970
Kenya,2006,sp,1524,4953,4708,9661
Kenya,2006,sp,2534,6052,8229,14281
Kenya,2006,sp,3544,2792,4975,7767
Kenya,2006,sp,4554,1343,2467,3810
Kenya,2006,sp,5564,604,1037,1641
Kenya,2006,sp,65,379,645,1024
Kenya,2007,sp,014,599,474,1073
Kenya,2007,sp,1524,4594,4752,9346
Kenya,2007,sp,2534,5979,8132,14111
Kenya,2007,sp,3544,2774,4959,7733
Kenya,2007,sp,4554,1180,2361,3541
Kenya,2007,sp,5564,542,1084,1626
Kenya,2007,sp,65,329,601,930
Kenya,2008,ep,014,946,1076,2022
Kenya,2008,ep,1524,1118,1040,2158
Kenya,2008,ep,2534,1806,1839,3645
Kenya,2008,ep,3544,1090,1416,2506
Kenya,2008,ep,4554,567,794,1361
Kenya,2008,ep,5564,301,418,719
Kenya,2008,ep,65,203,257,460
Kenya,2008,sn,014,1423,1490,2913
Kenya,2008,sn,1524,2406,2154,4560
Kenya,2008,sn,2534,4188,3927,8115
Kenya,2008,sn,3544,2778,3516,6294
Kenya,2008,sn,4554,1537,2117,3654
Kenya,2008,sn,5564,826,1104,1930
Kenya,2008,sn,65,647,902,1549
Kenya,2008,sp,014,586,451,1037
Kenya,2008,sp,1524,4355,4709,9064
Kenya,2008,sp,2534,5475,8128,13603
Kenya,2008,sp,3544,2431,4924,7355
Kenya,2008,sp,4554,1065,2302,3367
Kenya,2008,sp,5564,481,1025,1506
Kenya,2008,sp,65,296,583,879
Kenya,2009,ep,014,1346,1638,2984
Kenya,2009,ep,1524,1412,1366,2778
Kenya,2009,ep,2534,2394,2366,4760
Kenya,2009,ep,3544,1491,2006,3497
Kenya,2009,ep,4554,730,1110,1840
Kenya,2009,ep,5564,361,508,869
Kenya,2009,ep,65,303,407,710
Kenya,2009,sn,014,1272,1255,2527
Kenya,2009,sn,1524,2533,2363,4896
Kenya,2009,sn,2534,4921,4789,9710
Kenya,2009,sn,3544,3303,4109,7412
Kenya,2009,sn,4554,1550,2404,3954
Kenya,2009,sn,5564,977,1274,2251
Kenya,2009,sn,65,707,1130,1837
Kenya,2009,sp,014,662,470,1132
Kenya,2009,sp,1524,4306,4667,8973
Kenya,2009,sp,2534,5387,8081,13468
Kenya,2009,sp,3544,2512,5067,7579
Kenya,2009,sp,4554,1104,2565,3669
Kenya,2009,sp,5564,540,1030,1570
Kenya,2009,sp,65,352,659,1011
Kenya,2010,ep,014,1248,1485,2733
Kenya,2010,ep,1524,1375,1341,2716
Kenya,2010,ep,2534,2368,2383,4751
Kenya,2010,ep,3544,1567,1975,3542
Kenya,2010,ep,4554,743,1101,1844
Kenya,2010,ep,5564,396,536,932
Kenya,2010,ep,65,353,511,864
Kenya,2010,sn,014,1044,1038,2082
Kenya,2010,sn,1524,2410,2189,4599
Kenya,2010,sn,2534,4640,4427,9067
Kenya,2010,sn,3544,3156,4131,7287
Kenya,2010,sn,4554,1767,2491,4258
Kenya,2010,sn,5564,1047,1363,2410
Kenya,2010,sn,65,848,1291,2139
Kenya,2010,sp,014,549,357,906
Kenya,2010,sp,1524,4044,4698,8742
Kenya,2010,sp,2534,5112,7945,13057
Kenya,2010,sp,3544,2372,5077,7449
Kenya,2010,sp,4554,1056,2509,3565
Kenya,2010,sp,5564,544,994,1538
Kenya,2010,sp,65,345,658,1003
Kenya,2011,ep,014,1297,1498,2795
Kenya,2011,ep,1524,1339,1375,2714
Kenya,2011,ep,2534,2193,2317,4510
Kenya,2011,ep,3544,1450,2007,3457
Kenya,2011,ep,4554,689,1140,1829
Kenya,2011,ep,5564,387,571,958
Kenya,2011,ep,65,335,471,806
Kenya,2011,sn,014,1008,1000,2008
Kenya,2011,sn,1524,2309,2279,4588
Kenya,2011,sn,2534,4162,4279,8441
Kenya,2011,sn,3544,2979,3957,6936
Kenya,2011,sn,4554,1641,2453,4094
Kenya,2011,sn,5564,996,1296,2292
Kenya,2011,sn,65,815,1220,2035
Kenya,2011,sp,014,629,356,985
Kenya,2011,sp,1524,4183,4773,8956
Kenya,2011,sp,2534,4917,8376,13293
Kenya,2011,sp,3544,2434,5201,7635
Kenya,2011,sp,4554,1025,2660,3685
Kenya,2011,sp,5564,477,1045,1522
Kenya,2011,sp,65,344,665,1009
Kenya,2012,ep,014,1150,1315,2465
Kenya,2012,ep,1524,1227,1272,2499
Kenya,2012,ep,2534,2091,2159,4250
Kenya,2012,ep,3544,1394,1779,3173
Kenya,2012,ep,4554,731,1036,1767
Kenya,2012,ep,5564,415,539,954
Kenya,2012,ep,65,368,458,826
Kenya,2012,sn,014,965,942,1907
Kenya,2012,sn,1524,2149,2079,4228
Kenya,2012,sn,2534,3841,4012,7853
Kenya,2012,sn,3544,2753,3699,6452
Kenya,2012,sn,4554,1584,2235,3819
Kenya,2012,sn,5564,882,1317,2199
Kenya,2012,sn,65,841,1279,2120
Kenya,2012,sp,014,603,393,996
Kenya,2012,sp,1524,4097,4893,8990
Kenya,2012,sp,2534,4975,8149,13124
Kenya,2012,sp,3544,2363,5302,7665
Kenya,2012,sp,4554,993,2493,3486
Kenya,2012,sp,5564,529,1099,1628
Kenya,2012,sp,65,379,669,1048
Kenya,2013,rel,014,2174,2209,4383
Kenya,2013,rel,1524,6425,7614,14039
Kenya,2013,rel,2534,9717,13059,22776
Kenya,2013,rel,3544,6052,10306,16358
Kenya,2013,rel,4554,3002,5571,8573
Kenya,2013,rel,5564,1641,2776,4417
Kenya,2013,rel,65,1402,2387,3789
Kiribati,1996,sp,014,2,0,2
Kiribati,1996,sp,1524,3,4,7
Kiribati,1996,sp,2534,3,1,4
Kiribati,1996,sp,3544,4,2,6
Kiribati,1996,sp,4554,2,2,4
Kiribati,1996,sp,5564,1,2,3
Kiribati,1996,sp,65,1,2,3
Kiribati,1997,sp,014,2,1,3
Kiribati,1997,sp,1524,0,2,2
Kiribati,1997,sp,2534,0,0,0
Kiribati,1997,sp,3544,2,0,2
Kiribati,1997,sp,4554,0,5,5
Kiribati,1997,sp,5564,2,1,3
Kiribati,1997,sp,65,1,1,2
Kiribati,1998,sp,014,2,1,3
Kiribati,1998,sp,1524,7,6,13
Kiribati,1998,sp,2534,5,10,15
Kiribati,1998,sp,3544,3,2,5
Kiribati,1998,sp,4554,5,3,8
Kiribati,1998,sp,5564,1,2,3
Kiribati,1998,sp,65,1,1,2
Kiribati,1999,sp,014,1,2,3
Kiribati,1999,sp,1524,9,6,15
Kiribati,1999,sp,2534,9,4,13
Kiribati,1999,sp,3544,6,2,8
Kiribati,1999,sp,4554,2,4,6
Kiribati,1999,sp,5564,3,4,7
Kiribati,1999,sp,65,4,3,7
Kiribati,2000,sp,014,2,2,4
Kiribati,2000,sp,1524,5,9,14
Kiribati,2000,sp,2534,6,3,9
Kiribati,2000,sp,3544,3,3,6
Kiribati,2000,sp,4554,4,3,7
Kiribati,2000,sp,5564,1,8,9
Kiribati,2000,sp,65,3,2,5
Kiribati,2001,sp,014,4,4,8
Kiribati,2001,sp,1524,7,10,17
Kiribati,2001,sp,2534,7,7,14
Kiribati,2001,sp,3544,3,3,6
Kiribati,2001,sp,4554,3,3,6
Kiribati,2001,sp,5564,4,5,9
Kiribati,2001,sp,65,1,3,4
Kiribati,2002,sp,014,5,5,10
Kiribati,2002,sp,1524,15,11,26
Kiribati,2002,sp,2534,8,1,9
Kiribati,2002,sp,3544,8,7,15
Kiribati,2002,sp,4554,3,7,10
Kiribati,2002,sp,5564,4,7,11
Kiribati,2002,sp,65,1,NA,NA
Kiribati,2003,sp,014,5,5,10
Kiribati,2003,sp,1524,20,13,33
Kiribati,2003,sp,2534,4,5,9
Kiribati,2003,sp,3544,12,9,21
Kiribati,2003,sp,4554,7,6,13
Kiribati,2003,sp,5564,3,6,9
Kiribati,2003,sp,65,4,0,4
Kiribati,2004,sp,014,7,8,15
Kiribati,2004,sp,1524,31,17,48
Kiribati,2004,sp,2534,9,10,19
Kiribati,2004,sp,3544,12,12,24
Kiribati,2004,sp,4554,7,10,17
Kiribati,2004,sp,5564,6,9,15
Kiribati,2004,sp,65,1,3,4
Kiribati,2005,sp,014,5,3,8
Kiribati,2005,sp,1524,22,15,37
Kiribati,2005,sp,2534,12,15,27
Kiribati,2005,sp,3544,7,12,19
Kiribati,2005,sp,4554,7,17,24
Kiribati,2005,sp,5564,3,4,7
Kiribati,2005,sp,65,1,1,2
Kiribati,2006,ep,014,25,29,54
Kiribati,2006,ep,1524,9,17,26
Kiribati,2006,ep,2534,7,5,12
Kiribati,2006,ep,3544,6,8,14
Kiribati,2006,ep,4554,3,2,5
Kiribati,2006,ep,5564,2,4,6
Kiribati,2006,ep,65,2,2,4
Kiribati,2006,sn,014,20,11,31
Kiribati,2006,sn,1524,10,10,20
Kiribati,2006,sn,2534,5,6,11
Kiribati,2006,sn,3544,2,9,11
Kiribati,2006,sn,4554,1,11,12
Kiribati,2006,sn,5564,2,7,9
Kiribati,2006,sn,65,1,9,10
Kiribati,2006,sp,014,5,3,8
Kiribati,2006,sp,1524,15,18,33
Kiribati,2006,sp,2534,5,18,23
Kiribati,2006,sp,3544,5,16,21
Kiribati,2006,sp,4554,1,18,19
Kiribati,2006,sp,5564,8,3,11
Kiribati,2006,sp,65,3,7,10
Kiribati,2007,ep,014,36,31,67
Kiribati,2007,ep,1524,15,24,39
Kiribati,2007,ep,2534,5,4,9
Kiribati,2007,ep,3544,11,4,15
Kiribati,2007,ep,4554,1,2,3
Kiribati,2007,ep,5564,3,6,9
Kiribati,2007,ep,65,3,2,5
Kiribati,2007,sn,014,16,12,28
Kiribati,2007,sn,1524,4,12,16
Kiribati,2007,sn,2534,3,2,5
Kiribati,2007,sn,3544,5,8,13
Kiribati,2007,sn,4554,3,4,7
Kiribati,2007,sn,5564,3,2,5
Kiribati,2007,sn,65,0,4,4
Kiribati,2007,sp,014,8,2,10
Kiribati,2007,sp,1524,13,15,28
Kiribati,2007,sp,2534,6,7,13
Kiribati,2007,sp,3544,8,10,18
Kiribati,2007,sp,4554,9,6,15
Kiribati,2007,sp,5564,4,10,14
Kiribati,2007,sp,65,2,3,5
Kiribati,2008,ep,014,10,15,25
Kiribati,2008,ep,1524,8,14,22
Kiribati,2008,ep,2534,3,16,19
Kiribati,2008,ep,3544,6,8,14
Kiribati,2008,ep,4554,12,8,20
Kiribati,2008,ep,5564,1,2,3
Kiribati,2008,ep,65,2,2,4
Kiribati,2008,sn,014,12,9,21
Kiribati,2008,sn,1524,8,7,15
Kiribati,2008,sn,2534,6,4,10
Kiribati,2008,sn,3544,1,6,7
Kiribati,2008,sn,4554,1,9,10
Kiribati,2008,sn,5564,1,4,5
Kiribati,2008,sn,65,1,2,3
Kiribati,2008,sp,014,4,2,6
Kiribati,2008,sp,1524,33,30,63
Kiribati,2008,sp,2534,9,9,18
Kiribati,2008,sp,3544,12,15,27
Kiribati,2008,sp,4554,9,10,19
Kiribati,2008,sp,5564,3,2,5
Kiribati,2008,sp,65,4,5,9
Kiribati,2009,ep,014,11,11,22
Kiribati,2009,ep,1524,6,6,12
Kiribati,2009,ep,2534,4,3,7
Kiribati,2009,ep,3544,1,5,6
Kiribati,2009,ep,4554,3,5,8
Kiribati,2009,ep,5564,1,1,2
Kiribati,2009,ep,65,0,2,2
Kiribati,2009,sn,014,10,8,18
Kiribati,2009,sn,1524,8,9,17
Kiribati,2009,sn,2534,2,2,4
Kiribati,2009,sn,3544,6,5,11
Kiribati,2009,sn,4554,5,4,9
Kiribati,2009,sn,5564,3,4,7
Kiribati,2009,sn,65,3,1,4
Kiribati,2009,sp,014,10,6,16
Kiribati,2009,sp,1524,19,22,41
Kiribati,2009,sp,2534,12,13,25
Kiribati,2009,sp,3544,9,12,21
Kiribati,2009,sp,4554,14,8,22
Kiribati,2009,sp,5564,5,6,11
Kiribati,2009,sp,65,3,6,9
Kiribati,2010,ep,014,14,8,22
Kiribati,2010,ep,1524,9,10,19
Kiribati,2010,ep,2534,2,6,8
Kiribati,2010,ep,3544,3,8,11
Kiribati,2010,ep,4554,2,5,7
Kiribati,2010,ep,5564,1,1,2
Kiribati,2010,ep,65,1,1,2
Kiribati,2010,sn,014,12,8,20
Kiribati,2010,sn,1524,9,17,26
Kiribati,2010,sn,2534,3,10,13
Kiribati,2010,sn,3544,3,7,10
Kiribati,2010,sn,4554,4,4,8
Kiribati,2010,sn,5564,4,8,12
Kiribati,2010,sn,65,2,0,2
Kiribati,2010,sp,014,5,3,8
Kiribati,2010,sp,1524,15,27,42
Kiribati,2010,sp,2534,7,13,20
Kiribati,2010,sp,3544,4,10,14
Kiribati,2010,sp,4554,8,9,17
Kiribati,2010,sp,5564,5,6,11
Kiribati,2010,sp,65,4,2,6
Kiribati,2011,ep,014,16,21,37
Kiribati,2011,ep,1524,12,6,18
Kiribati,2011,ep,2534,5,1,6
Kiribati,2011,ep,3544,7,4,11
Kiribati,2011,ep,4554,3,5,8
Kiribati,2011,ep,5564,2,2,4
Kiribati,2011,ep,65,0,3,3
Kiribati,2011,sn,014,21,22,43
Kiribati,2011,sn,1524,11,15,26
Kiribati,2011,sn,2534,7,2,9
Kiribati,2011,sn,3544,4,7,11
Kiribati,2011,sn,4554,1,6,7
Kiribati,2011,sn,5564,4,3,7
Kiribati,2011,sn,65,3,3,6
Kiribati,2011,sp,014,6,4,10
Kiribati,2011,sp,1524,26,17,43
Kiribati,2011,sp,2534,12,9,21
Kiribati,2011,sp,3544,9,3,12
Kiribati,2011,sp,4554,16,10,26
Kiribati,2011,sp,5564,12,9,21
Kiribati,2011,sp,65,4,3,7
Kiribati,2012,ep,014,10,15,25
Kiribati,2012,ep,1524,9,5,14
Kiribati,2012,ep,2534,2,7,9
Kiribati,2012,ep,3544,3,3,6
Kiribati,2012,ep,4554,0,6,6
Kiribati,2012,ep,5564,2,5,7
Kiribati,2012,ep,65,4,2,6
Kiribati,2012,sn,014,18,23,41
Kiribati,2012,sn,1524,19,18,37
Kiribati,2012,sn,2534,4,9,13
Kiribati,2012,sn,3544,4,8,12
Kiribati,2012,sn,4554,1,8,9
Kiribati,2012,sn,5564,3,3,6
Kiribati,2012,sn,65,2,2,4
Kiribati,2012,sp,014,4,4,8
Kiribati,2012,sp,1524,15,19,34
Kiribati,2012,sp,2534,11,12,23
Kiribati,2012,sp,3544,10,16,26
Kiribati,2012,sp,4554,7,17,24
Kiribati,2012,sp,5564,2,11,13
Kiribati,2012,sp,65,1,5,6
Kiribati,2013,rel,014,46,49,95
Kiribati,2013,rel,1524,36,41,77
Kiribati,2013,rel,2534,32,41,73
Kiribati,2013,rel,3544,35,30,65
Kiribati,2013,rel,4554,19,27,46
Kiribati,2013,rel,5564,15,17,32
Kiribati,2013,rel,65,8,14,22
Kuwait,1995,sp,014,0,0,0
Kuwait,1995,sp,1524,8,15,23
Kuwait,1995,sp,2534,24,51,75
Kuwait,1995,sp,3544,9,32,41
Kuwait,1995,sp,4554,4,17,21
Kuwait,1995,sp,5564,4,9,13
Kuwait,1995,sp,65,2,0,2
Kuwait,1996,sp,014,1,0,1
Kuwait,1996,sp,1524,12,11,23
Kuwait,1996,sp,2534,17,45,62
Kuwait,1996,sp,3544,8,16,24
Kuwait,1996,sp,4554,3,30,33
Kuwait,1996,sp,5564,3,4,7
Kuwait,1996,sp,65,2,1,3
Kuwait,1997,sp,014,1,1,2
Kuwait,1997,sp,1524,17,23,40
Kuwait,1997,sp,2534,26,38,64
Kuwait,1997,sp,3544,11,37,48
Kuwait,1997,sp,4554,7,22,29
Kuwait,1997,sp,5564,1,6,7
Kuwait,1997,sp,65,4,7,11
Kuwait,1998,sp,014,0,0,0
Kuwait,1998,sp,1524,13,14,27
Kuwait,1998,sp,2534,14,42,56
Kuwait,1998,sp,3544,9,42,51
Kuwait,1998,sp,4554,5,20,25
Kuwait,1998,sp,5564,5,11,16
Kuwait,1998,sp,65,5,5,10
Kuwait,1999,sp,014,2,0,2
Kuwait,1999,sp,1524,9,18,27
Kuwait,1999,sp,2534,23,49,72
Kuwait,1999,sp,3544,5,26,31
Kuwait,1999,sp,4554,6,11,17
Kuwait,1999,sp,5564,4,10,14
Kuwait,1999,sp,65,2,4,6
Kuwait,2000,sp,014,1,0,1
Kuwait,2000,sp,1524,11,10,21
Kuwait,2000,sp,2534,24,44,68
Kuwait,2000,sp,3544,12,32,44
Kuwait,2000,sp,4554,5,21,26
Kuwait,2000,sp,5564,3,11,14
Kuwait,2000,sp,65,1,5,6
Kuwait,2001,sp,014,1,0,1
Kuwait,2001,sp,1524,13,13,26
Kuwait,2001,sp,2534,30,37,67
Kuwait,2001,sp,3544,14,29,43
Kuwait,2001,sp,4554,4,19,23
Kuwait,2001,sp,5564,5,1,6
Kuwait,2001,sp,65,2,6,8
Kuwait,2002,sp,014,0,0,0
Kuwait,2002,sp,1524,15,14,29
Kuwait,2002,sp,2534,37,47,84
Kuwait,2002,sp,3544,11,32,43
Kuwait,2002,sp,4554,7,26,33
Kuwait,2002,sp,5564,3,9,12
Kuwait,2002,sp,65,2,3,5
Kuwait,2003,sp,014,1,1,2
Kuwait,2003,sp,1524,16,14,30
Kuwait,2003,sp,2534,31,39,70
Kuwait,2003,sp,3544,18,33,51
Kuwait,2003,sp,4554,2,26,28
Kuwait,2003,sp,5564,3,11,14
Kuwait,2003,sp,65,1,5,6
Kuwait,2004,sp,014,0,0,0
Kuwait,2004,sp,1524,14,20,34
Kuwait,2004,sp,2534,44,63,107
Kuwait,2004,sp,3544,12,38,50
Kuwait,2004,sp,4554,7,22,29
Kuwait,2004,sp,5564,5,9,14
Kuwait,2004,sp,65,7,7,14
Kuwait,2005,sp,014,0,0,0
Kuwait,2005,sp,1524,13,12,25
Kuwait,2005,sp,2534,31,45,76
Kuwait,2005,sp,3544,11,29,40
Kuwait,2005,sp,4554,3,26,29
Kuwait,2005,sp,5564,1,8,9
Kuwait,2005,sp,65,5,3,8
Kuwait,2006,ep,014,8,3,11
Kuwait,2006,ep,1524,22,22,44
Kuwait,2006,ep,2534,44,69,113
Kuwait,2006,ep,3544,28,45,73
Kuwait,2006,ep,4554,18,13,31
Kuwait,2006,ep,5564,3,5,8
Kuwait,2006,ep,65,2,2,4
Kuwait,2006,sn,014,5,1,6
Kuwait,2006,sn,1524,7,8,15
Kuwait,2006,sn,2534,6,28,34
Kuwait,2006,sn,3544,4,6,10
Kuwait,2006,sn,4554,1,3,4
Kuwait,2006,sn,5564,0,0,0
Kuwait,2006,sn,65,0,7,7
Kuwait,2006,sp,014,0,1,1
Kuwait,2006,sp,1524,17,19,36
Kuwait,2006,sp,2534,41,72,113
Kuwait,2006,sp,3544,23,40,63
Kuwait,2006,sp,4554,5,37,42
Kuwait,2006,sp,5564,6,14,20
Kuwait,2006,sp,65,6,3,9
Kuwait,2007,ep,014,7,1,8
Kuwait,2007,ep,1524,16,24,40
Kuwait,2007,ep,2534,38,62,100
Kuwait,2007,ep,3544,39,48,87
Kuwait,2007,ep,4554,14,17,31
Kuwait,2007,ep,5564,2,6,8
Kuwait,2007,ep,65,1,2,3
Kuwait,2007,sn,014,4,2,6
Kuwait,2007,sn,1524,4,7,11
Kuwait,2007,sn,2534,12,29,41
Kuwait,2007,sn,3544,8,17,25
Kuwait,2007,sn,4554,1,4,5
Kuwait,2007,sn,5564,1,3,4
Kuwait,2007,sn,65,1,1,2
Kuwait,2007,sp,014,0,1,1
Kuwait,2007,sp,1524,26,16,42
Kuwait,2007,sp,2534,53,69,122
Kuwait,2007,sp,3544,18,25,43
Kuwait,2007,sp,4554,13,29,42
Kuwait,2007,sp,5564,7,8,15
Kuwait,2007,sp,65,4,5,9
Kuwait,2008,ep,014,4,6,10
Kuwait,2008,ep,1524,27,24,51
Kuwait,2008,ep,2534,73,75,148
Kuwait,2008,ep,3544,44,58,102
Kuwait,2008,ep,4554,12,16,28
Kuwait,2008,ep,5564,7,9,16
Kuwait,2008,ep,65,5,3,8
Kuwait,2008,sn,014,6,3,9
Kuwait,2008,sn,1524,13,4,17
Kuwait,2008,sn,2534,21,36,57
Kuwait,2008,sn,3544,9,31,40
Kuwait,2008,sn,4554,3,18,21
Kuwait,2008,sn,5564,2,6,8
Kuwait,2008,sn,65,3,3,6
Kuwait,2008,sp,014,2,0,2
Kuwait,2008,sp,1524,33,18,51
Kuwait,2008,sp,2534,47,90,137
Kuwait,2008,sp,3544,27,56,83
Kuwait,2008,sp,4554,7,34,41
Kuwait,2008,sp,5564,5,11,16
Kuwait,2008,sp,65,6,9,15
Kuwait,2009,ep,014,7,4,11
Kuwait,2009,ep,1524,39,18,57
Kuwait,2009,ep,2534,80,81,161
Kuwait,2009,ep,3544,55,33,88
Kuwait,2009,ep,4554,24,20,44
Kuwait,2009,ep,5564,12,8,20
Kuwait,2009,ep,65,7,3,10
Kuwait,2009,sn,014,5,2,7
Kuwait,2009,sn,1524,9,5,14
Kuwait,2009,sn,2534,31,41,72
Kuwait,2009,sn,3544,10,17,27
Kuwait,2009,sn,4554,5,15,20
Kuwait,2009,sn,5564,3,8,11
Kuwait,2009,sn,65,1,3,4
Kuwait,2009,sp,014,1,0,1
Kuwait,2009,sp,1524,39,26,65
Kuwait,2009,sp,2534,86,72,158
Kuwait,2009,sp,3544,18,67,85
Kuwait,2009,sp,4554,10,36,46
Kuwait,2009,sp,5564,4,12,16
Kuwait,2009,sp,65,7,8,15
Kuwait,2010,ep,014,7,4,11
Kuwait,2010,ep,1524,32,25,57
Kuwait,2010,ep,2534,92,65,157
Kuwait,2010,ep,3544,64,40,104
Kuwait,2010,ep,4554,25,21,46
Kuwait,2010,ep,5564,9,9,18
Kuwait,2010,ep,65,6,8,14
Kuwait,2010,sn,014,4,3,7
Kuwait,2010,sn,1524,11,10,21
Kuwait,2010,sn,2534,32,33,65
Kuwait,2010,sn,3544,11,26,37
Kuwait,2010,sn,4554,5,15,20
Kuwait,2010,sn,5564,1,6,7
Kuwait,2010,sn,65,1,5,6
Kuwait,2010,sp,014,4,1,5
Kuwait,2010,sp,1524,41,16,57
Kuwait,2010,sp,2534,78,67,145
Kuwait,2010,sp,3544,30,50,80
Kuwait,2010,sp,4554,10,48,58
Kuwait,2010,sp,5564,11,10,21
Kuwait,2010,sp,65,8,11,19
Kuwait,2011,sp,014,0,0,0
Kuwait,2011,sp,1524,23,13,36
Kuwait,2011,sp,2534,30,41,71
Kuwait,2011,sp,3544,15,36,51
Kuwait,2011,sp,4554,9,35,44
Kuwait,2011,sp,5564,2,11,13
Kuwait,2011,sp,65,2,5,7
Kuwait,2012,ep,014,6,11,17
Kuwait,2012,ep,1524,13,20,33
Kuwait,2012,ep,2534,69,38,107
Kuwait,2012,ep,3544,31,28,59
Kuwait,2012,ep,4554,18,18,36
Kuwait,2012,ep,5564,5,8,13
Kuwait,2012,ep,65,3,1,4
Kuwait,2012,sn,014,3,1,4
Kuwait,2012,sn,1524,8,6,14
Kuwait,2012,sn,2534,26,35,61
Kuwait,2012,sn,3544,11,18,29
Kuwait,2012,sn,4554,3,16,19
Kuwait,2012,sn,5564,3,6,9
Kuwait,2012,sn,65,0,4,4
Kuwait,2012,sp,014,3,0,3
Kuwait,2012,sp,1524,40,14,54
Kuwait,2012,sp,2534,73,59,132
Kuwait,2012,sp,3544,15,49,64
Kuwait,2012,sp,4554,12,35,47
Kuwait,2012,sp,5564,6,15,21
Kuwait,2012,sp,65,4,3,7
Kuwait,2013,rel,014,11,8,19
Kuwait,2013,rel,1524,70,32,102
Kuwait,2013,rel,2534,164,97,261
Kuwait,2013,rel,3544,65,96,161
Kuwait,2013,rel,4554,24,64,88
Kuwait,2013,rel,5564,16,30,46
Kuwait,2013,rel,65,9,18,27
Kyrgyzstan,1995,sp,014,1,3,4
Kyrgyzstan,1995,sp,1524,70,109,179
Kyrgyzstan,1995,sp,2534,94,171,265
Kyrgyzstan,1995,sp,3544,34,165,199
Kyrgyzstan,1995,sp,4554,18,65,83
Kyrgyzstan,1995,sp,5564,15,38,53
Kyrgyzstan,1995,sp,65,19,30,49
Kyrgyzstan,1996,sp,014,8,4,12
Kyrgyzstan,1996,sp,1524,90,148,238
Kyrgyzstan,1996,sp,2534,93,210,303
Kyrgyzstan,1996,sp,3544,55,156,211
Kyrgyzstan,1996,sp,4554,18,86,104
Kyrgyzstan,1996,sp,5564,26,38,64
Kyrgyzstan,1996,sp,65,31,40,71
Kyrgyzstan,1997,sp,014,4,1,5
Kyrgyzstan,1997,sp,1524,115,212,327
Kyrgyzstan,1997,sp,2534,133,381,514
Kyrgyzstan,1997,sp,3544,64,349,413
Kyrgyzstan,1997,sp,4554,22,143,165
Kyrgyzstan,1997,sp,5564,29,90,119
Kyrgyzstan,1997,sp,65,37,38,75
Kyrgyzstan,1998,sp,014,3,4,7
Kyrgyzstan,1998,sp,1524,68,105,173
Kyrgyzstan,1998,sp,2534,89,176,265
Kyrgyzstan,1998,sp,3544,54,141,195
Kyrgyzstan,1998,sp,4554,20,75,95
Kyrgyzstan,1998,sp,5564,22,43,65
Kyrgyzstan,1998,sp,65,9,21,30
Kyrgyzstan,1999,sp,014,8,5,13
Kyrgyzstan,1999,sp,1524,137,216,353
Kyrgyzstan,1999,sp,2534,199,388,587
Kyrgyzstan,1999,sp,3544,75,244,319
Kyrgyzstan,1999,sp,4554,40,142,182
Kyrgyzstan,1999,sp,5564,31,73,104
Kyrgyzstan,1999,sp,65,35,49,84
Kyrgyzstan,2000,sp,014,6,4,10
Kyrgyzstan,2000,sp,1524,128,128,256
Kyrgyzstan,2000,sp,2534,146,227,373
Kyrgyzstan,2000,sp,3544,100,205,305
Kyrgyzstan,2000,sp,4554,41,115,156
Kyrgyzstan,2000,sp,5564,30,52,82
Kyrgyzstan,2000,sp,65,29,46,75
Kyrgyzstan,2001,sp,014,0,0,0
Kyrgyzstan,2001,sp,1524,133,176,309
Kyrgyzstan,2001,sp,2534,183,287,470
Kyrgyzstan,2001,sp,3544,105,217,322
Kyrgyzstan,2001,sp,4554,45,159,204
Kyrgyzstan,2001,sp,5564,30,54,84
Kyrgyzstan,2001,sp,65,48,44,92
Kyrgyzstan,2002,sp,014,0,0,0
Kyrgyzstan,2002,sp,1524,153,202,355
Kyrgyzstan,2002,sp,2534,179,268,447
Kyrgyzstan,2002,sp,3544,116,233,349
Kyrgyzstan,2002,sp,4554,44,137,181
Kyrgyzstan,2002,sp,5564,39,61,100
Kyrgyzstan,2002,sp,65,67,45,112
Kyrgyzstan,2003,sp,014,0,0,0
Kyrgyzstan,2003,sp,1524,178,189,367
Kyrgyzstan,2003,sp,2534,227,298,525
Kyrgyzstan,2003,sp,3544,109,241,350
Kyrgyzstan,2003,sp,4554,61,145,206
Kyrgyzstan,2003,sp,5564,29,63,92
Kyrgyzstan,2003,sp,65,42,70,112
Kyrgyzstan,2004,sp,014,11,3,14
Kyrgyzstan,2004,sp,1524,196,221,417
Kyrgyzstan,2004,sp,2534,228,277,505
Kyrgyzstan,2004,sp,3544,104,265,369
Kyrgyzstan,2004,sp,4554,59,164,223
Kyrgyzstan,2004,sp,5564,34,58,92
Kyrgyzstan,2004,sp,65,72,69,141
Kyrgyzstan,2005,sp,014,15,1,16
Kyrgyzstan,2005,sp,1524,215,247,462
Kyrgyzstan,2005,sp,2534,236,303,539
Kyrgyzstan,2005,sp,3544,141,269,410
Kyrgyzstan,2005,sp,4554,70,194,264
Kyrgyzstan,2005,sp,5564,33,66,99
Kyrgyzstan,2005,sp,65,98,84,182
Kyrgyzstan,2006,sp,014,13,3,16
Kyrgyzstan,2006,sp,1524,228,245,473
Kyrgyzstan,2006,sp,2534,203,298,501
Kyrgyzstan,2006,sp,3544,107,245,352
Kyrgyzstan,2006,sp,4554,75,179,254
Kyrgyzstan,2006,sp,5564,32,75,107
Kyrgyzstan,2006,sp,65,65,75,140
Kyrgyzstan,2007,sp,014,11,3,14
Kyrgyzstan,2007,sp,1524,216,243,459
Kyrgyzstan,2007,sp,2534,213,274,487
Kyrgyzstan,2007,sp,3544,114,186,300
Kyrgyzstan,2007,sp,4554,67,186,253
Kyrgyzstan,2007,sp,5564,47,62,109
Kyrgyzstan,2007,sp,65,61,63,124
Kyrgyzstan,2008,ep,014,233,251,484
Kyrgyzstan,2008,ep,1524,177,296,473
Kyrgyzstan,2008,ep,2534,118,144,262
Kyrgyzstan,2008,ep,3544,67,76,143
Kyrgyzstan,2008,ep,4554,46,73,119
Kyrgyzstan,2008,ep,5564,22,32,54
Kyrgyzstan,2008,ep,65,38,12,50
Kyrgyzstan,2008,sn,014,78,54,132
Kyrgyzstan,2008,sn,1524,242,298,540
Kyrgyzstan,2008,sn,2534,226,239,465
Kyrgyzstan,2008,sn,3544,118,193,311
Kyrgyzstan,2008,sn,4554,98,186,284
Kyrgyzstan,2008,sn,5564,49,99,148
Kyrgyzstan,2008,sn,65,55,101,156
Kyrgyzstan,2008,sp,014,13,1,14
Kyrgyzstan,2008,sp,1524,209,261,470
Kyrgyzstan,2008,sp,2534,217,275,492
Kyrgyzstan,2008,sp,3544,104,190,294
Kyrgyzstan,2008,sp,4554,61,155,216
Kyrgyzstan,2008,sp,5564,41,70,111
Kyrgyzstan,2008,sp,65,62,53,115
Kyrgyzstan,2009,ep,014,175,222,397
Kyrgyzstan,2009,ep,1524,202,294,496
Kyrgyzstan,2009,ep,2534,117,142,259
Kyrgyzstan,2009,ep,3544,67,97,164
Kyrgyzstan,2009,ep,4554,60,64,124
Kyrgyzstan,2009,ep,5564,33,25,58
Kyrgyzstan,2009,ep,65,30,30,60
Kyrgyzstan,2009,sn,014,72,51,123
Kyrgyzstan,2009,sn,1524,319,339,658
Kyrgyzstan,2009,sn,2534,258,255,513
Kyrgyzstan,2009,sn,3544,127,210,337
Kyrgyzstan,2009,sn,4554,101,204,305
Kyrgyzstan,2009,sn,5564,56,120,176
Kyrgyzstan,2009,sn,65,56,99,155
Kyrgyzstan,2009,sp,014,14,7,21
Kyrgyzstan,2009,sp,1524,214,251,465
Kyrgyzstan,2009,sp,2534,186,252,438
Kyrgyzstan,2009,sp,3544,97,185,282
Kyrgyzstan,2009,sp,4554,60,168,228
Kyrgyzstan,2009,sp,5564,29,54,83
Kyrgyzstan,2009,sp,65,51,41,92
Kyrgyzstan,2010,ep,014,186,239,425
Kyrgyzstan,2010,ep,1524,217,261,478
Kyrgyzstan,2010,ep,2534,153,146,299
Kyrgyzstan,2010,ep,3544,107,68,175
Kyrgyzstan,2010,ep,4554,69,61,130
Kyrgyzstan,2010,ep,5564,40,31,71
Kyrgyzstan,2010,ep,65,31,26,57
Kyrgyzstan,2010,sn,014,57,39,96
Kyrgyzstan,2010,sn,1524,264,283,547
Kyrgyzstan,2010,sn,2534,232,249,481
Kyrgyzstan,2010,sn,3544,107,189,296
Kyrgyzstan,2010,sn,4554,86,199,285
Kyrgyzstan,2010,sn,5564,59,120,179
Kyrgyzstan,2010,sn,65,52,92,144
Kyrgyzstan,2010,sp,014,5,5,10
Kyrgyzstan,2010,sp,1524,223,261,484
Kyrgyzstan,2010,sp,2534,199,260,459
Kyrgyzstan,2010,sp,3544,98,188,286
Kyrgyzstan,2010,sp,4554,71,141,212
Kyrgyzstan,2010,sp,5564,40,64,104
Kyrgyzstan,2010,sp,65,42,48,90
Kyrgyzstan,2011,sp,014,13,6,19
Kyrgyzstan,2011,sp,1524,200,225,425
Kyrgyzstan,2011,sp,2534,191,204,395
Kyrgyzstan,2011,sp,3544,84,179,263
Kyrgyzstan,2011,sp,4554,60,168,228
Kyrgyzstan,2011,sp,5564,50,77,127
Kyrgyzstan,2011,sp,65,39,41,80
Kyrgyzstan,2012,ep,014,232,285,517
Kyrgyzstan,2012,ep,1524,197,321,518
Kyrgyzstan,2012,ep,2534,141,163,304
Kyrgyzstan,2012,ep,3544,94,91,185
Kyrgyzstan,2012,ep,4554,79,62,141
Kyrgyzstan,2012,ep,5564,39,42,81
Kyrgyzstan,2012,ep,65,40,23,63
Kyrgyzstan,2012,sn,014,55,56,111
Kyrgyzstan,2012,sn,1524,280,364,644
Kyrgyzstan,2012,sn,2534,259,311,570
Kyrgyzstan,2012,sn,3544,109,267,376
Kyrgyzstan,2012,sn,4554,118,220,338
Kyrgyzstan,2012,sn,5564,94,166,260
Kyrgyzstan,2012,sn,65,64,85,149
Kyrgyzstan,2012,sp,014,8,4,12
Kyrgyzstan,2012,sp,1524,195,210,405
Kyrgyzstan,2012,sp,2534,173,255,428
Kyrgyzstan,2012,sp,3544,108,207,315
Kyrgyzstan,2012,sp,4554,55,184,239
Kyrgyzstan,2012,sp,5564,42,86,128
Kyrgyzstan,2012,sp,65,37,30,67
Kyrgyzstan,2013,rel,014,293,301,594
Kyrgyzstan,2013,rel,1524,705,836,1541
Kyrgyzstan,2013,rel,2534,604,737,1341
Kyrgyzstan,2013,rel,3544,332,488,820
Kyrgyzstan,2013,rel,4554,232,470,702
Kyrgyzstan,2013,rel,5564,199,317,516
Kyrgyzstan,2013,rel,65,175,170,345
Lao People's Democratic Republic,1995,sp,014,3,6,9
Lao People's Democratic Republic,1995,sp,1524,49,56,105
Lao People's Democratic Republic,1995,sp,2534,49,71,120
Lao People's Democratic Republic,1995,sp,3544,69,68,137
Lao People's Democratic Republic,1995,sp,4554,54,78,132
Lao People's Democratic Republic,1995,sp,5564,52,90,142
Lao People's Democratic Republic,1995,sp,65,26,55,81
Lao People's Democratic Republic,1996,sp,014,4,1,5
Lao People's Democratic Republic,1996,sp,1524,31,42,73
Lao People's Democratic Republic,1996,sp,2534,62,80,142
Lao People's Democratic Republic,1996,sp,3544,80,97,177
Lao People's Democratic Republic,1996,sp,4554,64,131,195
Lao People's Democratic Republic,1996,sp,5564,59,127,186
Lao People's Democratic Republic,1996,sp,65,24,84,108
Lao People's Democratic Republic,1997,sp,014,2,2,4
Lao People's Democratic Republic,1997,sp,1524,60,61,121
Lao People's Democratic Republic,1997,sp,2534,83,91,174
Lao People's Democratic Republic,1997,sp,3544,102,151,253
Lao People's Democratic Republic,1997,sp,4554,102,158,260
Lao People's Democratic Republic,1997,sp,5564,88,156,244
Lao People's Democratic Republic,1997,sp,65,54,124,178
Lao People's Democratic Republic,1998,sp,014,6,4,10
Lao People's Democratic Republic,1998,sp,1524,59,77,136
Lao People's Democratic Republic,1998,sp,2534,121,152,273
Lao People's Democratic Republic,1998,sp,3544,122,150,272
Lao People's Democratic Republic,1998,sp,4554,108,177,285
Lao People's Democratic Republic,1998,sp,5564,90,211,301
Lao People's Democratic Republic,1998,sp,65,65,152,217
Lao People's Democratic Republic,1999,sp,014,9,5,14
Lao People's Democratic Republic,1999,sp,1524,60,91,151
Lao People's Democratic Republic,1999,sp,2534,115,175,290
Lao People's Democratic Republic,1999,sp,3544,142,183,325
Lao People's Democratic Republic,1999,sp,4554,141,213,354
Lao People's Democratic Republic,1999,sp,5564,98,193,291
Lao People's Democratic Republic,1999,sp,65,90,191,281
Lao People's Democratic Republic,2000,sp,014,10,7,17
Lao People's Democratic Republic,2000,sp,1524,59,92,151
Lao People's Democratic Republic,2000,sp,2534,95,128,223
Lao People's Democratic Republic,2000,sp,3544,131,166,297
Lao People's Democratic Republic,2000,sp,4554,122,201,323
Lao People's Democratic Republic,2000,sp,5564,91,177,268
Lao People's Democratic Republic,2000,sp,65,71,176,247
Lao People's Democratic Republic,2001,sp,014,6,10,16
Lao People's Democratic Republic,2001,sp,1524,51,81,132
Lao People's Democratic Republic,2001,sp,2534,99,137,236
Lao People's Democratic Republic,2001,sp,3544,121,176,297
Lao People's Democratic Republic,2001,sp,4554,138,219,357
Lao People's Democratic Republic,2001,sp,5564,104,186,290
Lao People's Democratic Republic,2001,sp,65,71,164,235
Lao People's Democratic Republic,2002,sp,014,2,4,6
Lao People's Democratic Republic,2002,sp,1524,72,86,158
Lao People's Democratic Republic,2002,sp,2534,141,159,300
Lao People's Democratic Republic,2002,sp,3544,151,220,371
Lao People's Democratic Republic,2002,sp,4554,152,223,375
Lao People's Democratic Republic,2002,sp,5564,117,227,344
Lao People's Democratic Republic,2002,sp,65,90,185,275
Lao People's Democratic Republic,2003,sp,014,7,6,13
Lao People's Democratic Republic,2003,sp,1524,77,91,168
Lao People's Democratic Republic,2003,sp,2534,107,180,287
Lao People's Democratic Republic,2003,sp,3544,162,239,401
Lao People's Democratic Republic,2003,sp,4554,156,226,382
Lao People's Democratic Republic,2003,sp,5564,114,207,321
Lao People's Democratic Republic,2003,sp,65,98,196,294
Lao People's Democratic Republic,2004,sp,014,12,14,26
Lao People's Democratic Republic,2004,sp,1524,72,120,192
Lao People's Democratic Republic,2004,sp,2534,137,181,318
Lao People's Democratic Republic,2004,sp,3544,157,231,388
Lao People's Democratic Republic,2004,sp,4554,172,318,490
Lao People's Democratic Republic,2004,sp,5564,164,259,423
Lao People's Democratic Republic,2004,sp,65,121,268,389
Lao People's Democratic Republic,2005,sp,014,7,13,20
Lao People's Democratic Republic,2005,sp,1524,101,136,237
Lao People's Democratic Republic,2005,sp,2534,186,223,409
Lao People's Democratic Republic,2005,sp,3544,205,296,501
Lao People's Democratic Republic,2005,sp,4554,244,373,617
Lao People's Democratic Republic,2005,sp,5564,192,300,492
Lao People's Democratic Republic,2005,sp,65,178,352,530
Lao People's Democratic Republic,2006,sp,014,13,12,25
Lao People's Democratic Republic,2006,sp,1524,109,145,254
Lao People's Democratic Republic,2006,sp,2534,196,245,441
Lao People's Democratic Republic,2006,sp,3544,221,340,561
Lao People's Democratic Republic,2006,sp,4554,228,406,634
Lao People's Democratic Republic,2006,sp,5564,222,345,567
Lao People's Democratic Republic,2006,sp,65,205,354,559
Lao People's Democratic Republic,2007,sp,014,7,11,18
Lao People's Democratic Republic,2007,sp,1524,126,150,276
Lao People's Democratic Republic,2007,sp,2534,175,258,433
Lao People's Democratic Republic,2007,sp,3544,215,307,522
Lao People's Democratic Republic,2007,sp,4554,293,418,711
Lao People's Democratic Republic,2007,sp,5564,206,361,567
Lao People's Democratic Republic,2007,sp,65,207,350,557
Lao People's Democratic Republic,2008,sp,014,10,6,16
Lao People's Democratic Republic,2008,sp,1524,101,159,260
Lao People's Democratic Republic,2008,sp,2534,165,262,427
Lao People's Democratic Republic,2008,sp,3544,209,329,538
Lao People's Democratic Republic,2008,sp,4554,264,380,644
Lao People's Democratic Republic,2008,sp,5564,220,409,629
Lao People's Democratic Republic,2008,sp,65,192,373,565
Lao People's Democratic Republic,2009,sp,014,6,11,17
Lao People's Democratic Republic,2009,sp,1524,119,159,278
Lao People's Democratic Republic,2009,sp,2534,186,235,421
Lao People's Democratic Republic,2009,sp,3544,205,325,530
Lao People's Democratic Republic,2009,sp,4554,265,382,647
Lao People's Democratic Republic,2009,sp,5564,217,366,583
Lao People's Democratic Republic,2009,sp,65,207,351,558
Lao People's Democratic Republic,2010,ep,014,7,16,23
Lao People's Democratic Republic,2010,ep,1524,13,24,37
Lao People's Democratic Republic,2010,ep,2534,19,46,65
Lao People's Democratic Republic,2010,ep,3544,30,29,59
Lao People's Democratic Republic,2010,ep,4554,20,30,50
Lao People's Democratic Republic,2010,ep,5564,12,23,35
Lao People's Democratic Republic,2010,ep,65,22,22,44
Lao People's Democratic Republic,2010,sn,014,7,9,16
Lao People's Democratic Republic,2010,sn,1524,18,20,38
Lao People's Democratic Republic,2010,sn,2534,39,34,73
Lao People's Democratic Republic,2010,sn,3544,25,43,68
Lao People's Democratic Republic,2010,sn,4554,19,34,53
Lao People's Democratic Republic,2010,sn,5564,18,49,67
Lao People's Democratic Republic,2010,sn,65,31,41,72
Lao People's Democratic Republic,2010,sp,014,13,8,21
Lao People's Democratic Republic,2010,sp,1524,133,157,290
Lao People's Democratic Republic,2010,sp,2534,152,254,406
Lao People's Democratic Republic,2010,sp,3544,215,287,502
Lao People's Democratic Republic,2010,sp,4554,269,416,685
Lao People's Democratic Republic,2010,sp,5564,225,385,610
Lao People's Democratic Republic,2010,sp,65,225,380,605
Lao People's Democratic Republic,2011,ep,014,7,14,21
Lao People's Democratic Republic,2011,ep,1524,19,28,47
Lao People's Democratic Republic,2011,ep,2534,39,42,81
Lao People's Democratic Republic,2011,ep,3544,24,32,56
Lao People's Democratic Republic,2011,ep,4554,25,34,59
Lao People's Democratic Republic,2011,ep,5564,10,32,42
Lao People's Democratic Republic,2011,ep,65,19,24,43
Lao People's Democratic Republic,2011,sn,014,4,5,9
Lao People's Democratic Republic,2011,sn,1524,23,20,43
Lao People's Democratic Republic,2011,sn,2534,45,47,92
Lao People's Democratic Republic,2011,sn,3544,33,46,79
Lao People's Democratic Republic,2011,sn,4554,33,59,92
Lao People's Democratic Republic,2011,sn,5564,27,61,88
Lao People's Democratic Republic,2011,sn,65,45,68,113
Lao People's Democratic Republic,2011,sp,014,14,8,22
Lao People's Democratic Republic,2011,sp,1524,141,145,286
Lao People's Democratic Republic,2011,sp,2534,204,275,479
Lao People's Democratic Republic,2011,sp,3544,208,323,531
Lao People's Democratic Republic,2011,sp,4554,267,474,741
Lao People's Democratic Republic,2011,sp,5564,215,416,631
Lao People's Democratic Republic,2011,sp,65,206,375,581
Lao People's Democratic Republic,2012,ep,014,12,13,25
Lao People's Democratic Republic,2012,ep,1524,25,26,51
Lao People's Democratic Republic,2012,ep,2534,39,45,84
Lao People's Democratic Republic,2012,ep,3544,30,32,62
Lao People's Democratic Republic,2012,ep,4554,19,27,46
Lao People's Democratic Republic,2012,ep,5564,15,23,38
Lao People's Democratic Republic,2012,ep,65,19,26,45
Lao People's Democratic Republic,2012,sn,014,14,7,21
Lao People's Democratic Republic,2012,sn,1524,14,14,28
Lao People's Democratic Republic,2012,sn,2534,47,59,106
Lao People's Democratic Republic,2012,sn,3544,24,49,73
Lao People's Democratic Republic,2012,sn,4554,27,43,70
Lao People's Democratic Republic,2012,sn,5564,29,48,77
Lao People's Democratic Republic,2012,sn,65,27,70,97
Lao People's Democratic Republic,2012,sp,014,11,10,21
Lao People's Democratic Republic,2012,sp,1524,119,144,263
Lao People's Democratic Republic,2012,sp,2534,197,236,433
Lao People's Democratic Republic,2012,sp,3544,192,326,518
Lao People's Democratic Republic,2012,sp,4554,246,424,670
Lao People's Democratic Republic,2012,sp,5564,210,381,591
Lao People's Democratic Republic,2012,sp,65,201,365,566
Lao People's Democratic Republic,2013,rel,014,37,35,72
Lao People's Democratic Republic,2013,rel,1524,152,189,341
Lao People's Democratic Republic,2013,rel,2534,243,358,601
Lao People's Democratic Republic,2013,rel,3544,246,360,606
Lao People's Democratic Republic,2013,rel,4554,307,534,841
Lao People's Democratic Republic,2013,rel,5564,258,523,781
Lao People's Democratic Republic,2013,rel,65,239,456,695
Latvia,1995,sp,014,0,0,0
Latvia,1995,sp,1524,22,20,42
Latvia,1995,sp,2534,49,44,93
Latvia,1995,sp,3544,55,71,126
Latvia,1995,sp,4554,47,70,117
Latvia,1995,sp,5564,27,40,67
Latvia,1995,sp,65,29,30,59
Latvia,1996,sp,014,0,0,0
Latvia,1996,sp,1524,32,28,60
Latvia,1996,sp,2534,39,69,108
Latvia,1996,sp,3544,31,130,161
Latvia,1996,sp,4554,22,89,111
Latvia,1996,sp,5564,10,67,77
Latvia,1996,sp,65,16,42,58
Latvia,1997,sp,014,1,0,1
Latvia,1997,sp,1524,27,47,74
Latvia,1997,sp,2534,22,109,131
Latvia,1997,sp,3544,37,145,182
Latvia,1997,sp,4554,20,106,126
Latvia,1997,sp,5564,16,61,77
Latvia,1997,sp,65,14,29,43
Latvia,1998,sp,014,1,0,1
Latvia,1998,sp,1524,24,58,82
Latvia,1998,sp,2534,45,105,150
Latvia,1998,sp,3544,26,129,155
Latvia,1998,sp,4554,23,121,144
Latvia,1998,sp,5564,15,68,83
Latvia,1998,sp,65,18,35,53
Latvia,1999,sp,014,2,1,3
Latvia,1999,sp,1524,28,48,76
Latvia,1999,sp,2534,24,87,111
Latvia,1999,sp,3544,40,110,150
Latvia,1999,sp,4554,29,103,132
Latvia,1999,sp,5564,11,57,68
Latvia,1999,sp,65,18,30,48
Latvia,2000,sp,014,2,0,2
Latvia,2000,sp,1524,25,53,78
Latvia,2000,sp,2534,41,106,147
Latvia,2000,sp,3544,27,124,151
Latvia,2000,sp,4554,28,111,139
Latvia,2000,sp,5564,7,64,71
Latvia,2000,sp,65,15,34,49
Latvia,2001,sp,014,2,0,2
Latvia,2001,sp,1524,24,48,72
Latvia,2001,sp,2534,33,109,142
Latvia,2001,sp,3544,41,138,179
Latvia,2001,sp,4554,31,101,132
Latvia,2001,sp,5564,18,64,82
Latvia,2001,sp,65,20,32,52
Latvia,2002,sp,014,0,0,0
Latvia,2002,sp,1524,37,32,69
Latvia,2002,sp,2534,42,98,140
Latvia,2002,sp,3544,37,123,160
Latvia,2002,sp,4554,23,121,144
Latvia,2002,sp,5564,11,64,75
Latvia,2002,sp,65,22,26,48
Latvia,2003,sp,014,0,0,0
Latvia,2003,sp,1524,31,36,67
Latvia,2003,sp,2534,42,74,116
Latvia,2003,sp,3544,42,141,183
Latvia,2003,sp,4554,35,106,141
Latvia,2003,sp,5564,17,59,76
Latvia,2003,sp,65,26,32,58
Latvia,2004,sp,014,2,0,2
Latvia,2004,sp,1524,29,30,59
Latvia,2004,sp,2534,32,74,106
Latvia,2004,sp,3544,36,119,155
Latvia,2004,sp,4554,29,109,138
Latvia,2004,sp,5564,12,53,65
Latvia,2004,sp,65,19,38,57
Latvia,2005,sp,014,0,1,1
Latvia,2005,sp,1524,17,22,39
Latvia,2005,sp,2534,31,71,102
Latvia,2005,sp,3544,31,104,135
Latvia,2005,sp,4554,23,117,140
Latvia,2005,sp,5564,18,55,73
Latvia,2005,sp,65,12,34,46
Latvia,2006,ep,014,40,26,66
Latvia,2006,ep,1524,7,6,13
Latvia,2006,ep,2534,5,7,12
Latvia,2006,ep,3544,2,7,9
Latvia,2006,ep,4554,3,4,7
Latvia,2006,ep,5564,2,5,7
Latvia,2006,ep,65,6,4,10
Latvia,2006,sn,014,7,9,16
Latvia,2006,sn,1524,17,23,40
Latvia,2006,sn,2534,42,72,114
Latvia,2006,sn,3544,49,81,130
Latvia,2006,sn,4554,33,74,107
Latvia,2006,sn,5564,8,52,60
Latvia,2006,sn,65,24,31,55
Latvia,2006,sp,014,0,2,2
Latvia,2006,sp,1524,17,27,44
Latvia,2006,sp,2534,27,78,105
Latvia,2006,sp,3544,33,82,115
Latvia,2006,sp,4554,28,105,133
Latvia,2006,sp,5564,9,51,60
Latvia,2006,sp,65,13,26,39
Latvia,2007,ep,014,54,50,104
Latvia,2007,ep,1524,10,14,24
Latvia,2007,ep,2534,12,24,36
Latvia,2007,ep,3544,10,12,22
Latvia,2007,ep,4554,16,18,34
Latvia,2007,ep,5564,10,12,22
Latvia,2007,ep,65,18,14,32
Latvia,2007,sn,014,4,0,4
Latvia,2007,sn,1524,25,29,54
Latvia,2007,sn,2534,38,70,108
Latvia,2007,sn,3544,35,62,97
Latvia,2007,sn,4554,29,67,96
Latvia,2007,sn,5564,16,38,54
Latvia,2007,sn,65,21,30,51
Latvia,2007,sp,014,1,NA,NA
Latvia,2007,sp,1524,18,33,51
Latvia,2007,sp,2534,27,65,92
Latvia,2007,sp,3544,32,93,125
Latvia,2007,sp,4554,18,102,120
Latvia,2007,sp,5564,12,49,61
Latvia,2007,sp,65,9,19,28
Latvia,2008,ep,014,13,22,35
Latvia,2008,ep,1524,3,7,10
Latvia,2008,ep,2534,9,12,21
Latvia,2008,ep,3544,6,8,14
Latvia,2008,ep,4554,5,2,7
Latvia,2008,ep,5564,6,3,9
Latvia,2008,ep,65,16,6,22
Latvia,2008,sn,014,6,7,13
Latvia,2008,sn,1524,15,30,45
Latvia,2008,sn,2534,30,49,79
Latvia,2008,sn,3544,29,67,96
Latvia,2008,sn,4554,15,64,79
Latvia,2008,sn,5564,10,35,45
Latvia,2008,sn,65,9,34,43
Latvia,2008,sp,014,0,0,0
Latvia,2008,sp,1524,11,28,39
Latvia,2008,sp,2534,23,54,77
Latvia,2008,sp,3544,26,71,97
Latvia,2008,sp,4554,21,71,92
Latvia,2008,sp,5564,9,47,56
Latvia,2008,sp,65,12,27,39
Latvia,2009,ep,014,13,13,26
Latvia,2009,ep,1524,6,10,16
Latvia,2009,ep,2534,4,2,6
Latvia,2009,ep,3544,1,6,7
Latvia,2009,ep,4554,3,6,9
Latvia,2009,ep,5564,2,4,6
Latvia,2009,ep,65,12,4,16
Latvia,2009,sn,014,11,3,14
Latvia,2009,sn,1524,27,23,50
Latvia,2009,sn,2534,36,47,83
Latvia,2009,sn,3544,24,48,72
Latvia,2009,sn,4554,15,53,68
Latvia,2009,sn,5564,14,36,50
Latvia,2009,sn,65,11,29,40
Latvia,2009,sp,014,0,0,0
Latvia,2009,sp,1524,12,21,33
Latvia,2009,sp,2534,17,41,58
Latvia,2009,sp,3544,20,67,87
Latvia,2009,sp,4554,20,78,98
Latvia,2009,sp,5564,9,48,57
Latvia,2009,sp,65,14,20,34
Latvia,2010,ep,014,18,16,34
Latvia,2010,ep,1524,2,4,6
Latvia,2010,ep,2534,6,8,14
Latvia,2010,ep,3544,5,4,9
Latvia,2010,ep,4554,1,5,6
Latvia,2010,ep,5564,3,1,4
Latvia,2010,ep,65,9,4,13
Latvia,2010,sn,014,8,3,11
Latvia,2010,sn,1524,29,29,58
Latvia,2010,sn,2534,36,52,88
Latvia,2010,sn,3544,35,62,97
Latvia,2010,sn,4554,14,56,70
Latvia,2010,sn,5564,18,30,48
Latvia,2010,sn,65,13,15,28
Latvia,2010,sp,014,0,0,0
Latvia,2010,sp,1524,6,20,26
Latvia,2010,sp,2534,19,44,63
Latvia,2010,sp,3544,25,65,90
Latvia,2010,sp,4554,12,71,83
Latvia,2010,sp,5564,10,39,49
Latvia,2010,sp,65,13,15,28
Latvia,2011,ep,014,14,22,36
Latvia,2011,ep,1524,2,7,9
Latvia,2011,ep,2534,4,4,8
Latvia,2011,ep,3544,3,5,8
Latvia,2011,ep,4554,2,6,8
Latvia,2011,ep,5564,6,3,9
Latvia,2011,ep,65,4,3,7
Latvia,2011,sn,014,10,15,25
Latvia,2011,sn,1524,31,20,51
Latvia,2011,sn,2534,32,56,88
Latvia,2011,sn,3544,30,62,92
Latvia,2011,sn,4554,20,56,76
Latvia,2011,sn,5564,16,34,50
Latvia,2011,sn,65,14,14,28
Latvia,2011,sp,014,0,0,0
Latvia,2011,sp,1524,7,11,18
Latvia,2011,sp,2534,16,42,58
Latvia,2011,sp,3544,19,58,77
Latvia,2011,sp,4554,14,50,64
Latvia,2011,sp,5564,12,33,45
Latvia,2011,sp,65,13,18,31
Latvia,2012,ep,014,15,15,30
Latvia,2012,ep,1524,5,11,16
Latvia,2012,ep,2534,3,8,11
Latvia,2012,ep,3544,2,8,10
Latvia,2012,ep,4554,9,5,14
Latvia,2012,ep,5564,1,1,2
Latvia,2012,ep,65,8,9,17
Latvia,2012,sn,014,14,11,25
Latvia,2012,sn,1524,25,35,60
Latvia,2012,sn,2534,35,54,89
Latvia,2012,sn,3544,26,68,94
Latvia,2012,sn,4554,28,60,88
Latvia,2012,sn,5564,14,34,48
Latvia,2012,sn,65,15,19,34
Latvia,2012,sp,014,1,0,1
Latvia,2012,sp,1524,14,19,33
Latvia,2012,sp,2534,15,62,77
Latvia,2012,sp,3544,14,67,81
Latvia,2012,sp,4554,16,59,75
Latvia,2012,sp,5564,15,36,51
Latvia,2012,sp,65,9,15,24
Latvia,2013,rel,014,29,16,45
Latvia,2013,rel,1524,34,38,72
Latvia,2013,rel,2534,58,94,152
Latvia,2013,rel,3544,53,143,196
Latvia,2013,rel,4554,43,134,177
Latvia,2013,rel,5564,40,99,139
Latvia,2013,rel,65,37,54,91
Lebanon,1995,sp,014,1,3,4
Lebanon,1995,sp,1524,16,26,42
Lebanon,1995,sp,2534,18,32,50
Lebanon,1995,sp,3544,13,30,43
Lebanon,1995,sp,4554,8,16,24
Lebanon,1995,sp,5564,5,16,21
Lebanon,1995,sp,65,3,10,13
Lebanon,1996,sp,014,4,4,8
Lebanon,1996,sp,1524,24,28,52
Lebanon,1996,sp,2534,13,41,54
Lebanon,1996,sp,3544,11,18,29
Lebanon,1996,sp,4554,5,12,17
Lebanon,1996,sp,5564,6,9,15
Lebanon,1996,sp,65,4,19,23
Lebanon,1997,sp,014,3,1,4
Lebanon,1997,sp,1524,30,18,48
Lebanon,1997,sp,2534,20,33,53
Lebanon,1997,sp,3544,6,22,28
Lebanon,1997,sp,4554,7,19,26
Lebanon,1997,sp,5564,8,17,25
Lebanon,1997,sp,65,3,17,20
Lebanon,1998,sp,014,3,1,4
Lebanon,1998,sp,1524,23,27,50
Lebanon,1998,sp,2534,20,33,53
Lebanon,1998,sp,3544,6,22,28
Lebanon,1998,sp,4554,7,19,26
Lebanon,1998,sp,5564,8,17,25
Lebanon,1998,sp,65,3,17,20
Lebanon,1999,sp,014,1,3,4
Lebanon,1999,sp,1524,33,27,60
Lebanon,1999,sp,2534,26,44,70
Lebanon,1999,sp,3544,17,35,52
Lebanon,1999,sp,4554,6,17,23
Lebanon,1999,sp,5564,9,17,26
Lebanon,1999,sp,65,3,11,14
Lebanon,2000,sp,014,4,5,9
Lebanon,2000,sp,1524,31,16,47
Lebanon,2000,sp,2534,26,28,54
Lebanon,2000,sp,3544,9,20,29
Lebanon,2000,sp,4554,7,15,22
Lebanon,2000,sp,5564,4,17,21
Lebanon,2000,sp,65,6,14,20
Lebanon,2001,sp,014,3,0,3
Lebanon,2001,sp,1524,25,22,47
Lebanon,2001,sp,2534,28,20,48
Lebanon,2001,sp,3544,7,18,25
Lebanon,2001,sp,4554,6,16,22
Lebanon,2001,sp,5564,4,8,12
Lebanon,2001,sp,65,5,8,13
Lebanon,2002,sp,014,2,1,3
Lebanon,2002,sp,1524,17,19,36
Lebanon,2002,sp,2534,21,25,46
Lebanon,2002,sp,3544,8,14,22
Lebanon,2002,sp,4554,9,10,19
Lebanon,2002,sp,5564,3,7,10
Lebanon,2002,sp,65,3,9,12
Lebanon,2003,sp,014,3,0,3
Lebanon,2003,sp,1524,14,19,33
Lebanon,2003,sp,2534,12,26,38
Lebanon,2003,sp,3544,9,22,31
Lebanon,2003,sp,4554,5,6,11
Lebanon,2003,sp,5564,2,5,7
Lebanon,2003,sp,65,4,7,11
Lebanon,2004,sp,014,0,1,1
Lebanon,2004,sp,1524,18,11,29
Lebanon,2004,sp,2534,21,25,46
Lebanon,2004,sp,3544,10,18,28
Lebanon,2004,sp,4554,5,18,23
Lebanon,2004,sp,5564,1,8,9
Lebanon,2004,sp,65,4,6,10
Lebanon,2005,sp,014,1,0,1
Lebanon,2005,sp,1524,25,12,37
Lebanon,2005,sp,2534,14,19,33
Lebanon,2005,sp,3544,8,15,23
Lebanon,2005,sp,4554,3,10,13
Lebanon,2005,sp,5564,3,12,15
Lebanon,2005,sp,65,1,8,9
Lebanon,2006,ep,014,7,14,21
Lebanon,2006,ep,1524,19,11,30
Lebanon,2006,ep,2534,32,13,45
Lebanon,2006,ep,3544,15,14,29
Lebanon,2006,ep,4554,6,3,9
Lebanon,2006,ep,5564,8,9,17
Lebanon,2006,ep,65,26,5,31
Lebanon,2006,sn,014,11,5,16
Lebanon,2006,sn,1524,11,10,21
Lebanon,2006,sn,2534,6,4,10
Lebanon,2006,sn,3544,7,8,15
Lebanon,2006,sn,4554,4,6,10
Lebanon,2006,sn,5564,3,4,7
Lebanon,2006,sn,65,3,8,11
Lebanon,2006,sp,014,1,0,1
Lebanon,2006,sp,1524,16,11,27
Lebanon,2006,sp,2534,12,12,24
Lebanon,2006,sp,3544,5,18,23
Lebanon,2006,sp,4554,2,14,16
Lebanon,2006,sp,5564,2,10,12
Lebanon,2006,sp,65,1,8,9
Lebanon,2007,ep,014,5,17,22
Lebanon,2007,ep,1524,34,25,59
Lebanon,2007,ep,2534,43,18,61
Lebanon,2007,ep,3544,14,8,22
Lebanon,2007,ep,4554,9,11,20
Lebanon,2007,ep,5564,10,5,15
Lebanon,2007,ep,65,6,7,13
Lebanon,2007,sn,014,13,4,17
Lebanon,2007,sn,1524,17,12,29
Lebanon,2007,sn,2534,15,17,32
Lebanon,2007,sn,3544,8,10,18
Lebanon,2007,sn,4554,5,3,8
Lebanon,2007,sn,5564,4,3,7
Lebanon,2007,sn,65,1,6,7
Lebanon,2007,sp,014,1,0,1
Lebanon,2007,sp,1524,17,12,29
Lebanon,2007,sp,2534,30,19,49
Lebanon,2007,sp,3544,13,13,26
Lebanon,2007,sp,4554,5,12,17
Lebanon,2007,sp,5564,3,11,14
Lebanon,2007,sp,65,2,5,7
Lebanon,2008,ep,014,20,11,31
Lebanon,2008,ep,1524,38,21,59
Lebanon,2008,ep,2534,39,19,58
Lebanon,2008,ep,3544,24,15,39
Lebanon,2008,ep,4554,5,4,9
Lebanon,2008,ep,5564,2,5,7
Lebanon,2008,ep,65,10,18,28
Lebanon,2008,sn,014,8,8,16
Lebanon,2008,sn,1524,25,4,29
Lebanon,2008,sn,2534,17,14,31
Lebanon,2008,sn,3544,6,7,13
Lebanon,2008,sn,4554,3,10,13
Lebanon,2008,sn,5564,0,14,14
Lebanon,2008,sn,65,4,3,7
Lebanon,2008,sp,014,2,1,3
Lebanon,2008,sp,1524,24,9,33
Lebanon,2008,sp,2534,32,14,46
Lebanon,2008,sp,3544,15,12,27
Lebanon,2008,sp,4554,7,17,24
Lebanon,2008,sp,5564,3,14,17
Lebanon,2008,sp,65,2,6,8
Lebanon,2009,ep,014,23,4,27
Lebanon,2009,ep,1524,36,17,53
Lebanon,2009,ep,2534,33,14,47
Lebanon,2009,ep,3544,17,13,30
Lebanon,2009,ep,4554,9,10,19
Lebanon,2009,ep,5564,6,9,15
Lebanon,2009,ep,65,12,15,27
Lebanon,2009,sn,014,2,6,8
Lebanon,2009,sn,1524,13,4,17
Lebanon,2009,sn,2534,21,6,27
Lebanon,2009,sn,3544,10,8,18
Lebanon,2009,sn,4554,5,7,12
Lebanon,2009,sn,5564,2,6,8
Lebanon,2009,sn,65,0,4,4
Lebanon,2009,sp,014,2,1,3
Lebanon,2009,sp,1524,28,12,40
Lebanon,2009,sp,2534,40,22,62
Lebanon,2009,sp,3544,14,13,27
Lebanon,2009,sp,4554,2,9,11
Lebanon,2009,sp,5564,8,12,20
Lebanon,2009,sp,65,9,7,16
Lebanon,2010,ep,014,14,14,28
Lebanon,2010,ep,1524,29,14,43
Lebanon,2010,ep,2534,32,18,50
Lebanon,2010,ep,3544,18,6,24
Lebanon,2010,ep,4554,12,8,20
Lebanon,2010,ep,5564,11,6,17
Lebanon,2010,ep,65,16,12,28
Lebanon,2010,sn,014,5,9,14
Lebanon,2010,sn,1524,14,5,19
Lebanon,2010,sn,2534,18,9,27
Lebanon,2010,sn,3544,7,7,14
Lebanon,2010,sn,4554,5,7,12
Lebanon,2010,sn,5564,4,4,8
Lebanon,2010,sn,65,2,3,5
Lebanon,2010,sp,014,0,1,1
Lebanon,2010,sp,1524,36,8,44
Lebanon,2010,sp,2534,48,21,69
Lebanon,2010,sp,3544,17,15,32
Lebanon,2010,sp,4554,7,12,19
Lebanon,2010,sp,5564,4,12,16
Lebanon,2010,sp,65,3,10,13
Lebanon,2011,ep,014,11,9,20
Lebanon,2011,ep,1524,44,11,55
Lebanon,2011,ep,2534,50,15,65
Lebanon,2011,ep,3544,15,7,22
Lebanon,2011,ep,4554,12,9,21
Lebanon,2011,ep,5564,6,9,15
Lebanon,2011,ep,65,6,5,11
Lebanon,2011,sn,014,2,3,5
Lebanon,2011,sn,1524,13,7,20
Lebanon,2011,sn,2534,27,11,38
Lebanon,2011,sn,3544,4,10,14
Lebanon,2011,sn,4554,5,10,15
Lebanon,2011,sn,5564,3,2,5
Lebanon,2011,sn,65,1,3,4
Lebanon,2011,sp,014,0,1,1
Lebanon,2011,sp,1524,37,14,51
Lebanon,2011,sp,2534,51,18,69
Lebanon,2011,sp,3544,12,13,25
Lebanon,2011,sp,4554,9,15,24
Lebanon,2011,sp,5564,1,6,7
Lebanon,2011,sp,65,3,8,11
Lebanon,2012,ep,014,18,9,27
Lebanon,2012,ep,1524,41,16,57
Lebanon,2012,ep,2534,61,21,82
Lebanon,2012,ep,3544,19,6,25
Lebanon,2012,ep,4554,18,12,30
Lebanon,2012,ep,5564,7,7,14
Lebanon,2012,ep,65,7,8,15
Lebanon,2012,sn,014,6,8,14
Lebanon,2012,sn,1524,22,7,29
Lebanon,2012,sn,2534,33,8,41
Lebanon,2012,sn,3544,8,8,16
Lebanon,2012,sn,4554,8,6,14
Lebanon,2012,sn,5564,4,3,7
Lebanon,2012,sn,65,5,5,10
Lebanon,2012,sp,014,2,2,4
Lebanon,2012,sp,1524,48,18,66
Lebanon,2012,sp,2534,72,21,93
Lebanon,2012,sp,3544,16,13,29
Lebanon,2012,sp,4554,9,14,23
Lebanon,2012,sp,5564,4,12,16
Lebanon,2012,sp,65,3,6,9
Lebanon,2013,rel,014,21,31,52
Lebanon,2013,rel,1524,108,46,154
Lebanon,2013,rel,2534,158,71,229
Lebanon,2013,rel,3544,44,50,94
Lebanon,2013,rel,4554,39,32,71
Lebanon,2013,rel,5564,13,27,40
Lebanon,2013,rel,65,16,25,41
Lesotho,1995,sp,014,14,9,23
Lesotho,1995,sp,1524,106,108,214
Lesotho,1995,sp,2534,125,214,339
Lesotho,1995,sp,3544,71,256,327
Lesotho,1995,sp,4554,49,189,238
Lesotho,1995,sp,5564,17,96,113
Lesotho,1995,sp,65,19,88,107
Lesotho,1996,sp,014,7,12,19
Lesotho,1996,sp,1524,164,123,287
Lesotho,1996,sp,2534,189,272,461
Lesotho,1996,sp,3544,94,367,461
Lesotho,1996,sp,4554,44,223,267
Lesotho,1996,sp,5564,29,149,178
Lesotho,1996,sp,65,28,87,115
Lesotho,1997,sp,014,29,11,40
Lesotho,1997,sp,1524,216,180,396
Lesotho,1997,sp,2534,272,392,664
Lesotho,1997,sp,3544,152,463,615
Lesotho,1997,sp,4554,71,307,378
Lesotho,1997,sp,5564,40,173,213
Lesotho,1997,sp,65,23,69,92
Lesotho,1998,sp,014,10,6,16
Lesotho,1998,sp,1524,200,190,390
Lesotho,1998,sp,2534,283,407,690
Lesotho,1998,sp,3544,125,488,613
Lesotho,1998,sp,4554,65,372,437
Lesotho,1998,sp,5564,30,190,220
Lesotho,1998,sp,65,23,87,110
Lesotho,2000,sp,014,11,8,19
Lesotho,2000,sp,1524,222,165,387
Lesotho,2000,sp,2534,336,458,794
Lesotho,2000,sp,3544,195,517,712
Lesotho,2000,sp,4554,83,395,478
Lesotho,2000,sp,5564,36,198,234
Lesotho,2000,sp,65,29,76,105
Lesotho,2002,sp,014,14,10,24
Lesotho,2002,sp,1524,304,218,522
Lesotho,2002,sp,2534,447,547,994
Lesotho,2002,sp,3544,207,535,742
Lesotho,2002,sp,4554,125,347,472
Lesotho,2002,sp,5564,41,211,252
Lesotho,2002,sp,65,17,80,97
Lesotho,2003,sp,014,32,10,42
Lesotho,2003,sp,1524,328,219,547
Lesotho,2003,sp,2534,567,614,1181
Lesotho,2003,sp,3544,313,592,905
Lesotho,2003,sp,4554,219,466,685
Lesotho,2003,sp,5564,59,219,278
Lesotho,2003,sp,65,33,83,116
Lesotho,2004,sp,014,22,29,51
Lesotho,2004,sp,1524,459,286,745
Lesotho,2004,sp,2534,691,728,1419
Lesotho,2004,sp,3544,364,696,1060
Lesotho,2004,sp,4554,161,448,609
Lesotho,2004,sp,5564,68,206,274
Lesotho,2004,sp,65,36,78,114
Lesotho,2005,sp,014,19,32,51
Lesotho,2005,sp,1524,226,395,621
Lesotho,2005,sp,2534,721,695,1416
Lesotho,2005,sp,3544,616,397,1013
Lesotho,2005,sp,4554,494,148,642
Lesotho,2005,sp,5564,297,82,379
Lesotho,2005,sp,65,121,37,158
Lesotho,2006,sp,014,50,33,83
Lesotho,2006,sp,1524,370,228,598
Lesotho,2006,sp,2534,642,628,1270
Lesotho,2006,sp,3544,430,550,980
Lesotho,2006,sp,4554,171,440,611
Lesotho,2006,sp,5564,90,218,308
Lesotho,2006,sp,65,125,49,174
Lesotho,2007,sp,014,4,6,10
Lesotho,2007,sp,1524,78,32,110
Lesotho,2007,sp,2534,121,135,256
Lesotho,2007,sp,3544,106,73,179
Lesotho,2007,sp,4554,40,87,127
Lesotho,2007,sp,5564,13,52,65
Lesotho,2007,sp,65,13,28,41
Lesotho,2008,sp,014,24,21,45
Lesotho,2008,sp,1524,343,223,566
Lesotho,2008,sp,2534,700,615,1315
Lesotho,2008,sp,3544,358,542,900
Lesotho,2008,sp,4554,146,380,526
Lesotho,2008,sp,5564,76,242,318
Lesotho,2008,sp,65,54,138,192
Lesotho,2009,ep,014,50,65,115
Lesotho,2009,ep,1524,169,116,285
Lesotho,2009,ep,2534,370,349,719
Lesotho,2009,ep,3544,287,298,585
Lesotho,2009,ep,4554,164,223,387
Lesotho,2009,ep,5564,92,150,242
Lesotho,2009,ep,65,51,102,153
Lesotho,2009,sn,014,226,264,490
Lesotho,2009,sn,1524,293,245,538
Lesotho,2009,sn,2534,668,674,1342
Lesotho,2009,sn,3544,494,634,1128
Lesotho,2009,sn,4554,294,421,715
Lesotho,2009,sn,5564,183,348,531
Lesotho,2009,sn,65,126,213,339
Lesotho,2009,sp,014,30,26,56
Lesotho,2009,sp,1524,326,217,543
Lesotho,2009,sp,2534,659,685,1344
Lesotho,2009,sp,3544,409,549,958
Lesotho,2009,sp,4554,167,411,578
Lesotho,2009,sp,5564,79,257,336
Lesotho,2009,sp,65,43,118,161
Lesotho,2010,ep,014,43,52,95
Lesotho,2010,ep,1524,148,106,254
Lesotho,2010,ep,2534,344,337,681
Lesotho,2010,ep,3544,213,255,468
Lesotho,2010,ep,4554,152,206,358
Lesotho,2010,ep,5564,50,154,204
Lesotho,2010,ep,65,48,114,162
Lesotho,2010,sn,014,264,305,569
Lesotho,2010,sn,1524,289,217,506
Lesotho,2010,sn,2534,703,699,1402
Lesotho,2010,sn,3544,495,670,1165
Lesotho,2010,sn,4554,313,467,780
Lesotho,2010,sn,5564,163,340,503
Lesotho,2010,sn,65,127,279,406
Lesotho,2010,sp,014,27,16,43
Lesotho,2010,sp,1524,283,222,505
Lesotho,2010,sp,2534,597,607,1204
Lesotho,2010,sp,3544,329,497,826
Lesotho,2010,sp,4554,169,364,533
Lesotho,2010,sp,5564,64,244,308
Lesotho,2010,sp,65,48,133,181
Lesotho,2011,ep,014,51,50,101
Lesotho,2011,ep,1524,138,90,228
Lesotho,2011,ep,2534,310,257,567
Lesotho,2011,ep,3544,253,262,515
Lesotho,2011,ep,4554,143,186,329
Lesotho,2011,ep,5564,82,132,214
Lesotho,2011,ep,65,38,97,135
Lesotho,2011,sn,014,226,271,497
Lesotho,2011,sn,1524,292,195,487
Lesotho,2011,sn,2534,709,685,1394
Lesotho,2011,sn,3544,500,691,1191
Lesotho,2011,sn,4554,357,508,865
Lesotho,2011,sn,5564,205,357,562
Lesotho,2011,sn,65,117,233,350
Lesotho,2011,sp,014,23,19,42
Lesotho,2011,sp,1524,311,179,490
Lesotho,2011,sp,2534,572,584,1156
Lesotho,2011,sp,3544,307,493,800
Lesotho,2011,sp,4554,185,329,514
Lesotho,2011,sp,5564,84,245,329
Lesotho,2011,sp,65,58,121,179
Lesotho,2012,ep,014,31,41,72
Lesotho,2012,ep,1524,155,95,250
Lesotho,2012,ep,2534,300,272,572
Lesotho,2012,ep,3544,210,236,446
Lesotho,2012,ep,4554,106,129,235
Lesotho,2012,ep,5564,65,110,175
Lesotho,2012,ep,65,43,84,127
Lesotho,2012,sn,014,246,220,466
Lesotho,2012,sn,1524,333,229,562
Lesotho,2012,sn,2534,787,810,1597
Lesotho,2012,sn,3544,510,672,1182
Lesotho,2012,sn,4554,304,340,644
Lesotho,2012,sn,5564,147,249,396
Lesotho,2012,sn,65,105,190,295
Lesotho,2012,sp,014,30,15,45
Lesotho,2012,sp,1524,309,204,513
Lesotho,2012,sp,2534,571,580,1151
Lesotho,2012,sp,3544,296,427,723
Lesotho,2012,sp,4554,143,295,438
Lesotho,2012,sp,5564,71,196,267
Lesotho,2012,sp,65,47,114,161
Lesotho,2013,rel,014,229,244,473
Lesotho,2013,rel,1524,614,452,1066
Lesotho,2013,rel,2534,1293,1322,2615
Lesotho,2013,rel,3544,821,1172,1993
Lesotho,2013,rel,4554,486,780,1266
Lesotho,2013,rel,5564,249,593,842
Lesotho,2013,rel,65,225,436,661
Liberia,1996,sp,014,44,38,82
Liberia,1996,sp,1524,72,69,141
Liberia,1996,sp,2534,78,105,183
Liberia,1996,sp,3544,51,84,135
Liberia,1996,sp,4554,24,42,66
Liberia,1996,sp,5564,12,33,45
Liberia,1996,sp,65,7,9,16
Liberia,1998,sp,014,18,18,36
Liberia,1998,sp,1524,164,150,314
Liberia,1998,sp,2534,160,229,389
Liberia,1998,sp,3544,98,158,256
Liberia,1998,sp,4554,45,72,117
Liberia,1998,sp,5564,17,34,51
Liberia,1998,sp,65,16,11,27
Liberia,2000,sp,014,21,12,33
Liberia,2000,sp,1524,140,133,273
Liberia,2000,sp,2534,149,196,345
Liberia,2000,sp,3544,88,127,215
Liberia,2000,sp,4554,28,52,80
Liberia,2000,sp,5564,16,17,33
Liberia,2000,sp,65,16,26,42
Liberia,2001,sp,014,18,16,34
Liberia,2001,sp,1524,108,111,219
Liberia,2001,sp,2534,143,174,317
Liberia,2001,sp,3544,77,132,209
Liberia,2001,sp,4554,35,63,98
Liberia,2001,sp,5564,17,17,34
Liberia,2001,sp,65,12,11,23
Liberia,2002,sp,014,26,20,46
Liberia,2002,sp,1524,256,252,508
Liberia,2002,sp,2534,250,315,565
Liberia,2002,sp,3544,150,295,445
Liberia,2002,sp,4554,86,143,229
Liberia,2002,sp,5564,41,60,101
Liberia,2002,sp,65,26,44,70
Liberia,2003,sp,014,12,5,17
Liberia,2003,sp,1524,148,180,328
Liberia,2003,sp,2534,180,215,395
Liberia,2003,sp,3544,109,204,313
Liberia,2003,sp,4554,43,99,142
Liberia,2003,sp,5564,30,49,79
Liberia,2003,sp,65,22,23,45
Liberia,2004,sp,014,39,32,71
Liberia,2004,sp,1524,268,333,601
Liberia,2004,sp,2534,397,427,824
Liberia,2004,sp,3544,183,285,468
Liberia,2004,sp,4554,123,198,321
Liberia,2004,sp,5564,41,71,112
Liberia,2004,sp,65,42,51,93
Liberia,2005,sp,014,37,26,63
Liberia,2005,sp,1524,232,240,472
Liberia,2005,sp,2534,297,352,649
Liberia,2005,sp,3544,171,333,504
Liberia,2005,sp,4554,108,155,263
Liberia,2005,sp,5564,52,74,126
Liberia,2005,sp,65,25,65,90
Liberia,2006,ep,014,32,51,83
Liberia,2006,ep,1524,72,77,149
Liberia,2006,ep,2534,50,72,122
Liberia,2006,ep,3544,118,106,224
Liberia,2006,ep,4554,65,84,149
Liberia,2006,ep,5564,4,7,11
Liberia,2006,ep,65,2,6,8
Liberia,2006,sn,014,63,70,133
Liberia,2006,sn,1524,33,39,72
Liberia,2006,sn,2534,24,19,43
Liberia,2006,sn,3544,80,99,179
Liberia,2006,sn,4554,75,58,133
Liberia,2006,sn,5564,31,29,60
Liberia,2006,sn,65,12,14,26
Liberia,2006,sp,014,55,59,114
Liberia,2006,sp,1524,292,324,616
Liberia,2006,sp,2534,371,442,813
Liberia,2006,sp,3544,242,371,613
Liberia,2006,sp,4554,125,250,375
Liberia,2006,sp,5564,85,125,210
Liberia,2006,sp,65,68,97,165
Liberia,2008,sp,014,56,107,163
Liberia,2008,sp,1524,115,129,244
Liberia,2008,sp,2534,237,412,649
Liberia,2008,sp,3544,367,532,899
Liberia,2008,sp,4554,298,308,606
Liberia,2008,sp,5564,170,169,339
Liberia,2008,sp,65,44,98,142
Liberia,2009,ep,014,27,25,52
Liberia,2009,ep,1524,11,13,24
Liberia,2009,ep,2534,19,46,65
Liberia,2009,ep,3544,17,26,43
Liberia,2009,ep,4554,28,55,83
Liberia,2009,ep,5564,2,33,35
Liberia,2009,ep,65,0,0,0
Liberia,2009,sn,014,14,24,38
Liberia,2009,sn,1524,11,8,19
Liberia,2009,sn,2534,37,17,54
Liberia,2009,sn,3544,8,20,28
Liberia,2009,sn,4554,15,12,27
Liberia,2009,sn,5564,0,8,8
Liberia,2009,sn,65,0,0,0
Liberia,2009,sp,014,105,95,200
Liberia,2009,sp,1524,354,360,714
Liberia,2009,sp,2534,541,591,1132
Liberia,2009,sp,3544,399,592,991
Liberia,2009,sp,4554,222,346,568
Liberia,2009,sp,5564,0,135,135
Liberia,2009,sp,65,96,0,96
Liberia,2010,ep,014,202,353,555
Liberia,2010,ep,1524,45,56,101
Liberia,2010,ep,2534,19,38,57
Liberia,2010,ep,3544,452,65,517
Liberia,2010,ep,4554,23,4,27
Liberia,2010,ep,5564,6,12,18
Liberia,2010,ep,65,78,10,88
Liberia,2010,sn,014,145,121,266
Liberia,2010,sn,1524,40,132,172
Liberia,2010,sn,2534,18,193,211
Liberia,2010,sn,3544,351,48,399
Liberia,2010,sn,4554,123,69,192
Liberia,2010,sn,5564,46,19,65
Liberia,2010,sn,65,78,2,80
Liberia,2010,sp,014,254,90,344
Liberia,2010,sp,1524,339,338,677
Liberia,2010,sp,2534,488,621,1109
Liberia,2010,sp,3544,259,510,769
Liberia,2010,sp,4554,171,295,466
Liberia,2010,sp,5564,151,114,265
Liberia,2010,sp,65,99,21,120
Liberia,2011,ep,014,65,162,227
Liberia,2011,ep,1524,70,19,89
Liberia,2011,ep,2534,145,114,259
Liberia,2011,ep,3544,125,85,210
Liberia,2011,ep,4554,136,219,355
Liberia,2011,ep,5564,110,113,223
Liberia,2011,ep,65,81,168,249
Liberia,2011,sn,014,58,77,135
Liberia,2011,sn,1524,199,111,310
Liberia,2011,sn,2534,115,190,305
Liberia,2011,sn,3544,179,194,373
Liberia,2011,sn,4554,129,270,399
Liberia,2011,sn,5564,78,104,182
Liberia,2011,sn,65,44,84,128
Liberia,2011,sp,014,67,67,134
Liberia,2011,sp,1524,329,382,711
Liberia,2011,sp,2534,433,595,1028
Liberia,2011,sp,3544,517,727,1244
Liberia,2011,sp,4554,285,440,725
Liberia,2011,sp,5564,88,194,282
Liberia,2011,sp,65,50,87,137
Liberia,2012,ep,014,64,149,213
Liberia,2012,ep,1524,152,50,202
Liberia,2012,ep,2534,152,164,316
Liberia,2012,ep,3544,135,128,263
Liberia,2012,ep,4554,110,212,322
Liberia,2012,ep,5564,92,133,225
Liberia,2012,ep,65,75,133,208
Liberia,2012,sn,014,171,172,343
Liberia,2012,sn,1524,99,118,217
Liberia,2012,sn,2534,96,305,401
Liberia,2012,sn,3544,165,139,304
Liberia,2012,sn,4554,122,233,355
Liberia,2012,sn,5564,76,111,187
Liberia,2012,sn,65,50,89,139
Liberia,2012,sp,014,61,65,126
Liberia,2012,sp,1524,354,382,736
Liberia,2012,sp,2534,535,627,1162
Liberia,2012,sp,3544,605,667,1272
Liberia,2012,sp,4554,292,406,698
Liberia,2012,sp,5564,79,129,208
Liberia,2012,sp,65,57,83,140
Liberia,2013,rel,014,64,57,121
Liberia,2013,rel,1524,316,366,682
Liberia,2013,rel,2534,512,660,1172
Liberia,2013,rel,3544,217,635,852
Liberia,2013,rel,4554,242,320,562
Liberia,2013,rel,5564,86,198,284
Liberia,2013,rel,65,64,98,162
Libya,1995,sp,014,5,2,7
Libya,1995,sp,1524,34,112,146
Libya,1995,sp,2534,31,212,243
Libya,1995,sp,3544,19,78,97
Libya,1995,sp,4554,20,46,66
Libya,1995,sp,5564,13,22,35
Libya,1995,sp,65,11,21,32
Libya,1996,sp,014,4,4,8
Libya,1996,sp,1524,30,93,123
Libya,1996,sp,2534,35,142,177
Libya,1996,sp,3544,17,82,99
Libya,1996,sp,4554,10,31,41
Libya,1996,sp,5564,9,28,37
Libya,1996,sp,65,11,19,30
Libya,1999,sp,014,6,2,8
Libya,1999,sp,1524,43,110,153
Libya,1999,sp,2534,59,257,316
Libya,1999,sp,3544,25,115,140
Libya,1999,sp,4554,15,53,68
Libya,1999,sp,5564,14,36,50
Libya,1999,sp,65,27,33,60
Libya,2000,sp,014,6,5,11
Libya,2000,sp,1524,43,101,144
Libya,2000,sp,2534,35,239,274
Libya,2000,sp,3544,24,86,110
Libya,2000,sp,4554,24,36,60
Libya,2000,sp,5564,16,29,45
Libya,2000,sp,65,22,32,54
Libya,2003,sp,014,4,0,4
Libya,2003,sp,1524,43,108,151
Libya,2003,sp,2534,28,266,294
Libya,2003,sp,3544,30,142,172
Libya,2003,sp,4554,25,32,57
Libya,2003,sp,5564,21,25,46
Libya,2003,sp,65,21,19,40
Libya,2004,sp,014,1,5,6
Libya,2004,sp,1524,44,113,157
Libya,2004,sp,2534,50,310,360
Libya,2004,sp,3544,20,173,193
Libya,2004,sp,4554,23,53,76
Libya,2004,sp,5564,13,24,37
Libya,2004,sp,65,23,20,43
Libya,2005,sp,014,8,2,10
Libya,2005,sp,1524,36,114,150
Libya,2005,sp,2534,36,293,329
Libya,2005,sp,3544,35,168,203
Libya,2005,sp,4554,21,52,73
Libya,2005,sp,5564,21,19,40
Libya,2005,sp,65,20,35,55
Libya,2006,ep,014,46,49,95
Libya,2006,ep,1524,87,52,139
Libya,2006,ep,2534,94,116,210
Libya,2006,ep,3544,67,51,118
Libya,2006,ep,4554,58,29,87
Libya,2006,ep,5564,50,24,74
Libya,2006,ep,65,45,36,81
Libya,2006,sp,014,8,1,9
Libya,2006,sp,1524,55,98,153
Libya,2006,sp,2534,34,247,281
Libya,2006,sp,3544,24,150,174
Libya,2006,sp,4554,10,49,59
Libya,2006,sp,5564,12,23,35
Libya,2006,sp,65,11,23,34
Libya,2007,ep,014,45,45,90
Libya,2007,ep,1524,78,65,143
Libya,2007,ep,2534,79,122,201
Libya,2007,ep,3544,40,73,113
Libya,2007,ep,4554,18,44,62
Libya,2007,ep,5564,35,45,80
Libya,2007,ep,65,391,32,423
Libya,2007,sn,014,14,14,28
Libya,2007,sn,1524,16,33,49
Libya,2007,sn,2534,14,58,72
Libya,2007,sn,3544,13,54,67
Libya,2007,sn,4554,11,25,36
Libya,2007,sn,5564,14,17,31
Libya,2007,sn,65,16,23,39
Libya,2007,sp,014,4,2,6
Libya,2007,sp,1524,23,61,84
Libya,2007,sp,2534,17,143,160
Libya,2007,sp,3544,12,78,90
Libya,2007,sp,4554,8,26,34
Libya,2007,sp,5564,7,12,19
Libya,2007,sp,65,11,10,21
Libya,2008,ep,014,39,33,72
Libya,2008,ep,1524,80,71,151
Libya,2008,ep,2534,89,112,201
Libya,2008,ep,3544,67,67,134
Libya,2008,ep,4554,54,21,75
Libya,2008,ep,5564,36,12,48
Libya,2008,ep,65,44,24,68
Libya,2008,sn,014,13,10,23
Libya,2008,sn,1524,21,26,47
Libya,2008,sn,2534,29,64,93
Libya,2008,sn,3544,29,75,104
Libya,2008,sn,4554,15,18,33
Libya,2008,sn,5564,22,20,42
Libya,2008,sn,65,25,23,48
Libya,2008,sp,014,6,2,8
Libya,2008,sp,1524,56,116,172
Libya,2008,sp,2534,35,298,333
Libya,2008,sp,3544,22,162,184
Libya,2008,sp,4554,20,85,105
Libya,2008,sp,5564,9,24,33
Libya,2008,sp,65,17,19,36
Libya,2009,ep,014,25,27,52
Libya,2009,ep,1524,64,69,133
Libya,2009,ep,2534,83,111,194
Libya,2009,ep,3544,57,68,125
Libya,2009,ep,4554,43,29,72
Libya,2009,ep,5564,40,15,55
Libya,2009,ep,65,44,21,65
Libya,2009,sn,014,11,18,29
Libya,2009,sn,1524,27,34,61
Libya,2009,sn,2534,28,78,106
Libya,2009,sn,3544,22,105,127
Libya,2009,sn,4554,22,33,55
Libya,2009,sn,5564,19,11,30
Libya,2009,sn,65,17,30,47
Libya,2009,sp,014,11,4,15
Libya,2009,sp,1524,54,131,185
Libya,2009,sp,2534,63,295,358
Libya,2009,sp,3544,26,180,206
Libya,2009,sp,4554,10,73,83
Libya,2009,sp,5564,14,30,44
Libya,2009,sp,65,22,23,45
Libya,2011,ep,014,16,11,27
Libya,2011,ep,1524,46,27,73
Libya,2011,ep,2534,58,52,110
Libya,2011,ep,3544,59,47,106
Libya,2011,ep,4554,29,27,56
Libya,2011,ep,5564,25,13,38
Libya,2011,ep,65,26,26,52
Libya,2011,sn,014,7,17,24
Libya,2011,sn,1524,26,16,42
Libya,2011,sn,2534,19,51,70
Libya,2011,sn,3544,16,79,95
Libya,2011,sn,4554,2,32,34
Libya,2011,sn,5564,9,13,22
Libya,2011,sn,65,7,11,18
Libya,2011,sp,014,8,5,13
Libya,2011,sp,1524,59,85,144
Libya,2011,sp,2534,47,173,220
Libya,2011,sp,3544,37,148,185
Libya,2011,sp,4554,22,54,76
Libya,2011,sp,5564,25,18,43
Libya,2011,sp,65,29,21,50
Libya,2012,ep,014,19,22,41
Libya,2012,ep,1524,51,34,85
Libya,2012,ep,2534,55,65,120
Libya,2012,ep,3544,53,45,98
Libya,2012,ep,4554,43,20,63
Libya,2012,ep,5564,30,19,49
Libya,2012,ep,65,47,30,77
Libya,2012,sn,014,24,25,49
Libya,2012,sn,1524,17,27,44
Libya,2012,sn,2534,20,58,78
Libya,2012,sn,3544,17,60,77
Libya,2012,sn,4554,18,40,58
Libya,2012,sn,5564,14,24,38
Libya,2012,sn,65,14,14,28
Libya,2012,sp,014,10,2,12
Libya,2012,sp,1524,47,86,133
Libya,2012,sp,2534,37,136,173
Libya,2012,sp,3544,19,136,155
Libya,2012,sp,4554,24,63,87
Libya,2012,sp,5564,18,31,49
Libya,2012,sp,65,13,22,35
Libya,2013,rel,014,30,42,72
Libya,2013,rel,1524,110,135,245
Libya,2013,rel,2534,124,233,357
Libya,2013,rel,3544,80,204,284
Libya,2013,rel,4554,60,93,153
Libya,2013,rel,5564,56,69,125
Libya,2013,rel,65,42,66,108
Lithuania,1995,sp,014,5,4,9
Lithuania,1995,sp,1524,6,46,52
Lithuania,1995,sp,2534,53,132,185
Lithuania,1995,sp,3544,45,225,270
Lithuania,1995,sp,4554,32,176,208
Lithuania,1995,sp,5564,16,90,106
Lithuania,1995,sp,65,42,77,119
Lithuania,1996,sp,014,6,2,8
Lithuania,1996,sp,1524,37,60,97
Lithuania,1996,sp,2534,62,133,195
Lithuania,1996,sp,3544,73,224,297
Lithuania,1996,sp,4554,40,206,246
Lithuania,1996,sp,5564,29,133,162
Lithuania,1996,sp,65,44,82,126
Lithuania,1997,sp,014,5,2,7
Lithuania,1997,sp,1524,40,53,93
Lithuania,1997,sp,2534,77,136,213
Lithuania,1997,sp,3544,73,227,300
Lithuania,1997,sp,4554,38,213,251
Lithuania,1997,sp,5564,25,146,171
Lithuania,1997,sp,65,67,98,165
Lithuania,1998,sp,014,0,0,0
Lithuania,1998,sp,1524,27,38,65
Lithuania,1998,sp,2534,25,77,102
Lithuania,1998,sp,3544,65,165,230
Lithuania,1998,sp,4554,22,163,185
Lithuania,1998,sp,5564,21,81,102
Lithuania,1998,sp,65,46,57,103
Lithuania,1999,sp,014,0,0,0
Lithuania,1999,sp,1524,32,42,74
Lithuania,1999,sp,2534,48,90,138
Lithuania,1999,sp,3544,55,153,208
Lithuania,1999,sp,4554,25,22,47
Lithuania,1999,sp,5564,20,91,111
Lithuania,1999,sp,65,40,67,107
Lithuania,2000,sp,014,0,1,1
Lithuania,2000,sp,1524,20,38,58
Lithuania,2000,sp,2534,37,97,134
Lithuania,2000,sp,3544,39,145,184
Lithuania,2000,sp,4554,32,155,187
Lithuania,2000,sp,5564,22,74,96
Lithuania,2000,sp,65,48,68,116
Lithuania,2001,sp,014,1,0,1
Lithuania,2001,sp,1524,33,35,68
Lithuania,2001,sp,2534,59,112,171
Lithuania,2001,sp,3544,57,197,254
Lithuania,2001,sp,4554,35,155,190
Lithuania,2001,sp,5564,28,88,116
Lithuania,2001,sp,65,59,76,135
Lithuania,2002,sp,014,0,1,1
Lithuania,2002,sp,1524,30,24,54
Lithuania,2002,sp,2534,59,95,154
Lithuania,2002,sp,3544,45,176,221
Lithuania,2002,sp,4554,32,142,174
Lithuania,2002,sp,5564,18,88,106
Lithuania,2002,sp,65,52,59,111
Lithuania,2003,sp,014,0,1,1
Lithuania,2003,sp,1524,35,35,70
Lithuania,2003,sp,2534,49,116,165
Lithuania,2003,sp,3544,37,175,212
Lithuania,2003,sp,4554,38,174,212
Lithuania,2003,sp,5564,20,107,127
Lithuania,2003,sp,65,50,60,110
Lithuania,2004,sp,014,1,0,1
Lithuania,2004,sp,1524,21,39,60
Lithuania,2004,sp,2534,48,100,148
Lithuania,2004,sp,3544,47,161,208
Lithuania,2004,sp,4554,47,173,220
Lithuania,2004,sp,5564,24,92,116
Lithuania,2004,sp,65,32,71,103
Lithuania,2005,sp,014,1,0,1
Lithuania,2005,sp,1524,25,42,67
Lithuania,2005,sp,2534,41,118,159
Lithuania,2005,sp,3544,57,186,243
Lithuania,2005,sp,4554,49,187,236
Lithuania,2005,sp,5564,23,108,131
Lithuania,2005,sp,65,54,67,121
Lithuania,2006,ep,014,46,51,97
Lithuania,2006,ep,1524,13,18,31
Lithuania,2006,ep,2534,10,18,28
Lithuania,2006,ep,3544,16,19,35
Lithuania,2006,ep,4554,21,26,47
Lithuania,2006,ep,5564,12,19,31
Lithuania,2006,ep,65,32,15,47
Lithuania,2006,sn,014,2,5,7
Lithuania,2006,sn,1524,29,34,63
Lithuania,2006,sn,2534,33,79,112
Lithuania,2006,sn,3544,46,109,155
Lithuania,2006,sn,4554,42,132,174
Lithuania,2006,sn,5564,23,101,124
Lithuania,2006,sn,65,53,66,119
Lithuania,2006,sp,014,0,0,0
Lithuania,2006,sp,1524,25,38,63
Lithuania,2006,sp,2534,48,120,168
Lithuania,2006,sp,3544,56,207,263
Lithuania,2006,sp,4554,52,211,263
Lithuania,2006,sp,5564,38,107,145
Lithuania,2006,sp,65,53,74,127
Lithuania,2007,ep,014,43,35,78
Lithuania,2007,ep,1524,15,10,25
Lithuania,2007,ep,2534,9,15,24
Lithuania,2007,ep,3544,23,18,41
Lithuania,2007,ep,4554,11,27,38
Lithuania,2007,ep,5564,13,14,27
Lithuania,2007,ep,65,29,16,45
Lithuania,2007,sn,014,4,3,7
Lithuania,2007,sn,1524,23,30,53
Lithuania,2007,sn,2534,45,85,130
Lithuania,2007,sn,3544,42,112,154
Lithuania,2007,sn,4554,49,145,194
Lithuania,2007,sn,5564,23,90,113
Lithuania,2007,sn,65,46,82,128
Lithuania,2007,sp,014,0,0,0
Lithuania,2007,sp,1524,34,31,65
Lithuania,2007,sp,2534,41,77,118
Lithuania,2007,sp,3544,48,165,213
Lithuania,2007,sp,4554,50,235,285
Lithuania,2007,sp,5564,22,109,131
Lithuania,2007,sp,65,37,76,113
Lithuania,2008,ep,014,51,46,97
Lithuania,2008,ep,1524,8,13,21
Lithuania,2008,ep,2534,11,14,25
Lithuania,2008,ep,3544,18,16,34
Lithuania,2008,ep,4554,9,25,34
Lithuania,2008,ep,5564,11,11,22
Lithuania,2008,ep,65,20,11,31
Lithuania,2008,sn,014,1,1,2
Lithuania,2008,sn,1524,27,25,52
Lithuania,2008,sn,2534,46,69,115
Lithuania,2008,sn,3544,37,108,145
Lithuania,2008,sn,4554,44,140,184
Lithuania,2008,sn,5564,21,88,109
Lithuania,2008,sn,65,52,85,137
Lithuania,2008,sp,014,1,0,1
Lithuania,2008,sp,1524,20,39,59
Lithuania,2008,sp,2534,51,110,161
Lithuania,2008,sp,3544,46,162,208
Lithuania,2008,sp,4554,36,182,218
Lithuania,2008,sp,5564,18,104,122
Lithuania,2008,sp,65,44,71,115
Lithuania,2009,ep,014,25,41,66
Lithuania,2009,ep,1524,17,10,27
Lithuania,2009,ep,2534,12,19,31
Lithuania,2009,ep,3544,16,9,25
Lithuania,2009,ep,4554,14,19,33
Lithuania,2009,ep,5564,11,9,20
Lithuania,2009,ep,65,19,12,31
Lithuania,2009,sn,014,2,2,4
Lithuania,2009,sn,1524,38,29,67
Lithuania,2009,sn,2534,38,53,91
Lithuania,2009,sn,3544,51,102,153
Lithuania,2009,sn,4554,35,120,155
Lithuania,2009,sn,5564,29,74,103
Lithuania,2009,sn,65,51,77,128
Lithuania,2009,sp,014,4,0,4
Lithuania,2009,sp,1524,25,22,47
Lithuania,2009,sp,2534,36,91,127
Lithuania,2009,sp,3544,31,130,161
Lithuania,2009,sp,4554,33,163,196
Lithuania,2009,sp,5564,21,100,121
Lithuania,2009,sp,65,39,48,87
Lithuania,2010,ep,014,32,54,86
Lithuania,2010,ep,1524,13,14,27
Lithuania,2010,ep,2534,7,9,16
Lithuania,2010,ep,3544,4,14,18
Lithuania,2010,ep,4554,7,17,24
Lithuania,2010,ep,5564,5,17,22
Lithuania,2010,ep,65,18,10,28
Lithuania,2010,sn,014,4,0,4
Lithuania,2010,sn,1524,32,29,61
Lithuania,2010,sn,2534,33,64,97
Lithuania,2010,sn,3544,36,105,141
Lithuania,2010,sn,4554,44,87,131
Lithuania,2010,sn,5564,14,82,96
Lithuania,2010,sn,65,38,65,103
Lithuania,2010,sp,014,1,1,2
Lithuania,2010,sp,1524,20,34,54
Lithuania,2010,sp,2534,36,75,111
Lithuania,2010,sp,3544,31,128,159
Lithuania,2010,sp,4554,43,157,200
Lithuania,2010,sp,5564,18,89,107
Lithuania,2010,sp,65,32,54,86
Lithuania,2011,ep,014,29,52,81
Lithuania,2011,ep,1524,10,2,12
Lithuania,2011,ep,2534,2,10,12
Lithuania,2011,ep,3544,10,13,23
Lithuania,2011,ep,4554,9,11,20
Lithuania,2011,ep,5564,5,7,12
Lithuania,2011,ep,65,19,8,27
Lithuania,2011,sn,014,4,2,6
Lithuania,2011,sn,1524,31,28,59
Lithuania,2011,sn,2534,45,67,112
Lithuania,2011,sn,3544,43,97,140
Lithuania,2011,sn,4554,40,96,136
Lithuania,2011,sn,5564,25,75,100
Lithuania,2011,sn,65,56,55,111
Lithuania,2011,sp,014,0,1,1
Lithuania,2011,sp,1524,20,25,45
Lithuania,2011,sp,2534,31,52,83
Lithuania,2011,sp,3544,37,126,163
Lithuania,2011,sp,4554,38,158,196
Lithuania,2011,sp,5564,16,77,93
Lithuania,2011,sp,65,45,55,100
Lithuania,2012,ep,014,25,23,48
Lithuania,2012,ep,1524,13,14,27
Lithuania,2012,ep,2534,5,7,12
Lithuania,2012,ep,3544,7,6,13
Lithuania,2012,ep,4554,10,11,21
Lithuania,2012,ep,5564,7,9,16
Lithuania,2012,ep,65,14,5,19
Lithuania,2012,sn,014,5,2,7
Lithuania,2012,sn,1524,25,15,40
Lithuania,2012,sn,2534,34,51,85
Lithuania,2012,sn,3544,43,73,116
Lithuania,2012,sn,4554,35,87,122
Lithuania,2012,sn,5564,21,70,91
Lithuania,2012,sn,65,30,57,87
Lithuania,2012,sp,014,1,0,1
Lithuania,2012,sp,1524,8,35,43
Lithuania,2012,sp,2534,28,73,101
Lithuania,2012,sp,3544,55,143,198
Lithuania,2012,sp,4554,36,148,184
Lithuania,2012,sp,5564,20,91,111
Lithuania,2012,sp,65,28,60,88
Lithuania,2013,rel,014,18,19,37
Lithuania,2013,rel,1524,42,49,91
Lithuania,2013,rel,2534,76,150,226
Lithuania,2013,rel,3544,84,254,338
Lithuania,2013,rel,4554,82,299,381
Lithuania,2013,rel,5564,57,209,266
Lithuania,2013,rel,65,74,160,234
Luxembourg,1996,sp,014,1,0,1
Luxembourg,1996,sp,1524,3,5,8
Luxembourg,1996,sp,2534,2,3,5
Luxembourg,1996,sp,3544,0,4,4
Luxembourg,1996,sp,4554,1,2,3
Luxembourg,1996,sp,5564,0,3,3
Luxembourg,1996,sp,65,3,2,5
Luxembourg,1997,sp,014,1,1,2
Luxembourg,1997,sp,1524,3,2,5
Luxembourg,1997,sp,2534,0,2,2
Luxembourg,1997,sp,3544,1,7,8
Luxembourg,1997,sp,4554,0,3,3
Luxembourg,1997,sp,5564,1,2,3
Luxembourg,1997,sp,65,5,3,8
Luxembourg,1998,sp,014,1,0,1
Luxembourg,1998,sp,1524,0,3,3
Luxembourg,1998,sp,2534,1,6,7
Luxembourg,1998,sp,3544,2,7,9
Luxembourg,1998,sp,4554,2,4,6
Luxembourg,1998,sp,5564,0,2,2
Luxembourg,1998,sp,65,2,0,2
Luxembourg,2001,sp,014,0,0,0
Luxembourg,2001,sp,1524,2,0,2
Luxembourg,2001,sp,2534,2,1,3
Luxembourg,2001,sp,3544,1,0,1
Luxembourg,2001,sp,4554,1,0,1
Luxembourg,2001,sp,5564,1,0,1
Luxembourg,2001,sp,65,2,2,4
Luxembourg,2002,sp,014,0,0,0
Luxembourg,2002,sp,1524,0,0,0
Luxembourg,2002,sp,2534,2,1,3
Luxembourg,2002,sp,3544,1,3,4
Luxembourg,2002,sp,4554,1,3,4
Luxembourg,2002,sp,5564,1,2,3
Luxembourg,2002,sp,65,2,1,3
Luxembourg,2003,sp,014,0,0,0
Luxembourg,2003,sp,1524,2,2,4
Luxembourg,2003,sp,2534,1,10,11
Luxembourg,2003,sp,3544,1,7,8
Luxembourg,2003,sp,4554,0,1,1
Luxembourg,2003,sp,5564,0,2,2
Luxembourg,2003,sp,65,0,2,2
Luxembourg,2004,sp,014,0,0,0
Luxembourg,2004,sp,1524,0,1,1
Luxembourg,2004,sp,2534,5,0,5
Luxembourg,2004,sp,3544,5,4,9
Luxembourg,2004,sp,4554,0,3,3
Luxembourg,2004,sp,5564,0,1,1
Luxembourg,2004,sp,65,0,1,1
Luxembourg,2005,sp,014,0,0,0
Luxembourg,2005,sp,1524,0,0,0
Luxembourg,2005,sp,2534,2,2,4
Luxembourg,2005,sp,3544,1,2,3
Luxembourg,2005,sp,4554,1,1,2
Luxembourg,2005,sp,5564,1,1,2
Luxembourg,2005,sp,65,0,2,2
Luxembourg,2006,ep,014,0,0,0
Luxembourg,2006,ep,1524,0,0,0
Luxembourg,2006,ep,2534,0,0,0
Luxembourg,2006,ep,3544,0,0,0
Luxembourg,2006,ep,4554,0,0,0
Luxembourg,2006,ep,5564,0,0,0
Luxembourg,2006,ep,65,0,1,1
Luxembourg,2006,sn,014,0,0,0
Luxembourg,2006,sn,1524,1,0,1
Luxembourg,2006,sn,2534,1,1,2
Luxembourg,2006,sn,3544,1,1,2
Luxembourg,2006,sn,4554,1,0,1
Luxembourg,2006,sn,5564,0,1,1
Luxembourg,2006,sn,65,2,1,3
Luxembourg,2006,sp,014,0,0,0
Luxembourg,2006,sp,1524,2,0,2
Luxembourg,2006,sp,2534,3,3,6
Luxembourg,2006,sp,3544,2,2,4
Luxembourg,2006,sp,4554,0,3,3
Luxembourg,2006,sp,5564,1,2,3
Luxembourg,2006,sp,65,1,3,4
Luxembourg,2007,ep,014,2,0,2
Luxembourg,2007,ep,1524,0,0,0
Luxembourg,2007,ep,2534,0,0,0
Luxembourg,2007,ep,3544,0,2,2
Luxembourg,2007,ep,4554,0,0,0
Luxembourg,2007,ep,5564,2,0,2
Luxembourg,2007,ep,65,0,2,2
Luxembourg,2007,sn,014,0,1,1
Luxembourg,2007,sn,1524,1,1,2
Luxembourg,2007,sn,2534,4,5,9
Luxembourg,2007,sn,3544,1,6,7
Luxembourg,2007,sn,4554,1,4,5
Luxembourg,2007,sn,5564,1,1,2
Luxembourg,2007,sn,65,2,6,8
Luxembourg,2007,sp,014,0,0,0
Luxembourg,2007,sp,1524,0,0,0
Luxembourg,2007,sp,2534,0,0,0
Luxembourg,2007,sp,3544,0,1,1
Luxembourg,2007,sp,4554,0,0,0
Luxembourg,2007,sp,5564,0,0,0
Luxembourg,2007,sp,65,0,0,0
Luxembourg,2008,ep,014,0,0,0
Luxembourg,2008,ep,1524,0,0,0
Luxembourg,2008,ep,2534,0,0,0
Luxembourg,2008,ep,3544,0,0,0
Luxembourg,2008,ep,4554,0,0,0
Luxembourg,2008,ep,5564,0,0,0
Luxembourg,2008,ep,65,0,0,0
Luxembourg,2008,sn,014,0,0,0
Luxembourg,2008,sn,1524,0,0,0
Luxembourg,2008,sn,2534,0,0,0
Luxembourg,2008,sn,3544,0,0,0
Luxembourg,2008,sn,4554,0,0,0
Luxembourg,2008,sn,5564,0,0,0
Luxembourg,2008,sn,65,0,0,0
Luxembourg,2008,sp,014,0,0,0
Luxembourg,2008,sp,1524,0,0,0
Luxembourg,2008,sp,2534,0,0,0
Luxembourg,2008,sp,3544,0,0,0
Luxembourg,2008,sp,4554,0,0,0
Luxembourg,2008,sp,5564,0,0,0
Luxembourg,2008,sp,65,0,0,0
Luxembourg,2009,ep,014,0,0,0
Luxembourg,2009,ep,1524,0,0,0
Luxembourg,2009,ep,2534,0,0,0
Luxembourg,2009,ep,3544,0,0,0
Luxembourg,2009,ep,4554,0,0,0
Luxembourg,2009,ep,5564,0,0,0
Luxembourg,2009,ep,65,0,0,0
Luxembourg,2009,sn,014,0,0,0
Luxembourg,2009,sn,1524,0,0,0
Luxembourg,2009,sn,2534,0,0,0
Luxembourg,2009,sn,3544,0,0,0
Luxembourg,2009,sn,4554,0,0,0
Luxembourg,2009,sn,5564,0,0,0
Luxembourg,2009,sn,65,0,0,0
Luxembourg,2009,sp,014,0,0,0
Luxembourg,2009,sp,1524,0,0,0
Luxembourg,2009,sp,2534,0,0,0
Luxembourg,2009,sp,3544,0,0,0
Luxembourg,2009,sp,4554,0,0,0
Luxembourg,2009,sp,5564,0,0,0
Luxembourg,2009,sp,65,0,0,0
Luxembourg,2010,ep,014,0,0,0
Luxembourg,2010,ep,1524,0,1,1
Luxembourg,2010,ep,2534,1,0,1
Luxembourg,2010,ep,3544,1,1,2
Luxembourg,2010,ep,4554,0,0,0
Luxembourg,2010,ep,5564,0,0,0
Luxembourg,2010,ep,65,0,2,2
Luxembourg,2010,sn,014,1,0,1
Luxembourg,2010,sn,1524,1,1,2
Luxembourg,2010,sn,2534,1,3,4
Luxembourg,2010,sn,3544,1,2,3
Luxembourg,2010,sn,4554,3,4,7
Luxembourg,2010,sn,5564,0,1,1
Luxembourg,2010,sn,65,0,0,0
Luxembourg,2010,sp,014,0,0,0
Luxembourg,2010,sp,1524,0,0,0
Luxembourg,2010,sp,2534,0,0,0
Luxembourg,2010,sp,3544,0,0,0
Luxembourg,2010,sp,4554,0,0,0
Luxembourg,2010,sp,5564,0,0,0
Luxembourg,2010,sp,65,0,0,0
Luxembourg,2011,ep,014,0,0,0
Luxembourg,2011,ep,1524,0,0,0
Luxembourg,2011,ep,2534,0,0,0
Luxembourg,2011,ep,3544,0,0,0
Luxembourg,2011,ep,4554,0,0,0
Luxembourg,2011,ep,5564,0,0,0
Luxembourg,2011,ep,65,0,0,0
Luxembourg,2011,sn,014,0,0,0
Luxembourg,2011,sn,1524,0,0,0
Luxembourg,2011,sn,2534,0,0,0
Luxembourg,2011,sn,3544,0,0,0
Luxembourg,2011,sn,4554,0,0,0
Luxembourg,2011,sn,5564,0,0,0
Luxembourg,2011,sn,65,0,0,0
Luxembourg,2011,sp,014,0,0,0
Luxembourg,2011,sp,1524,0,0,0
Luxembourg,2011,sp,2534,0,0,0
Luxembourg,2011,sp,3544,0,0,0
Luxembourg,2011,sp,4554,0,0,0
Luxembourg,2011,sp,5564,0,0,0
Luxembourg,2011,sp,65,0,0,0
Luxembourg,2012,ep,014,0,0,0
Luxembourg,2012,ep,1524,0,0,0
Luxembourg,2012,ep,2534,0,0,0
Luxembourg,2012,ep,3544,0,0,0
Luxembourg,2012,ep,4554,0,0,0
Luxembourg,2012,ep,5564,0,0,0
Luxembourg,2012,ep,65,0,0,0
Luxembourg,2012,sn,014,0,0,0
Luxembourg,2012,sn,1524,0,0,0
Luxembourg,2012,sn,2534,0,0,0
Luxembourg,2012,sn,3544,0,0,0
Luxembourg,2012,sn,4554,0,0,0
Luxembourg,2012,sn,5564,0,0,0
Luxembourg,2012,sn,65,0,0,0
Luxembourg,2012,sp,014,0,0,0
Luxembourg,2012,sp,1524,0,0,0
Luxembourg,2012,sp,2534,0,0,0
Luxembourg,2012,sp,3544,0,0,0
Luxembourg,2012,sp,4554,0,0,0
Luxembourg,2012,sp,5564,0,0,0
Luxembourg,2012,sp,65,0,0,0
Luxembourg,2013,rel,014,0,1,1
Luxembourg,2013,rel,1524,2,3,5
Luxembourg,2013,rel,2534,4,8,12
Luxembourg,2013,rel,3544,3,6,9
Luxembourg,2013,rel,4554,1,5,6
Luxembourg,2013,rel,5564,1,2,3
Luxembourg,2013,rel,65,2,0,2
Madagascar,1995,sp,014,100,79,179
Madagascar,1995,sp,1524,799,791,1590
Madagascar,1995,sp,2534,1108,1289,2397
Madagascar,1995,sp,3544,744,1173,1917
Madagascar,1995,sp,4554,340,630,970
Madagascar,1995,sp,5564,230,423,653
Madagascar,1995,sp,65,78,242,320
Madagascar,1996,sp,014,106,68,174
Madagascar,1996,sp,1524,808,888,1696
Madagascar,1996,sp,2534,1031,1325,2356
Madagascar,1996,sp,3544,744,1271,2015
Madagascar,1996,sp,4554,393,673,1066
Madagascar,1996,sp,5564,197,484,681
Madagascar,1996,sp,65,79,285,364
Madagascar,1998,sp,014,108,70,178
Madagascar,1998,sp,1524,852,827,1679
Madagascar,1998,sp,2534,1193,1545,2738
Madagascar,1998,sp,3544,824,1420,2244
Madagascar,1998,sp,4554,430,829,1259
Madagascar,1998,sp,5564,253,485,738
Madagascar,1998,sp,65,117,282,399
Madagascar,2001,sp,014,190,103,293
Madagascar,2001,sp,1524,1010,1033,2043
Madagascar,2001,sp,2534,1349,1588,2937
Madagascar,2001,sp,3544,1094,1625,2719
Madagascar,2001,sp,4554,546,1094,1640
Madagascar,2001,sp,5564,289,613,902
Madagascar,2001,sp,65,154,404,558
Madagascar,2002,sp,014,163,94,257
Madagascar,2002,sp,1524,983,1023,2006
Madagascar,2002,sp,2534,1372,1594,2966
Madagascar,2002,sp,3544,1000,1563,2563
Madagascar,2002,sp,4554,598,1174,1772
Madagascar,2002,sp,5564,234,609,843
Madagascar,2002,sp,65,135,398,533
Madagascar,2003,sp,014,216,123,339
Madagascar,2003,sp,1524,1164,1249,2413
Madagascar,2003,sp,2534,1578,1830,3408
Madagascar,2003,sp,3544,1240,1839,3079
Madagascar,2003,sp,4554,743,1413,2156
Madagascar,2003,sp,5564,326,723,1049
Madagascar,2003,sp,65,191,438,629
Madagascar,2004,sp,014,130,118,248
Madagascar,2004,sp,1524,950,1025,1975
Madagascar,2004,sp,2534,1130,1593,2723
Madagascar,2004,sp,3544,841,1482,2323
Madagascar,2004,sp,4554,513,1026,1539
Madagascar,2004,sp,5564,220,495,715
Madagascar,2004,sp,65,95,300,395
Madagascar,2005,sp,014,150,98,248
Madagascar,2005,sp,1524,1012,1159,2171
Madagascar,2005,sp,2534,1451,1867,3318
Madagascar,2005,sp,3544,1047,1732,2779
Madagascar,2005,sp,4554,614,1349,1963
Madagascar,2005,sp,5564,248,582,830
Madagascar,2005,sp,65,129,333,462
Madagascar,2006,sp,014,208,117,325
Madagascar,2006,sp,1524,1458,1500,2958
Madagascar,2006,sp,2534,1944,2391,4335
Madagascar,2006,sp,3544,1444,2220,3664
Madagascar,2006,sp,4554,874,1714,2588
Madagascar,2006,sp,5564,353,766,1119
Madagascar,2006,sp,65,166,458,624
Madagascar,2007,ep,014,421,512,933
Madagascar,2007,ep,1524,197,224,421
Madagascar,2007,ep,2534,213,242,455
Madagascar,2007,ep,3544,605,687,1292
Madagascar,2007,ep,4554,195,221,416
Madagascar,2007,ep,5564,128,147,275
Madagascar,2007,ep,65,85,96,181
Madagascar,2007,sn,014,128,155,283
Madagascar,2007,sn,1524,86,58,144
Madagascar,2007,sn,2534,133,106,239
Madagascar,2007,sn,3544,220,178,398
Madagascar,2007,sn,4554,62,39,101
Madagascar,2007,sn,5564,56,38,94
Madagascar,2007,sn,65,37,25,62
Madagascar,2007,sp,014,223,196,419
Madagascar,2007,sp,1524,1456,1473,2929
Madagascar,2007,sp,2534,1810,2353,4163
Madagascar,2007,sp,3544,1354,2097,3451
Madagascar,2007,sp,4554,880,1671,2551
Madagascar,2007,sp,5564,378,823,1201
Madagascar,2007,sp,65,192,438,630
Madagascar,2008,ep,014,NA,1215,NA
Madagascar,2008,sn,014,NA,215,NA
Madagascar,2008,sp,014,251,142,393
Madagascar,2008,sp,1524,1433,1499,2932
Madagascar,2008,sp,2534,1846,2294,4140
Madagascar,2008,sp,3544,1352,2113,3465
Madagascar,2008,sp,4554,911,1669,2580
Madagascar,2008,sp,5564,383,836,1219
Madagascar,2008,sp,65,171,465,636
Madagascar,2009,ep,014,NA,1225,NA
Madagascar,2009,ep,1524,NA,2762,NA
Madagascar,2009,sn,014,NA,303,NA
Madagascar,2009,sn,1524,NA,1332,NA
Madagascar,2009,sp,014,230,150,380
Madagascar,2009,sp,1524,1527,1463,2990
Madagascar,2009,sp,2534,1886,2377,4263
Madagascar,2009,sp,3544,1428,2132,3560
Madagascar,2009,sp,4554,906,1662,2568
Madagascar,2009,sp,5564,390,942,1332
Madagascar,2009,sp,65,187,433,620
Madagascar,2010,ep,014,NA,1314,NA
Madagascar,2010,ep,1524,NA,3237,NA
Madagascar,2010,sn,014,NA,285,NA
Madagascar,2010,sn,1524,NA,1372,NA
Madagascar,2010,sp,014,323,204,527
Madagascar,2010,sp,1524,1621,1721,3342
Madagascar,2010,sp,2534,1943,1621,3564
Madagascar,2010,sp,3544,1376,2525,3901
Madagascar,2010,sp,4554,946,1782,2728
Madagascar,2010,sp,5564,397,960,1357
Madagascar,2010,sp,65,192,485,677
Madagascar,2011,sp,014,252,146,398
Madagascar,2011,sp,1524,1726,1807,3533
Madagascar,2011,sp,2534,2031,2764,4795
Madagascar,2011,sp,3544,1503,2495,3998
Madagascar,2011,sp,4554,978,1938,2916
Madagascar,2011,sp,5564,462,1044,1506
Madagascar,2011,sp,65,188,522,710
Madagascar,2012,sp,014,242,177,419
Madagascar,2012,sp,1524,1720,1725,3445
Madagascar,2012,sp,2534,1848,2474,4322
Madagascar,2012,sp,3544,1420,2460,3880
Madagascar,2012,sp,4554,914,1927,2841
Madagascar,2012,sp,5564,474,1059,1533
Madagascar,2012,sp,65,199,490,689
Malawi,1995,sp,014,65,25,90
Malawi,1995,sp,1524,802,493,1295
Malawi,1995,sp,2534,1028,1195,2223
Malawi,1995,sp,3544,573,833,1406
Malawi,1995,sp,4554,294,519,813
Malawi,1995,sp,5564,108,215,323
Malawi,1995,sp,65,45,89,134
Malawi,1996,sp,014,92,27,119
Malawi,1996,sp,1524,887,562,1449
Malawi,1996,sp,2534,1187,1388,2575
Malawi,1996,sp,3544,715,937,1652
Malawi,1996,sp,4554,347,529,876
Malawi,1996,sp,5564,133,224,357
Malawi,1996,sp,65,37,110,147
Malawi,1997,sp,014,84,47,131
Malawi,1997,sp,1524,1009,578,1587
Malawi,1997,sp,2534,1307,1418,2725
Malawi,1997,sp,3544,767,995,1762
Malawi,1997,sp,4554,347,521,868
Malawi,1997,sp,5564,123,254,377
Malawi,1997,sp,65,36,101,137
Malawi,1998,sp,014,85,46,131
Malawi,1998,sp,1524,1131,677,1808
Malawi,1998,sp,2534,1585,1581,3166
Malawi,1998,sp,3544,867,1158,2025
Malawi,1998,sp,4554,437,643,1080
Malawi,1998,sp,5564,148,281,429
Malawi,1998,sp,65,63,151,214
Malawi,1999,sp,014,80,43,123
Malawi,1999,sp,1524,1052,588,1640
Malawi,1999,sp,2534,1487,1475,2962
Malawi,1999,sp,3544,777,1083,1860
Malawi,1999,sp,4554,376,588,964
Malawi,1999,sp,5564,154,239,393
Malawi,1999,sp,65,62,126,188
Malawi,2000,sp,014,66,50,116
Malawi,2000,sp,1524,1038,653,1691
Malawi,2000,sp,2534,1481,1476,2957
Malawi,2000,sp,3544,831,1113,1944
Malawi,2000,sp,4554,401,585,986
Malawi,2000,sp,5564,148,245,393
Malawi,2000,sp,65,64,114,178
Malawi,2001,sp,014,74,37,111
Malawi,2001,sp,1524,1070,704,1774
Malawi,2001,sp,2534,1520,1486,3006
Malawi,2001,sp,3544,862,1025,1887
Malawi,2001,sp,4554,384,591,975
Malawi,2001,sp,5564,139,230,369
Malawi,2001,sp,65,58,129,187
Malawi,2003,sp,014,76,43,119
Malawi,2003,sp,1524,963,596,1559
Malawi,2003,sp,2534,1531,1374,2905
Malawi,2003,sp,3544,790,936,1726
Malawi,2003,sp,4554,374,489,863
Malawi,2003,sp,5564,155,209,364
Malawi,2003,sp,65,52,128,180
Malawi,2004,sp,014,78,47,125
Malawi,2004,sp,1524,1009,647,1656
Malawi,2004,sp,2534,1694,1505,3199
Malawi,2004,sp,3544,910,1081,1991
Malawi,2004,sp,4554,412,508,920
Malawi,2004,sp,5564,191,264,455
Malawi,2004,sp,65,96,124,220
Malawi,2005,sp,014,84,58,142
Malawi,2005,sp,1524,913,622,1535
Malawi,2005,sp,2534,1598,1653,3251
Malawi,2005,sp,3544,859,1031,1890
Malawi,2005,sp,4554,386,549,935
Malawi,2005,sp,5564,180,279,459
Malawi,2005,sp,65,74,157,231
Malawi,2006,sp,014,80,42,122
Malawi,2006,sp,1524,848,584,1432
Malawi,2006,sp,2534,1545,1647,3192
Malawi,2006,sp,3544,813,1054,1867
Malawi,2006,sp,4554,348,491,839
Malawi,2006,sp,5564,183,256,439
Malawi,2006,sp,65,93,182,275
Malawi,2007,ep,014,0,0,0
Malawi,2007,ep,1524,0,0,0
Malawi,2007,ep,2534,0,0,0
Malawi,2007,ep,3544,0,0,0
Malawi,2007,ep,4554,0,0,0
Malawi,2007,ep,5564,0,0,0
Malawi,2007,ep,65,0,0,0
Malawi,2007,sn,014,0,0,0
Malawi,2007,sn,1524,0,0,0
Malawi,2007,sn,2534,0,0,0
Malawi,2007,sn,3544,0,0,0
Malawi,2007,sn,4554,0,0,0
Malawi,2007,sn,5564,0,0,0
Malawi,2007,sn,65,0,0,0
Malawi,2007,sp,014,109,61,170
Malawi,2007,sp,1524,768,614,1382
Malawi,2007,sp,2534,1497,1454,2951
Malawi,2007,sp,3544,715,954,1669
Malawi,2007,sp,4554,342,473,815
Malawi,2007,sp,5564,146,233,379
Malawi,2007,sp,65,84,158,242
Malawi,2008,sp,014,166,56,222
Malawi,2008,sp,1524,707,570,1277
Malawi,2008,sp,2534,1327,1562,2889
Malawi,2008,sp,3544,727,982,1709
Malawi,2008,sp,4554,365,502,867
Malawi,2008,sp,5564,172,280,452
Malawi,2008,sp,65,89,176,265
Malawi,2009,ep,014,0,0,0
Malawi,2009,ep,1524,0,0,0
Malawi,2009,ep,2534,0,0,0
Malawi,2009,ep,3544,0,0,0
Malawi,2009,ep,4554,0,0,0
Malawi,2009,ep,5564,0,0,0
Malawi,2009,ep,65,0,0,0
Malawi,2009,sn,014,0,0,0
Malawi,2009,sn,1524,0,0,0
Malawi,2009,sn,2534,0,0,0
Malawi,2009,sn,3544,0,0,0
Malawi,2009,sn,4554,0,0,0
Malawi,2009,sn,5564,0,0,0
Malawi,2009,sn,65,0,0,0
Malawi,2009,sp,014,75,53,128
Malawi,2009,sp,1524,691,565,1256
Malawi,2009,sp,2534,1246,1645,2891
Malawi,2009,sp,3544,706,1066,1772
Malawi,2009,sp,4554,318,503,821
Malawi,2009,sp,5564,174,278,452
Malawi,2009,sp,65,104,199,303
Malawi,2010,sp,014,103,50,153
Malawi,2010,sp,1524,610,565,1175
Malawi,2010,sp,2534,1196,1509,2705
Malawi,2010,sp,3544,661,985,1646
Malawi,2010,sp,4554,314,485,799
Malawi,2010,sp,5564,198,275,473
Malawi,2010,sp,65,102,187,289
Malawi,2011,sp,014,79,70,149
Malawi,2011,sp,1524,601,519,1120
Malawi,2011,sp,2534,1119,1486,2605
Malawi,2011,sp,3544,660,1050,1710
Malawi,2011,sp,4554,283,440,723
Malawi,2011,sp,5564,161,238,399
Malawi,2011,sp,65,96,201,297
Malawi,2012,sp,014,71,52,123
Malawi,2012,sp,1524,538,495,1033
Malawi,2012,sp,2534,1057,1537,2594
Malawi,2012,sp,3544,609,1051,1660
Malawi,2012,sp,4554,298,471,769
Malawi,2012,sp,5564,156,292,448
Malawi,2012,sp,65,120,204,324
Malawi,2013,rel,014,850,977,1827
Malawi,2013,rel,1524,1053,1047,2100
Malawi,2013,rel,2534,2219,2950,5169
Malawi,2013,rel,3544,1556,1601,3157
Malawi,2013,rel,4554,833,1348,2181
Malawi,2013,rel,5564,529,752,1281
Malawi,2013,rel,65,395,685,1080
Malaysia,1995,sp,014,58,59,117
Malaysia,1995,sp,1524,446,640,1086
Malaysia,1995,sp,2534,448,879,1327
Malaysia,1995,sp,3544,345,775,1120
Malaysia,1995,sp,4554,316,788,1104
Malaysia,1995,sp,5564,149,374,523
Malaysia,1995,sp,65,339,1072,1411
Malaysia,1996,sp,014,77,45,122
Malaysia,1996,sp,1524,457,720,1177
Malaysia,1996,sp,2534,463,1026,1489
Malaysia,1996,sp,3544,371,894,1265
Malaysia,1996,sp,4554,327,838,1165
Malaysia,1996,sp,5564,242,671,913
Malaysia,1996,sp,65,270,868,1138
Malaysia,1997,sp,014,51,44,95
Malaysia,1997,sp,1524,535,701,1236
Malaysia,1997,sp,2534,485,1036,1521
Malaysia,1997,sp,3544,383,961,1344
Malaysia,1997,sp,4554,338,816,1154
Malaysia,1997,sp,5564,141,380,521
Malaysia,1997,sp,65,343,1123,1466
Malaysia,1998,sp,014,45,31,76
Malaysia,1998,sp,1524,519,670,1189
Malaysia,1998,sp,2534,526,1090,1616
Malaysia,1998,sp,3544,398,1050,1448
Malaysia,1998,sp,4554,330,872,1202
Malaysia,1998,sp,5564,157,426,583
Malaysia,1998,sp,65,406,1282,1688
Malaysia,1999,sp,014,32,27,59
Malaysia,1999,sp,1524,513,692,1205
Malaysia,1999,sp,2534,558,1147,1705
Malaysia,1999,sp,3544,422,1152,1574
Malaysia,1999,sp,4554,351,977,1328
Malaysia,1999,sp,5564,286,902,1188
Malaysia,1999,sp,65,268,880,1148
Malaysia,2000,sp,014,41,32,73
Malaysia,2000,sp,1524,464,694,1158
Malaysia,2000,sp,2534,564,1138,1702
Malaysia,2000,sp,3544,424,1177,1601
Malaysia,2000,sp,4554,367,908,1275
Malaysia,2000,sp,5564,356,814,1170
Malaysia,2000,sp,65,286,891,1177
Malaysia,2001,sp,014,36,48,84
Malaysia,2001,sp,1524,510,713,1223
Malaysia,2001,sp,2534,506,1198,1704
Malaysia,2001,sp,3544,445,1221,1666
Malaysia,2001,sp,4554,374,1011,1385
Malaysia,2001,sp,5564,353,934,1287
Malaysia,2001,sp,65,222,738,960
Malaysia,2002,sp,014,30,22,52
Malaysia,2002,sp,1524,421,562,983
Malaysia,2002,sp,2534,524,1106,1630
Malaysia,2002,sp,3544,415,1182,1597
Malaysia,2002,sp,4554,485,997,1482
Malaysia,2002,sp,5564,319,758,1077
Malaysia,2002,sp,65,293,844,1137
Malaysia,2003,sp,014,196,216,412
Malaysia,2003,sp,1524,969,1211,2180
Malaysia,2003,sp,2534,1044,2010,3054
Malaysia,2003,sp,3544,857,2073,2930
Malaysia,2003,sp,4554,669,1798,2467
Malaysia,2003,sp,5564,584,1438,2022
Malaysia,2003,sp,65,626,1601,2227
Malaysia,2004,sp,014,227,191,418
Malaysia,2004,sp,1524,925,1195,2120
Malaysia,2004,sp,2534,1014,2105,3119
Malaysia,2004,sp,3544,852,2189,3041
Malaysia,2004,sp,4554,694,1890,2584
Malaysia,2004,sp,5564,605,1440,2045
Malaysia,2004,sp,65,532,1535,2067
Malaysia,2005,sp,014,208,244,452
Malaysia,2005,sp,1524,1044,1179,2223
Malaysia,2005,sp,2534,1061,2218,3279
Malaysia,2005,sp,3544,947,2277,3224
Malaysia,2005,sp,4554,816,1980,2796
Malaysia,2005,sp,5564,586,1427,2013
Malaysia,2005,sp,65,572,1507,2079
Malaysia,2006,ep,014,18,42,60
Malaysia,2006,ep,1524,78,104,182
Malaysia,2006,ep,2534,79,100,179
Malaysia,2006,ep,3544,49,78,127
Malaysia,2006,ep,4554,40,85,125
Malaysia,2006,ep,5564,46,57,103
Malaysia,2006,ep,65,48,65,113
Malaysia,2006,sn,014,30,63,93
Malaysia,2006,sn,1524,72,122,194
Malaysia,2006,sn,2534,80,130,210
Malaysia,2006,sn,3544,118,181,299
Malaysia,2006,sn,4554,102,175,277
Malaysia,2006,sn,5564,67,132,199
Malaysia,2006,sn,65,52,108,160
Malaysia,2006,sp,014,3,15,18
Malaysia,2006,sp,1524,30,507,537
Malaysia,2006,sp,2534,300,855,1155
Malaysia,2006,sp,3544,403,734,1137
Malaysia,2006,sp,4554,321,678,999
Malaysia,2006,sp,5564,257,443,700
Malaysia,2006,sp,65,161,496,657
Malaysia,2007,sp,014,226,216,442
Malaysia,2007,sp,1524,1098,1291,2389
Malaysia,2007,sp,2534,1101,2224,3325
Malaysia,2007,sp,3544,849,2082,2931
Malaysia,2007,sp,4554,782,1839,2621
Malaysia,2007,sp,5564,585,1394,1979
Malaysia,2007,sp,65,514,1395,1909
Malaysia,2008,sp,014,240,221,461
Malaysia,2008,sp,1524,1161,1436,2597
Malaysia,2008,sp,2534,1283,2445,3728
Malaysia,2008,sp,3544,906,2318,3224
Malaysia,2008,sp,4554,878,2169,3047
Malaysia,2008,sp,5564,648,1599,2247
Malaysia,2008,sp,65,657,1543,2200
Malaysia,2010,ep,014,31,44,75
Malaysia,2010,ep,1524,205,212,417
Malaysia,2010,ep,2534,147,294,441
Malaysia,2010,ep,3544,96,323,419
Malaysia,2010,ep,4554,128,358,486
Malaysia,2010,ep,5564,108,255,363
Malaysia,2010,ep,65,99,245,344
Malaysia,2010,sn,014,52,35,87
Malaysia,2010,sn,1524,245,282,527
Malaysia,2010,sn,2534,389,653,1042
Malaysia,2010,sn,3544,295,708,1003
Malaysia,2010,sn,4554,181,440,621
Malaysia,2010,sn,5564,172,370,542
Malaysia,2010,sn,65,149,367,516
Malaysia,2010,sp,014,152,129,281
Malaysia,2010,sp,1524,704,884,1588
Malaysia,2010,sp,2534,881,1438,2319
Malaysia,2010,sp,3544,592,1599,2191
Malaysia,2010,sp,4554,542,1453,1995
Malaysia,2010,sp,5564,425,967,1392
Malaysia,2010,sp,65,388,981,1369
Malaysia,2011,ep,014,90,97,187
Malaysia,2011,ep,1524,246,205,451
Malaysia,2011,ep,2534,299,393,692
Malaysia,2011,ep,3544,195,354,549
Malaysia,2011,ep,4554,148,267,415
Malaysia,2011,ep,5564,132,222,354
Malaysia,2011,ep,65,93,147,240
Malaysia,2011,sn,014,103,110,213
Malaysia,2011,sn,1524,299,338,637
Malaysia,2011,sn,2534,317,553,870
Malaysia,2011,sn,3544,200,541,741
Malaysia,2011,sn,4554,221,519,740
Malaysia,2011,sn,5564,188,448,636
Malaysia,2011,sn,65,193,471,664
Malaysia,2011,sp,014,77,63,140
Malaysia,2011,sp,1524,837,948,1785
Malaysia,2011,sp,2534,876,1564,2440
Malaysia,2011,sp,3544,584,1559,2143
Malaysia,2011,sp,4554,599,1594,2193
Malaysia,2011,sp,5564,459,1245,1704
Malaysia,2011,sp,65,403,1054,1457
Malaysia,2012,ep,014,96,96,192
Malaysia,2012,ep,1524,242,243,485
Malaysia,2012,ep,2534,306,376,682
Malaysia,2012,ep,3544,173,369,542
Malaysia,2012,ep,4554,168,270,438
Malaysia,2012,ep,5564,129,207,336
Malaysia,2012,ep,65,106,164,270
Malaysia,2012,sn,014,142,174,316
Malaysia,2012,sn,1524,318,371,689
Malaysia,2012,sn,2534,362,644,1006
Malaysia,2012,sn,3544,241,520,761
Malaysia,2012,sn,4554,220,504,724
Malaysia,2012,sn,5564,217,506,723
Malaysia,2012,sn,65,204,570,774
Malaysia,2012,sp,014,105,74,179
Malaysia,2012,sp,1524,903,1060,1963
Malaysia,2012,sp,2534,1010,1575,2585
Malaysia,2012,sp,3544,710,1677,2387
Malaysia,2012,sp,4554,693,1762,2455
Malaysia,2012,sp,5564,590,1409,1999
Malaysia,2012,sp,65,483,1260,1743
Malaysia,2013,rel,014,335,309,644
Malaysia,2013,rel,1524,1718,1871,3589
Malaysia,2013,rel,2534,1798,2756,4554
Malaysia,2013,rel,3544,1228,2737,3965
Malaysia,2013,rel,4554,1179,2850,4029
Malaysia,2013,rel,5564,1060,2347,3407
Malaysia,2013,rel,65,989,2158,3147
Maldives,1995,sp,014,1,1,2
Maldives,1995,sp,1524,13,28,41
Maldives,1995,sp,2534,8,11,19
Maldives,1995,sp,3544,4,10,14
Maldives,1995,sp,4554,6,8,14
Maldives,1995,sp,5564,6,10,16
Maldives,1995,sp,65,2,6,8
Maldives,1996,sp,014,1,0,1
Maldives,1996,sp,1524,12,24,36
Maldives,1996,sp,2534,9,9,18
Maldives,1996,sp,3544,5,3,8
Maldives,1996,sp,4554,6,5,11
Maldives,1996,sp,5564,5,14,19
Maldives,1996,sp,65,5,8,13
Maldives,1997,sp,014,3,1,4
Maldives,1997,sp,1524,15,13,28
Maldives,1997,sp,2534,8,6,14
Maldives,1997,sp,3544,9,2,11
Maldives,1997,sp,4554,4,13,17
Maldives,1997,sp,5564,3,9,12
Maldives,1997,sp,65,0,8,8
Maldives,1998,sp,014,1,1,2
Maldives,1998,sp,1524,13,19,32
Maldives,1998,sp,2534,5,18,23
Maldives,1998,sp,3544,1,8,9
Maldives,1998,sp,4554,6,4,10
Maldives,1998,sp,5564,4,6,10
Maldives,1998,sp,65,0,2,2
Maldives,1999,sp,014,3,0,3
Maldives,1999,sp,1524,10,14,24
Maldives,1999,sp,2534,6,8,14
Maldives,1999,sp,3544,3,9,12
Maldives,1999,sp,4554,6,7,13
Maldives,1999,sp,5564,6,7,13
Maldives,1999,sp,65,1,8,9
Maldives,2000,sp,014,0,0,0
Maldives,2000,sp,1524,11,9,20
Maldives,2000,sp,2534,4,10,14
Maldives,2000,sp,3544,5,2,7
Maldives,2000,sp,4554,4,5,9
Maldives,2000,sp,5564,5,5,10
Maldives,2000,sp,65,2,3,5
Maldives,2001,sp,014,1,1,2
Maldives,2001,sp,1524,10,12,22
Maldives,2001,sp,2534,3,5,8
Maldives,2001,sp,3544,2,3,5
Maldives,2001,sp,4554,6,5,11
Maldives,2001,sp,5564,1,7,8
Maldives,2001,sp,65,2,1,3
Maldives,2002,sp,014,1,0,1
Maldives,2002,sp,1524,8,11,19
Maldives,2002,sp,2534,5,9,14
Maldives,2002,sp,3544,4,0,4
Maldives,2002,sp,4554,5,1,6
Maldives,2002,sp,5564,1,5,6
Maldives,2002,sp,65,2,8,10
Maldives,2003,sp,014,0,1,1
Maldives,2003,sp,1524,8,14,22
Maldives,2003,sp,2534,5,7,12
Maldives,2003,sp,3544,1,4,5
Maldives,2003,sp,4554,5,9,14
Maldives,2003,sp,5564,1,9,10
Maldives,2003,sp,65,0,4,4
Maldives,2004,sp,014,0,0,0
Maldives,2004,sp,1524,8,13,21
Maldives,2004,sp,2534,3,11,14
Maldives,2004,sp,3544,2,3,5
Maldives,2004,sp,4554,1,8,9
Maldives,2004,sp,5564,2,5,7
Maldives,2004,sp,65,4,6,10
Maldives,2005,sp,014,1,0,1
Maldives,2005,sp,1524,10,9,19
Maldives,2005,sp,2534,7,8,15
Maldives,2005,sp,3544,1,5,6
Maldives,2005,sp,4554,2,6,8
Maldives,2005,sp,5564,2,6,8
Maldives,2005,sp,65,4,5,9
Maldives,2006,ep,014,2,3,5
Maldives,2006,ep,1524,4,6,10
Maldives,2006,ep,2534,1,1,2
Maldives,2006,ep,3544,4,1,5
Maldives,2006,ep,4554,3,0,3
Maldives,2006,ep,5564,0,0,0
Maldives,2006,ep,65,0,1,1
Maldives,2006,sn,014,1,1,2
Maldives,2006,sn,1524,2,1,3
Maldives,2006,sn,2534,1,0,1
Maldives,2006,sn,3544,2,2,4
Maldives,2006,sn,4554,0,0,0
Maldives,2006,sn,5564,2,2,4
Maldives,2006,sn,65,1,1,2
Maldives,2006,sp,014,0,0,0
Maldives,2006,sp,1524,6,8,14
Maldives,2006,sp,2534,3,9,12
Maldives,2006,sp,3544,4,3,7
Maldives,2006,sp,4554,3,4,7
Maldives,2006,sp,5564,2,3,5
Maldives,2006,sp,65,2,6,8
Maldives,2007,ep,014,3,4,7
Maldives,2007,ep,1524,3,1,4
Maldives,2007,ep,2534,4,4,8
Maldives,2007,ep,3544,2,2,4
Maldives,2007,ep,4554,2,0,2
Maldives,2007,ep,5564,0,2,2
Maldives,2007,ep,65,1,1,2
Maldives,2007,sn,014,4,2,6
Maldives,2007,sn,1524,2,4,6
Maldives,2007,sn,2534,3,3,6
Maldives,2007,sn,3544,3,3,6
Maldives,2007,sn,4554,2,4,6
Maldives,2007,sn,5564,3,2,5
Maldives,2007,sn,65,2,1,3
Maldives,2007,sp,014,1,0,1
Maldives,2007,sp,1524,5,14,19
Maldives,2007,sp,2534,2,4,6
Maldives,2007,sp,3544,5,6,11
Maldives,2007,sp,4554,5,5,10
Maldives,2007,sp,5564,0,6,6
Maldives,2007,sp,65,1,5,6
Maldives,2008,ep,014,1,2,3
Maldives,2008,ep,1524,1,3,4
Maldives,2008,ep,2534,3,6,9
Maldives,2008,ep,3544,2,1,3
Maldives,2008,ep,4554,0,5,5
Maldives,2008,ep,5564,1,3,4
Maldives,2008,ep,65,2,3,5
Maldives,2008,sn,014,1,1,2
Maldives,2008,sn,1524,0,3,3
Maldives,2008,sn,2534,2,5,7
Maldives,2008,sn,3544,3,2,5
Maldives,2008,sn,4554,1,2,3
Maldives,2008,sn,5564,3,3,6
Maldives,2008,sn,65,1,5,6
Maldives,2008,sp,1524,7,9,16
Maldives,2008,sp,2534,1,11,12
Maldives,2008,sp,3544,3,3,6
Maldives,2008,sp,4554,NA,5,NA
Maldives,2008,sp,5564,3,6,9
Maldives,2008,sp,65,2,3,5
Maldives,2009,ep,014,3,NA,NA
Maldives,2009,ep,1524,3,2,5
Maldives,2009,ep,2534,10,7,17
Maldives,2009,ep,3544,3,4,7
Maldives,2009,ep,4554,1,1,2
Maldives,2009,ep,5564,1,3,4
Maldives,2009,ep,65,NA,3,NA
Maldives,2009,sn,014,NA,3,NA
Maldives,2009,sn,1524,1,1,2
Maldives,2009,sn,4554,NA,2,NA
Maldives,2009,sn,5564,1,1,2
Maldives,2009,sn,65,3,1,4
Maldives,2009,sp,014,0,0,0
Maldives,2009,sp,1524,4,16,20
Maldives,2009,sp,2534,4,5,9
Maldives,2009,sp,3544,2,1,3
Maldives,2009,sp,4554,2,4,6
Maldives,2009,sp,5564,2,0,2
Maldives,2009,sp,65,0,5,5
Maldives,2010,ep,014,3,5,8
Maldives,2010,ep,1524,4,3,7
Maldives,2010,ep,2534,3,4,7
Maldives,2010,ep,3544,2,6,8
Maldives,2010,ep,4554,2,0,2
Maldives,2010,ep,5564,1,0,1
Maldives,2010,ep,65,1,0,1
Maldives,2010,sn,014,1,1,2
Maldives,2010,sn,1524,1,1,2
Maldives,2010,sn,2534,0,2,2
Maldives,2010,sn,3544,1,2,3
Maldives,2010,sn,4554,1,2,3
Maldives,2010,sn,5564,3,0,3
Maldives,2010,sn,65,0,6,6
Maldives,2010,sp,014,1,0,1
Maldives,2010,sp,1524,2,8,10
Maldives,2010,sp,2534,3,6,9
Maldives,2010,sp,3544,4,0,4
Maldives,2010,sp,4554,1,4,5
Maldives,2010,sp,5564,0,5,5
Maldives,2010,sp,65,1,6,7
Maldives,2011,ep,014,1,3,4
Maldives,2011,ep,1524,2,3,5
Maldives,2011,ep,2534,4,2,6
Maldives,2011,ep,3544,0,1,1
Maldives,2011,ep,4554,2,3,5
Maldives,2011,ep,5564,3,1,4
Maldives,2011,ep,65,1,2,3
Maldives,2011,sn,014,1,0,1
Maldives,2011,sn,1524,0,4,4
Maldives,2011,sn,2534,2,1,3
Maldives,2011,sn,3544,0,1,1
Maldives,2011,sn,4554,0,0,0
Maldives,2011,sn,5564,2,0,2
Maldives,2011,sn,65,0,1,1
Maldives,2011,sp,014,0,0,0
Maldives,2011,sp,1524,4,12,16
Maldives,2011,sp,2534,3,7,10
Maldives,2011,sp,3544,1,3,4
Maldives,2011,sp,4554,2,8,10
Maldives,2011,sp,5564,1,1,2
Maldives,2011,sp,65,2,3,5
Maldives,2012,ep,014,4,1,5
Maldives,2012,ep,1524,3,2,5
Maldives,2012,ep,2534,8,4,12
Maldives,2012,ep,3544,4,0,4
Maldives,2012,ep,4554,0,2,2
Maldives,2012,ep,5564,4,3,7
Maldives,2012,ep,65,4,2,6
Maldives,2012,sn,014,2,3,5
Maldives,2012,sn,1524,0,0,0
Maldives,2012,sn,2534,0,1,1
Maldives,2012,sn,3544,1,2,3
Maldives,2012,sn,4554,0,3,3
Maldives,2012,sn,5564,1,0,1
Maldives,2012,sn,65,1,3,4
Maldives,2012,sp,014,0,0,0
Maldives,2012,sp,1524,7,8,15
Maldives,2012,sp,2534,6,6,12
Maldives,2012,sp,3544,3,2,5
Maldives,2012,sp,4554,3,4,7
Maldives,2012,sp,5564,2,5,7
Maldives,2012,sp,65,2,4,6
Maldives,2013,rel,014,6,4,10
Maldives,2013,rel,1524,11,20,31
Maldives,2013,rel,2534,8,20,28
Maldives,2013,rel,3544,4,4,8
Maldives,2013,rel,4554,7,9,16
Maldives,2013,rel,5564,4,9,13
Maldives,2013,rel,65,3,5,8
Mali,1995,sp,014,31,27,58
Mali,1995,sp,1524,132,72,204
Mali,1995,sp,2534,184,357,541
Mali,1995,sp,3544,128,294,422
Mali,1995,sp,4554,107,181,288
Mali,1995,sp,5564,61,138,199
Mali,1995,sp,65,52,102,154
Mali,1996,sp,014,21,19,40
Mali,1996,sp,1524,153,182,335
Mali,1996,sp,2534,197,408,605
Mali,1996,sp,3544,128,364,492
Mali,1996,sp,4554,95,226,321
Mali,1996,sp,5564,51,157,208
Mali,1996,sp,65,36,136,172
Mali,1997,sp,014,15,16,31
Mali,1997,sp,1524,178,226,404
Mali,1997,sp,2534,264,559,823
Mali,1997,sp,3544,167,493,660
Mali,1997,sp,4554,111,357,468
Mali,1997,sp,5564,60,255,315
Mali,1997,sp,65,34,164,198
Mali,1998,sp,014,11,13,24
Mali,1998,sp,1524,173,193,366
Mali,1998,sp,2534,237,501,738
Mali,1998,sp,3544,164,428,592
Mali,1998,sp,4554,88,308,396
Mali,1998,sp,5564,79,205,284
Mali,1998,sp,65,30,130,160
Mali,1999,sp,014,21,19,40
Mali,1999,sp,1524,180,235,415
Mali,1999,sp,2534,226,475,701
Mali,1999,sp,3544,171,429,600
Mali,1999,sp,4554,120,315,435
Mali,1999,sp,5564,96,216,312
Mali,1999,sp,65,58,129,187
Mali,2000,sp,014,14,23,37
Mali,2000,sp,1524,174,206,380
Mali,2000,sp,2534,232,430,662
Mali,2000,sp,3544,152,396,548
Mali,2000,sp,4554,106,297,403
Mali,2000,sp,5564,75,235,310
Mali,2000,sp,65,43,144,187
Mali,2002,sp,014,39,20,59
Mali,2002,sp,1524,141,209,350
Mali,2002,sp,2534,250,547,797
Mali,2002,sp,3544,166,447,613
Mali,2002,sp,4554,190,430,620
Mali,2002,sp,5564,71,151,222
Mali,2002,sp,65,24,72,96
Mali,2003,sp,014,29,32,61
Mali,2003,sp,1524,172,348,520
Mali,2003,sp,2534,278,619,897
Mali,2003,sp,3544,212,438,650
Mali,2003,sp,4554,123,330,453
Mali,2003,sp,5564,73,201,274
Mali,2003,sp,65,45,115,160
Mali,2004,sp,014,29,28,57
Mali,2004,sp,1524,191,302,493
Mali,2004,sp,2534,284,584,868
Mali,2004,sp,3544,183,473,656
Mali,2004,sp,4554,151,316,467
Mali,2004,sp,5564,105,219,324
Mali,2004,sp,65,57,147,204
Mali,2005,sp,014,33,26,59
Mali,2005,sp,1524,208,350,558
Mali,2005,sp,2534,348,628,976
Mali,2005,sp,3544,245,539,784
Mali,2005,sp,4554,152,365,517
Mali,2005,sp,5564,101,263,364
Mali,2005,sp,65,72,193,265
Mali,2006,ep,014,NA,580,NA
Mali,2006,sn,014,NA,16,NA
Mali,2006,sn,1524,NA,370,NA
Mali,2006,sp,014,30,28,58
Mali,2006,sp,1524,250,361,611
Mali,2006,sp,2534,371,679,1050
Mali,2006,sp,3544,249,550,799
Mali,2006,sp,4554,168,436,604
Mali,2006,sp,5564,116,272,388
Mali,2006,sp,65,76,216,292
Mali,2007,ep,1524,NA,668,NA
Mali,2007,sn,014,NA,15,NA
Mali,2007,sn,1524,NA,376,NA
Mali,2007,sp,014,30,29,59
Mali,2007,sp,1524,263,369,632
Mali,2007,sp,2534,385,696,1081
Mali,2007,sp,3544,258,570,828
Mali,2007,sp,4554,160,422,582
Mali,2007,sp,5564,113,291,404
Mali,2007,sp,65,95,213,308
Mali,2008,ep,014,23,55,78
Mali,2008,sn,014,7,14,21
Mali,2008,sp,014,37,22,59
Mali,2008,sp,1524,332,453,785
Mali,2008,sp,2534,516,809,1325
Mali,2008,sp,3544,320,640,960
Mali,2008,sp,4554,245,503,748
Mali,2008,sp,5564,172,314,486
Mali,2008,sp,65,121,250,371
Mali,2009,sp,014,44,37,81
Mali,2009,sp,1524,365,489,854
Mali,2009,sp,2534,494,978,1472
Mali,2009,sp,3544,384,758,1142
Mali,2009,sp,4554,211,510,721
Mali,2009,sp,5564,135,379,514
Mali,2009,sp,65,104,275,379
Mali,2010,sp,014,31,94,125
Mali,2010,sp,1524,265,381,646
Mali,2010,sp,2534,337,707,1044
Mali,2010,sp,3544,247,526,773
Mali,2010,sp,4554,144,354,498
Mali,2010,sp,5564,96,227,323
Mali,2010,sp,65,70,207,277
Mali,2011,sp,014,42,25,67
Mali,2011,sp,1524,255,370,625
Mali,2011,sp,2534,393,772,1165
Mali,2011,sp,3544,223,515,738
Mali,2011,sp,4554,147,352,499
Mali,2011,sp,5564,118,267,385
Mali,2011,sp,65,68,230,298
Mali,2012,sp,014,34,25,59
Mali,2012,sp,1524,253,405,658
Mali,2012,sp,2534,344,731,1075
Mali,2012,sp,3544,239,547,786
Mali,2012,sp,4554,137,377,514
Mali,2012,sp,5564,89,257,346
Mali,2012,sp,65,77,211,288
Mali,2013,rel,014,27,26,53
Mali,2013,rel,1524,284,375,659
Mali,2013,rel,2534,351,750,1101
Mali,2013,rel,3544,266,551,817
Mali,2013,rel,4554,144,401,545
Mali,2013,rel,5564,95,244,339
Mali,2013,rel,65,74,230,304
Malta,1995,sp,014,0,0,0
Malta,1995,sp,1524,0,0,0
Malta,1995,sp,2534,1,0,1
Malta,1995,sp,3544,0,1,1
Malta,1995,sp,4554,0,0,0
Malta,1995,sp,5564,1,0,1
Malta,1995,sp,65,2,0,2
Malta,1996,sp,014,0,0,0
Malta,1996,sp,1524,0,0,0
Malta,1996,sp,2534,0,0,0
Malta,1996,sp,3544,1,0,1
Malta,1996,sp,4554,0,1,1
Malta,1996,sp,5564,0,2,2
Malta,1996,sp,65,0,1,1
Malta,1997,sp,014,0,0,0
Malta,1997,sp,1524,0,1,1
Malta,1997,sp,2534,0,0,0
Malta,1997,sp,3544,0,0,0
Malta,1997,sp,4554,0,0,0
Malta,1997,sp,5564,0,0,0
Malta,1997,sp,65,1,1,2
Malta,1998,sp,014,0,0,0
Malta,1998,sp,1524,1,1,2
Malta,1998,sp,2534,0,0,0
Malta,1998,sp,3544,0,0,0
Malta,1998,sp,4554,0,1,1
Malta,1998,sp,5564,0,0,0
Malta,1998,sp,65,0,3,3
Malta,1999,sp,014,NA,0,NA
Malta,1999,sp,1524,NA,0,NA
Malta,1999,sp,2534,NA,1,NA
Malta,1999,sp,3544,NA,0,NA
Malta,1999,sp,4554,NA,0,NA
Malta,1999,sp,5564,NA,5,NA
Malta,1999,sp,65,NA,3,NA
Malta,2000,sp,014,NA,0,NA
Malta,2000,sp,1524,NA,1,NA
Malta,2000,sp,2534,NA,0,NA
Malta,2000,sp,3544,NA,1,NA
Malta,2000,sp,4554,NA,1,NA
Malta,2000,sp,5564,NA,0,NA
Malta,2000,sp,65,NA,1,NA
Malta,2001,sp,014,0,0,0
Malta,2001,sp,3544,1,NA,NA
Malta,2001,sp,4554,NA,1,NA
Malta,2001,sp,65,NA,1,NA
Malta,2002,sp,014,0,0,0
Malta,2002,sp,1524,0,1,1
Malta,2002,sp,2534,1,0,1
Malta,2002,sp,3544,0,1,1
Malta,2002,sp,4554,0,0,0
Malta,2002,sp,5564,0,1,1
Malta,2002,sp,65,1,0,1
Malta,2003,sp,014,0,0,0
Malta,2003,sp,1524,0,0,0
Malta,2003,sp,2534,0,1,1
Malta,2003,sp,3544,0,0,0
Malta,2003,sp,4554,0,1,1
Malta,2003,sp,5564,0,0,0
Malta,2003,sp,65,0,0,0
Malta,2004,sp,014,0,0,0
Malta,2004,sp,1524,0,0,0
Malta,2004,sp,2534,0,0,0
Malta,2004,sp,3544,0,0,0
Malta,2004,sp,4554,1,1,2
Malta,2004,sp,5564,0,0,0
Malta,2004,sp,65,0,0,0
Malta,2005,sp,014,0,0,0
Malta,2005,sp,1524,0,1,1
Malta,2005,sp,2534,0,1,1
Malta,2005,sp,3544,0,1,1
Malta,2005,sp,4554,0,1,1
Malta,2005,sp,5564,0,1,1
Malta,2005,sp,65,0,0,0
Malta,2006,ep,014,0,0,0
Malta,2006,ep,1524,0,1,1
Malta,2006,ep,2534,1,2,3
Malta,2006,ep,3544,0,0,0
Malta,2006,ep,4554,0,0,0
Malta,2006,ep,5564,0,0,0
Malta,2006,ep,65,2,0,2
Malta,2006,sn,014,1,0,1
Malta,2006,sn,1524,0,6,6
Malta,2006,sn,2534,0,4,4
Malta,2006,sn,3544,0,1,1
Malta,2006,sn,4554,0,2,2
Malta,2006,sn,5564,0,1,1
Malta,2006,sn,65,0,5,5
Malta,2006,sp,014,0,0,0
Malta,2006,sp,1524,0,1,1
Malta,2006,sp,2534,0,0,0
Malta,2006,sp,3544,0,2,2
Malta,2006,sp,4554,0,0,0
Malta,2006,sp,5564,0,0,0
Malta,2006,sp,65,0,1,1
Malta,2007,ep,014,1,1,2
Malta,2007,ep,1524,1,3,4
Malta,2007,ep,2534,0,2,2
Malta,2007,ep,3544,0,2,2
Malta,2007,ep,4554,0,0,0
Malta,2007,ep,5564,0,1,1
Malta,2007,ep,65,0,0,0
Malta,2007,sn,014,0,0,0
Malta,2007,sn,1524,0,3,3
Malta,2007,sn,2534,0,5,5
Malta,2007,sn,3544,0,0,0
Malta,2007,sn,4554,0,1,1
Malta,2007,sn,5564,1,2,3
Malta,2007,sn,65,0,6,6
Malta,2007,sp,014,0,0,0
Malta,2007,sp,1524,2,0,2
Malta,2007,sp,2534,0,2,2
Malta,2007,sp,3544,0,0,0
Malta,2007,sp,4554,0,0,0
Malta,2007,sp,5564,0,1,1
Malta,2007,sp,65,0,3,3
Malta,2008,ep,014,0,0,0
Malta,2008,ep,1524,1,2,3
Malta,2008,ep,2534,2,3,5
Malta,2008,ep,3544,0,1,1
Malta,2008,ep,4554,1,1,2
Malta,2008,ep,5564,0,0,0
Malta,2008,ep,65,0,1,1
Malta,2008,sn,014,0,0,0
Malta,2008,sn,1524,0,7,7
Malta,2008,sn,2534,0,4,4
Malta,2008,sn,3544,0,2,2
Malta,2008,sn,4554,1,1,2
Malta,2008,sn,5564,0,0,0
Malta,2008,sn,65,1,3,4
Malta,2008,sp,014,0,0,0
Malta,2008,sp,1524,1,3,4
Malta,2008,sp,2534,1,6,7
Malta,2008,sp,3544,0,2,2
Malta,2008,sp,4554,0,0,0
Malta,2008,sp,5564,0,0,0
Malta,2008,sp,65,2,0,2
Malta,2009,ep,014,0,0,0
Malta,2009,ep,1524,3,4,7
Malta,2009,ep,2534,3,3,6
Malta,2009,ep,3544,1,0,1
Malta,2009,ep,4554,0,1,1
Malta,2009,ep,5564,0,0,0
Malta,2009,ep,65,0,3,3
Malta,2009,sn,014,0,0,0
Malta,2009,sn,1524,0,4,4
Malta,2009,sn,2534,1,4,5
Malta,2009,sn,3544,0,0,0
Malta,2009,sn,4554,0,0,0
Malta,2009,sn,5564,0,1,1
Malta,2009,sn,65,1,0,1
Malta,2009,sp,014,0,0,0
Malta,2009,sp,1524,0,4,4
Malta,2009,sp,2534,1,3,4
Malta,2009,sp,3544,0,1,1
Malta,2009,sp,4554,0,1,1
Malta,2009,sp,5564,0,1,1
Malta,2009,sp,65,0,1,1
Malta,2010,ep,014,0,0,0
Malta,2010,ep,1524,0,1,1
Malta,2010,ep,2534,2,5,7
Malta,2010,ep,3544,0,0,0
Malta,2010,ep,4554,0,0,0
Malta,2010,ep,5564,0,1,1
Malta,2010,ep,65,1,0,1
Malta,2010,sn,014,0,0,0
Malta,2010,sn,1524,1,1,2
Malta,2010,sn,2534,0,1,1
Malta,2010,sn,3544,0,1,1
Malta,2010,sn,4554,0,1,1
Malta,2010,sn,5564,0,0,0
Malta,2010,sn,65,0,1,1
Malta,2010,sp,014,0,0,0
Malta,2010,sp,1524,0,0,0
Malta,2010,sp,2534,1,3,4
Malta,2010,sp,3544,0,0,0
Malta,2010,sp,4554,0,0,0
Malta,2010,sp,5564,0,0,0
Malta,2010,sp,65,0,0,0
Malta,2011,ep,014,0,0,0
Malta,2011,ep,1524,0,1,1
Malta,2011,ep,2534,1,0,1
Malta,2011,ep,3544,0,1,1
Malta,2011,ep,4554,2,0,2
Malta,2011,ep,5564,0,0,0
Malta,2011,ep,65,1,1,2
Malta,2011,sn,014,0,0,0
Malta,2011,sn,1524,1,1,2
Malta,2011,sn,2534,0,3,3
Malta,2011,sn,3544,1,0,1
Malta,2011,sn,4554,0,0,0
Malta,2011,sn,5564,0,0,0
Malta,2011,sn,65,0,2,2
Malta,2011,sp,014,0,0,0
Malta,2011,sp,1524,1,2,3
Malta,2011,sp,2534,0,4,4
Malta,2011,sp,3544,0,0,0
Malta,2011,sp,4554,0,0,0
Malta,2011,sp,5564,0,0,0
Malta,2011,sp,65,0,0,0
Malta,2012,ep,014,0,0,0
Malta,2012,ep,1524,4,3,7
Malta,2012,ep,2534,0,3,3
Malta,2012,ep,3544,1,0,1
Malta,2012,ep,4554,0,0,0
Malta,2012,ep,5564,0,1,1
Malta,2012,ep,65,0,0,0
Malta,2012,sn,014,1,0,1
Malta,2012,sn,1524,2,5,7
Malta,2012,sn,2534,1,4,5
Malta,2012,sn,3544,0,1,1
Malta,2012,sn,4554,0,1,1
Malta,2012,sn,5564,0,0,0
Malta,2012,sn,65,0,5,5
Malta,2012,sp,014,0,1,1
Malta,2012,sp,1524,1,2,3
Malta,2012,sp,2534,1,2,3
Malta,2012,sp,3544,0,2,2
Malta,2012,sp,4554,0,0,0
Malta,2012,sp,5564,0,0,0
Malta,2012,sp,65,0,0,0
Malta,2013,rel,014,0,0,0
Malta,2013,rel,1524,2,22,24
Malta,2013,rel,2534,8,6,14
Malta,2013,rel,3544,1,4,5
Malta,2013,rel,4554,0,0,0
Malta,2013,rel,5564,0,0,0
Malta,2013,rel,65,4,3,7
Marshall Islands,1996,sp,014,12,7,19
Marshall Islands,1996,sp,1524,7,8,15
Marshall Islands,1996,sp,2534,3,3,6
Marshall Islands,1996,sp,3544,3,3,6
Marshall Islands,1996,sp,4554,2,5,7
Marshall Islands,1996,sp,5564,3,3,6
Marshall Islands,1996,sp,65,2,0,2
Marshall Islands,1998,sp,014,0,0,0
Marshall Islands,1998,sp,1524,1,2,3
Marshall Islands,1998,sp,2534,3,0,3
Marshall Islands,1998,sp,3544,1,1,2
Marshall Islands,1998,sp,4554,0,1,1
Marshall Islands,1998,sp,5564,1,1,2
Marshall Islands,1998,sp,65,0,0,0
Marshall Islands,1999,sp,014,2,5,7
Marshall Islands,1999,sp,1524,10,10,20
Marshall Islands,1999,sp,2534,7,3,10
Marshall Islands,1999,sp,3544,2,4,6
Marshall Islands,1999,sp,4554,2,1,3
Marshall Islands,1999,sp,5564,2,6,8
Marshall Islands,1999,sp,65,0,0,0
Marshall Islands,2000,sp,014,7,3,10
Marshall Islands,2000,sp,1524,7,5,12
Marshall Islands,2000,sp,2534,3,4,7
Marshall Islands,2000,sp,3544,0,1,1
Marshall Islands,2000,sp,4554,2,3,5
Marshall Islands,2000,sp,5564,2,5,7
Marshall Islands,2000,sp,65,0,3,3
Marshall Islands,2001,sp,014,5,3,8
Marshall Islands,2001,sp,1524,6,8,14
Marshall Islands,2001,sp,2534,4,4,8
Marshall Islands,2001,sp,3544,7,2,9
Marshall Islands,2001,sp,4554,8,4,12
Marshall Islands,2001,sp,5564,2,2,4
Marshall Islands,2001,sp,65,1,0,1
Marshall Islands,2002,sp,014,0,0,0
Marshall Islands,2002,sp,1524,2,1,3
Marshall Islands,2002,sp,2534,0,2,2
Marshall Islands,2002,sp,3544,0,1,1
Marshall Islands,2002,sp,4554,3,3,6
Marshall Islands,2002,sp,5564,1,2,3
Marshall Islands,2002,sp,65,1,2,3
Marshall Islands,2003,sp,014,4,6,10
Marshall Islands,2003,sp,1524,9,4,13
Marshall Islands,2003,sp,2534,2,2,4
Marshall Islands,2003,sp,3544,4,7,11
Marshall Islands,2003,sp,4554,6,7,13
Marshall Islands,2003,sp,5564,1,2,3
Marshall Islands,2003,sp,65,4,2,6
Marshall Islands,2004,sp,014,1,2,3
Marshall Islands,2004,sp,1524,7,5,12
Marshall Islands,2004,sp,2534,5,4,9
Marshall Islands,2004,sp,3544,3,3,6
Marshall Islands,2004,sp,4554,3,3,6
Marshall Islands,2004,sp,5564,0,2,2
Marshall Islands,2004,sp,65,1,NA,NA
Marshall Islands,2005,sp,014,1,2,3
Marshall Islands,2005,sp,1524,9,4,13
Marshall Islands,2005,sp,2534,2,4,6
Marshall Islands,2005,sp,3544,4,5,9
Marshall Islands,2005,sp,4554,3,6,9
Marshall Islands,2005,sp,5564,4,1,5
Marshall Islands,2005,sp,65,2,1,3
Marshall Islands,2006,sp,014,2,NA,NA
Marshall Islands,2006,sp,1524,2,4,6
Marshall Islands,2006,sp,2534,3,3,6
Marshall Islands,2006,sp,3544,3,4,7
Marshall Islands,2006,sp,4554,7,6,13
Marshall Islands,2006,sp,5564,4,3,7
Marshall Islands,2006,sp,65,2,2,4
Marshall Islands,2007,sp,014,1,0,1
Marshall Islands,2007,sp,1524,3,1,4
Marshall Islands,2007,sp,2534,3,1,4
Marshall Islands,2007,sp,3544,2,2,4
Marshall Islands,2007,sp,4554,3,5,8
Marshall Islands,2007,sp,5564,3,1,4
Marshall Islands,2007,sp,65,0,0,0
Marshall Islands,2008,sp,014,2,1,3
Marshall Islands,2008,sp,1524,3,1,4
Marshall Islands,2008,sp,2534,2,1,3
Marshall Islands,2008,sp,3544,4,2,6
Marshall Islands,2008,sp,4554,5,3,8
Marshall Islands,2008,sp,5564,1,0,1
Marshall Islands,2008,sp,65,0,0,0
Marshall Islands,2009,ep,014,2,2,4
Marshall Islands,2009,ep,1524,1,1,2
Marshall Islands,2009,ep,2534,0,1,1
Marshall Islands,2009,ep,3544,1,1,2
Marshall Islands,2009,ep,4554,0,2,2
Marshall Islands,2009,ep,5564,0,0,0
Marshall Islands,2009,ep,65,0,0,0
Marshall Islands,2009,sn,014,10,10,20
Marshall Islands,2009,sn,1524,6,3,9
Marshall Islands,2009,sn,2534,3,3,6
Marshall Islands,2009,sn,3544,6,3,9
Marshall Islands,2009,sn,4554,7,6,13
Marshall Islands,2009,sn,5564,2,5,7
Marshall Islands,2009,sn,65,4,2,6
Marshall Islands,2009,sp,014,1,1,2
Marshall Islands,2009,sp,1524,5,12,17
Marshall Islands,2009,sp,2534,5,5,10
Marshall Islands,2009,sp,3544,4,2,6
Marshall Islands,2009,sp,4554,5,5,10
Marshall Islands,2009,sp,5564,2,4,6
Marshall Islands,2009,sp,65,1,0,1
Marshall Islands,2010,ep,014,8,16,24
Marshall Islands,2010,ep,1524,3,9,12
Marshall Islands,2010,ep,2534,6,8,14
Marshall Islands,2010,ep,3544,3,3,6
Marshall Islands,2010,ep,4554,3,2,5
Marshall Islands,2010,ep,5564,1,2,3
Marshall Islands,2010,ep,65,0,1,1
Marshall Islands,2010,sn,014,5,15,20
Marshall Islands,2010,sn,1524,9,7,16
Marshall Islands,2010,sn,2534,4,2,6
Marshall Islands,2010,sn,3544,4,3,7
Marshall Islands,2010,sn,4554,1,6,7
Marshall Islands,2010,sn,5564,0,6,6
Marshall Islands,2010,sn,65,0,2,2
Marshall Islands,2010,sp,014,5,0,5
Marshall Islands,2010,sp,1524,9,10,19
Marshall Islands,2010,sp,2534,2,1,3
Marshall Islands,2010,sp,3544,2,4,6
Marshall Islands,2010,sp,4554,4,6,10
Marshall Islands,2010,sp,5564,8,6,14
Marshall Islands,2010,sp,65,0,2,2
Marshall Islands,2011,ep,014,15,14,29
Marshall Islands,2011,ep,1524,6,4,10
Marshall Islands,2011,ep,2534,4,5,9
Marshall Islands,2011,ep,3544,3,1,4
Marshall Islands,2011,ep,4554,2,3,5
Marshall Islands,2011,ep,5564,0,0,0
Marshall Islands,2011,ep,65,0,0,0
Marshall Islands,2011,sn,014,4,6,10
Marshall Islands,2011,sn,1524,0,2,2
Marshall Islands,2011,sn,2534,1,3,4
Marshall Islands,2011,sn,3544,2,2,4
Marshall Islands,2011,sn,4554,4,1,5
Marshall Islands,2011,sn,5564,0,2,2
Marshall Islands,2011,sn,65,0,3,3
Marshall Islands,2011,sp,014,1,1,2
Marshall Islands,2011,sp,1524,5,7,12
Marshall Islands,2011,sp,2534,8,2,10
Marshall Islands,2011,sp,3544,2,3,5
Marshall Islands,2011,sp,4554,5,3,8
Marshall Islands,2011,sp,5564,2,3,5
Marshall Islands,2011,sp,65,1,1,2
Marshall Islands,2012,ep,014,8,7,15
Marshall Islands,2012,ep,1524,1,4,5
Marshall Islands,2012,ep,2534,1,2,3
Marshall Islands,2012,ep,3544,0,2,2
Marshall Islands,2012,ep,4554,1,1,2
Marshall Islands,2012,ep,5564,0,1,1
Marshall Islands,2012,ep,65,0,1,1
Marshall Islands,2012,sn,014,11,8,19
Marshall Islands,2012,sn,1524,5,7,12
Marshall Islands,2012,sn,2534,4,2,6
Marshall Islands,2012,sn,3544,3,2,5
Marshall Islands,2012,sn,4554,3,2,5
Marshall Islands,2012,sn,5564,2,1,3
Marshall Islands,2012,sn,65,2,1,3
Marshall Islands,2012,sp,014,0,0,0
Marshall Islands,2012,sp,1524,5,3,8
Marshall Islands,2012,sp,2534,7,8,15
Marshall Islands,2012,sp,3544,2,6,8
Marshall Islands,2012,sp,4554,5,9,14
Marshall Islands,2012,sp,5564,3,2,5
Marshall Islands,2012,sp,65,2,2,4
Marshall Islands,2013,rel,014,14,16,30
Marshall Islands,2013,rel,1524,12,6,18
Marshall Islands,2013,rel,2534,17,15,32
Marshall Islands,2013,rel,3544,8,10,18
Marshall Islands,2013,rel,4554,12,12,24
Marshall Islands,2013,rel,5564,5,16,21
Marshall Islands,2013,rel,65,2,1,3
Mauritania,1997,sp,014,125,188,313
Mauritania,1997,sp,1524,131,165,296
Mauritania,1997,sp,2534,319,321,640
Mauritania,1997,sp,3544,230,341,571
Mauritania,1997,sp,4554,484,613,1097
Mauritania,1997,sp,5564,384,232,616
Mauritania,1997,sp,65,70,185,255
Mauritania,1999,sp,014,7,15,22
Mauritania,1999,sp,1524,157,290,447
Mauritania,1999,sp,2534,97,450,547
Mauritania,1999,sp,3544,110,262,372
Mauritania,1999,sp,4554,76,177,253
Mauritania,1999,sp,5564,43,113,156
Mauritania,1999,sp,65,20,92,112
Mauritania,2004,sp,014,14,15,29
Mauritania,2004,sp,1524,102,204,306
Mauritania,2004,sp,2534,114,343,457
Mauritania,2004,sp,3544,114,235,349
Mauritania,2004,sp,4554,58,154,212
Mauritania,2004,sp,5564,44,129,173
Mauritania,2004,sp,65,28,108,136
Mauritania,2006,sp,014,16,12,28
Mauritania,2006,sp,1524,109,197,306
Mauritania,2006,sp,2534,114,294,408
Mauritania,2006,sp,3544,86,203,289
Mauritania,2006,sp,4554,49,150,199
Mauritania,2006,sp,5564,29,106,135
Mauritania,2006,sp,65,25,96,121
Mauritania,2007,ep,014,7,5,12
Mauritania,2007,ep,1524,36,72,108
Mauritania,2007,ep,2534,54,126,180
Mauritania,2007,ep,3544,32,92,124
Mauritania,2007,ep,4554,23,51,74
Mauritania,2007,ep,5564,13,49,62
Mauritania,2007,ep,65,14,29,43
Mauritania,2007,sn,014,6,4,10
Mauritania,2007,sn,1524,30,59,89
Mauritania,2007,sn,2534,44,103,147
Mauritania,2007,sn,3544,26,75,101
Mauritania,2007,sn,4554,18,41,59
Mauritania,2007,sn,5564,11,40,51
Mauritania,2007,sn,65,13,24,37
Mauritania,2007,sp,014,21,14,35
Mauritania,2007,sp,1524,103,206,309
Mauritania,2007,sp,2534,152,355,507
Mauritania,2007,sp,3544,92,261,353
Mauritania,2007,sp,4554,64,144,208
Mauritania,2007,sp,5564,38,139,177
Mauritania,2007,sp,65,42,83,125
Mauritania,2008,sp,014,16,10,26
Mauritania,2008,sp,1524,127,199,326
Mauritania,2008,sp,2534,111,292,403
Mauritania,2008,sp,3544,97,249,346
Mauritania,2008,sp,4554,44,172,216
Mauritania,2008,sp,5564,51,107,158
Mauritania,2008,sp,65,40,90,130
Mauritania,2009,sp,014,24,25,49
Mauritania,2009,sp,1524,111,217,328
Mauritania,2009,sp,2534,127,328,455
Mauritania,2009,sp,3544,76,198,274
Mauritania,2009,sp,4554,49,150,199
Mauritania,2009,sp,5564,27,116,143
Mauritania,2009,sp,65,22,85,107
Mauritania,2010,sp,014,14,17,31
Mauritania,2010,sp,1524,90,192,282
Mauritania,2010,sp,2534,104,295,399
Mauritania,2010,sp,3544,82,206,288
Mauritania,2010,sp,4554,52,137,189
Mauritania,2010,sp,5564,29,99,128
Mauritania,2010,sp,65,29,76,105
Mauritania,2011,sp,014,28,36,64
Mauritania,2011,sp,1524,68,165,233
Mauritania,2011,sp,2534,72,185,257
Mauritania,2011,sp,3544,47,131,178
Mauritania,2011,sp,4554,36,106,142
Mauritania,2011,sp,5564,19,58,77
Mauritania,2011,sp,65,20,55,75
Mauritania,2012,ep,014,12,11,23
Mauritania,2012,ep,1524,22,33,55
Mauritania,2012,ep,2534,22,42,64
Mauritania,2012,ep,3544,27,47,74
Mauritania,2012,ep,4554,5,35,40
Mauritania,2012,ep,5564,15,22,37
Mauritania,2012,ep,65,14,32,46
Mauritania,2012,sn,014,2,13,15
Mauritania,2012,sn,1524,7,21,28
Mauritania,2012,sn,2534,17,31,48
Mauritania,2012,sn,3544,17,19,36
Mauritania,2012,sn,4554,7,24,31
Mauritania,2012,sn,5564,9,31,40
Mauritania,2012,sn,65,5,25,30
Mauritania,2012,sp,014,25,22,47
Mauritania,2012,sp,1524,112,204,316
Mauritania,2012,sp,2534,81,302,383
Mauritania,2012,sp,3544,88,195,283
Mauritania,2012,sp,4554,73,139,212
Mauritania,2012,sp,5564,46,114,160
Mauritania,2012,sp,65,28,114,142
Mauritania,2013,rel,014,37,28,65
Mauritania,2013,rel,1524,170,293,463
Mauritania,2013,rel,2534,153,426,579
Mauritania,2013,rel,3544,137,294,431
Mauritania,2013,rel,4554,105,230,335
Mauritania,2013,rel,5564,83,170,253
Mauritania,2013,rel,65,69,169,238
Mauritius,1995,sp,014,2,2,4
Mauritius,1995,sp,1524,4,17,21
Mauritius,1995,sp,2534,12,13,25
Mauritius,1995,sp,3544,10,22,32
Mauritius,1995,sp,4554,8,27,35
Mauritius,1995,sp,5564,4,13,17
Mauritius,1995,sp,65,4,8,12
Mauritius,1998,sp,014,0,1,1
Mauritius,1998,sp,1524,9,12,21
Mauritius,1998,sp,2534,5,10,15
Mauritius,1998,sp,3544,4,21,25
Mauritius,1998,sp,4554,3,19,22
Mauritius,1998,sp,5564,3,10,13
Mauritius,1998,sp,65,6,19,25
Mauritius,1999,sp,014,0,0,0
Mauritius,1999,sp,1524,13,7,20
Mauritius,1999,sp,2534,7,20,27
Mauritius,1999,sp,3544,7,15,22
Mauritius,1999,sp,4554,8,13,21
Mauritius,1999,sp,5564,2,12,14
Mauritius,1999,sp,65,3,12,15
Mauritius,2000,sp,014,1,2,3
Mauritius,2000,sp,1524,5,6,11
Mauritius,2000,sp,2534,8,9,17
Mauritius,2000,sp,3544,8,18,26
Mauritius,2000,sp,4554,6,19,25
Mauritius,2000,sp,5564,7,14,21
Mauritius,2000,sp,65,4,8,12
Mauritius,2002,sp,014,1,1,2
Mauritius,2002,sp,1524,3,12,15
Mauritius,2002,sp,2534,8,6,14
Mauritius,2002,sp,3544,7,21,28
Mauritius,2002,sp,4554,1,12,13
Mauritius,2002,sp,5564,2,7,9
Mauritius,2002,sp,65,1,4,5
Mauritius,2003,sp,014,1,0,1
Mauritius,2003,sp,1524,6,9,15
Mauritius,2003,sp,2534,8,12,20
Mauritius,2003,sp,3544,4,10,14
Mauritius,2003,sp,4554,4,17,21
Mauritius,2003,sp,5564,3,11,14
Mauritius,2003,sp,65,5,9,14
Mauritius,2004,sp,014,0,1,1
Mauritius,2004,sp,1524,6,13,19
Mauritius,2004,sp,2534,8,13,21
Mauritius,2004,sp,3544,10,24,34
Mauritius,2004,sp,4554,4,20,24
Mauritius,2004,sp,5564,4,4,8
Mauritius,2004,sp,65,5,5,10
Mauritius,2005,sp,1524,4,10,14
Mauritius,2005,sp,2534,5,15,20
Mauritius,2005,sp,3544,5,21,26
Mauritius,2005,sp,4554,11,20,31
Mauritius,2005,sp,5564,2,10,12
Mauritius,2005,sp,65,1,6,7
Mauritius,2006,ep,014,1,1,2
Mauritius,2006,ep,1524,1,0,1
Mauritius,2006,ep,2534,2,3,5
Mauritius,2006,ep,3544,1,0,1
Mauritius,2006,ep,4554,1,2,3
Mauritius,2006,ep,5564,1,0,1
Mauritius,2006,ep,65,2,0,2
Mauritius,2006,sn,014,0,0,0
Mauritius,2006,sn,1524,1,1,2
Mauritius,2006,sn,2534,0,2,2
Mauritius,2006,sn,3544,3,0,3
Mauritius,2006,sn,4554,1,2,3
Mauritius,2006,sn,5564,0,0,0
Mauritius,2006,sn,65,0,1,1
Mauritius,2006,sp,014,1,0,1
Mauritius,2006,sp,1524,3,4,7
Mauritius,2006,sp,2534,7,9,16
Mauritius,2006,sp,3544,3,22,25
Mauritius,2006,sp,4554,4,10,14
Mauritius,2006,sp,5564,1,12,13
Mauritius,2006,sp,65,3,6,9
Mauritius,2007,ep,014,0,0,0
Mauritius,2007,ep,1524,0,0,0
Mauritius,2007,ep,2534,1,0,1
Mauritius,2007,ep,3544,0,0,0
Mauritius,2007,ep,4554,0,1,1
Mauritius,2007,ep,5564,1,0,1
Mauritius,2007,ep,65,0,1,1
Mauritius,2007,sn,014,0,0,0
Mauritius,2007,sn,1524,0,2,2
Mauritius,2007,sn,2534,1,3,4
Mauritius,2007,sn,3544,2,1,3
Mauritius,2007,sn,4554,1,1,2
Mauritius,2007,sn,5564,0,0,0
Mauritius,2007,sn,65,0,1,1
Mauritius,2007,sp,014,0,0,0
Mauritius,2007,sp,1524,4,9,13
Mauritius,2007,sp,2534,7,9,16
Mauritius,2007,sp,3544,3,12,15
Mauritius,2007,sp,4554,5,15,20
Mauritius,2007,sp,5564,4,9,13
Mauritius,2007,sp,65,3,6,9
Mauritius,2008,ep,014,0,0,0
Mauritius,2008,ep,1524,0,0,0
Mauritius,2008,ep,2534,1,0,1
Mauritius,2008,ep,3544,1,2,3
Mauritius,2008,ep,4554,0,0,0
Mauritius,2008,ep,5564,1,0,1
Mauritius,2008,ep,65,0,0,0
Mauritius,2008,sn,014,0,0,0
Mauritius,2008,sn,1524,0,1,1
Mauritius,2008,sn,2534,1,1,2
Mauritius,2008,sn,3544,2,3,5
Mauritius,2008,sn,4554,0,3,3
Mauritius,2008,sn,5564,1,1,2
Mauritius,2008,sn,65,0,1,1
Mauritius,2008,sp,014,0,0,0
Mauritius,2008,sp,1524,2,11,13
Mauritius,2008,sp,2534,3,15,18
Mauritius,2008,sp,3544,2,14,16
Mauritius,2008,sp,4554,5,15,20
Mauritius,2008,sp,5564,2,7,9
Mauritius,2008,sp,65,1,8,9
Mauritius,2009,ep,014,0,1,1
Mauritius,2009,ep,1524,1,0,1
Mauritius,2009,ep,2534,0,0,0
Mauritius,2009,ep,3544,1,1,2
Mauritius,2009,ep,4554,0,1,1
Mauritius,2009,ep,5564,0,1,1
Mauritius,2009,ep,65,0,0,0
Mauritius,2009,sn,014,0,0,0
Mauritius,2009,sn,1524,2,1,3
Mauritius,2009,sn,2534,0,1,1
Mauritius,2009,sn,3544,0,0,0
Mauritius,2009,sn,4554,1,1,2
Mauritius,2009,sn,5564,0,0,0
Mauritius,2009,sn,65,0,1,1
Mauritius,2009,sp,014,0,0,0
Mauritius,2009,sp,1524,6,5,11
Mauritius,2009,sp,2534,10,7,17
Mauritius,2009,sp,3544,7,10,17
Mauritius,2009,sp,4554,5,19,24
Mauritius,2009,sp,5564,6,10,16
Mauritius,2009,sp,65,4,9,13
Mauritius,2010,ep,014,0,0,0
Mauritius,2010,ep,1524,1,0,1
Mauritius,2010,ep,2534,1,1,2
Mauritius,2010,ep,3544,1,0,1
Mauritius,2010,ep,4554,1,0,1
Mauritius,2010,ep,5564,0,1,1
Mauritius,2010,ep,65,0,0,0
Mauritius,2010,sn,014,0,0,0
Mauritius,2010,sn,1524,0,0,0
Mauritius,2010,sn,2534,0,0,0
Mauritius,2010,sn,3544,1,0,1
Mauritius,2010,sn,4554,0,2,2
Mauritius,2010,sn,5564,1,0,1
Mauritius,2010,sn,65,0,1,1
Mauritius,2010,sp,014,0,0,0
Mauritius,2010,sp,1524,7,9,16
Mauritius,2010,sp,2534,9,9,18
Mauritius,2010,sp,3544,4,13,17
Mauritius,2010,sp,4554,4,23,27
Mauritius,2010,sp,5564,3,15,18
Mauritius,2010,sp,65,2,7,9
Mauritius,2011,ep,014,0,0,0
Mauritius,2011,ep,1524,0,0,0
Mauritius,2011,ep,2534,1,1,2
Mauritius,2011,ep,3544,2,2,4
Mauritius,2011,ep,4554,2,0,2
Mauritius,2011,ep,5564,0,0,0
Mauritius,2011,ep,65,0,0,0
Mauritius,2011,sn,014,0,0,0
Mauritius,2011,sn,1524,0,1,1
Mauritius,2011,sn,2534,0,1,1
Mauritius,2011,sn,3544,0,0,0
Mauritius,2011,sn,4554,0,0,0
Mauritius,2011,sn,5564,0,1,1
Mauritius,2011,sn,65,0,0,0
Mauritius,2011,sp,014,0,0,0
Mauritius,2011,sp,1524,7,10,17
Mauritius,2011,sp,2534,12,13,25
Mauritius,2011,sp,3544,2,9,11
Mauritius,2011,sp,4554,3,17,20
Mauritius,2011,sp,5564,6,10,16
Mauritius,2011,sp,65,3,8,11
Mauritius,2012,ep,014,0,0,0
Mauritius,2012,ep,1524,1,0,1
Mauritius,2012,ep,2534,0,1,1
Mauritius,2012,ep,3544,0,0,0
Mauritius,2012,ep,4554,0,0,0
Mauritius,2012,ep,5564,1,0,1
Mauritius,2012,ep,65,1,1,2
Mauritius,2012,sn,014,0,0,0
Mauritius,2012,sn,1524,0,0,0
Mauritius,2012,sn,2534,0,0,0
Mauritius,2012,sn,3544,1,0,1
Mauritius,2012,sn,4554,0,0,0
Mauritius,2012,sn,5564,0,0,0
Mauritius,2012,sn,65,0,2,2
Mauritius,2012,sp,014,0,2,2
Mauritius,2012,sp,1524,11,11,22
Mauritius,2012,sp,2534,7,14,21
Mauritius,2012,sp,3544,8,16,24
Mauritius,2012,sp,4554,2,17,19
Mauritius,2012,sp,5564,8,11,19
Mauritius,2012,sp,65,4,7,11
Mauritius,2013,rel,014,0,1,1
Mauritius,2013,rel,1524,10,10,20
Mauritius,2013,rel,2534,4,15,19
Mauritius,2013,rel,3544,8,20,28
Mauritius,2013,rel,4554,9,27,36
Mauritius,2013,rel,5564,3,8,11
Mauritius,2013,rel,65,6,9,15
Mexico,1996,sp,014,243,198,441
Mexico,1996,sp,1524,685,936,1621
Mexico,1996,sp,2534,681,1021,1702
Mexico,1996,sp,3544,627,940,1567
Mexico,1996,sp,4554,482,721,1203
Mexico,1996,sp,5564,472,708,1180
Mexico,1996,sp,65,312,469,781
Mexico,1998,sp,014,268,229,497
Mexico,1998,sp,1524,856,1031,1887
Mexico,1998,sp,2534,829,1330,2159
Mexico,1998,sp,3544,874,1200,2074
Mexico,1998,sp,4554,742,1241,1983
Mexico,1998,sp,5564,583,813,1396
Mexico,1998,sp,65,585,892,1477
Mexico,1999,sp,014,151,143,294
Mexico,1999,sp,1524,773,1013,1786
Mexico,1999,sp,2534,795,1141,1936
Mexico,1999,sp,3544,641,1093,1734
Mexico,1999,sp,4554,665,1022,1687
Mexico,1999,sp,5564,592,880,1472
Mexico,1999,sp,65,710,1128,1838
Mexico,2000,sp,014,176,214,390
Mexico,2000,sp,1524,663,1079,1742
Mexico,2000,sp,2534,828,1387,2215
Mexico,2000,sp,3544,698,1162,1860
Mexico,2000,sp,4554,832,1235,2067
Mexico,2000,sp,5564,595,972,1567
Mexico,2000,sp,65,709,1126,1835
Mexico,2001,sp,014,146,130,276
Mexico,2001,sp,1524,1131,1448,2579
Mexico,2001,sp,2534,993,1639,2632
Mexico,2001,sp,3544,845,1683,2528
Mexico,2001,sp,4554,952,1606,2558
Mexico,2001,sp,5564,787,1229,2016
Mexico,2001,sp,65,948,1566,2514
Mexico,2002,sp,014,149,154,303
Mexico,2002,sp,1524,769,1090,1859
Mexico,2002,sp,2534,754,1292,2046
Mexico,2002,sp,3544,716,1301,2017
Mexico,2002,sp,4554,700,1146,1846
Mexico,2002,sp,5564,621,986,1607
Mexico,2002,sp,65,733,1144,1877
Mexico,2003,sp,014,184,187,371
Mexico,2003,sp,1524,850,1207,2057
Mexico,2003,sp,2534,826,1461,2287
Mexico,2003,sp,3544,734,1417,2151
Mexico,2003,sp,4554,813,1313,2126
Mexico,2003,sp,5564,743,1005,1748
Mexico,2003,sp,65,841,1352,2193
Mexico,2004,sp,014,102,86,188
Mexico,2004,sp,1524,760,1053,1813
Mexico,2004,sp,2534,649,1276,1925
Mexico,2004,sp,3544,693,1181,1874
Mexico,2004,sp,4554,695,1201,1896
Mexico,2004,sp,5564,626,958,1584
Mexico,2004,sp,65,725,1209,1934
Mexico,2005,sp,014,125,100,225
Mexico,2005,sp,1524,771,1095,1866
Mexico,2005,sp,2534,733,1376,2109
Mexico,2005,sp,3544,710,1314,2024
Mexico,2005,sp,4554,784,1238,2022
Mexico,2005,sp,5564,637,1042,1679
Mexico,2005,sp,65,784,1288,2072
Mexico,2006,ep,014,205,202,407
Mexico,2006,ep,1524,243,170,413
Mexico,2006,ep,2534,252,318,570
Mexico,2006,ep,3544,199,233,432
Mexico,2006,ep,4554,184,173,357
Mexico,2006,ep,5564,164,117,281
Mexico,2006,ep,65,147,144,291
Mexico,2006,sn,014,108,108,216
Mexico,2006,sn,1524,133,196,329
Mexico,2006,sn,2534,154,266,420
Mexico,2006,sn,3544,146,243,389
Mexico,2006,sn,4554,151,232,383
Mexico,2006,sn,5564,127,181,308
Mexico,2006,sn,65,170,253,423
Mexico,2006,sp,014,153,129,282
Mexico,2006,sp,1524,696,986,1682
Mexico,2006,sp,2534,774,1320,2094
Mexico,2006,sp,3544,662,1333,1995
Mexico,2006,sp,4554,794,1275,2069
Mexico,2006,sp,5564,722,1012,1734
Mexico,2006,sp,65,803,1215,2018
Mexico,2007,ep,014,185,205,390
Mexico,2007,ep,1524,220,237,457
Mexico,2007,ep,2534,274,307,581
Mexico,2007,ep,3544,233,268,501
Mexico,2007,ep,4554,182,177,359
Mexico,2007,ep,5564,143,154,297
Mexico,2007,ep,65,137,147,284
Mexico,2007,sn,014,122,136,258
Mexico,2007,sn,1524,207,270,477
Mexico,2007,sn,2534,209,344,553
Mexico,2007,sn,3544,166,346,512
Mexico,2007,sn,4554,202,311,513
Mexico,2007,sn,5564,166,212,378
Mexico,2007,sn,65,206,316,522
Mexico,2007,sp,014,140,145,285
Mexico,2007,sp,1524,645,981,1626
Mexico,2007,sp,2534,742,1286,2028
Mexico,2007,sp,3544,694,1286,1980
Mexico,2007,sp,4554,748,1266,2014
Mexico,2007,sp,5564,642,942,1584
Mexico,2007,sp,65,788,1226,2014
Mexico,2008,ep,014,224,204,428
Mexico,2008,ep,1524,224,245,469
Mexico,2008,ep,2534,280,350,630
Mexico,2008,ep,3544,242,312,554
Mexico,2008,ep,4554,190,244,434
Mexico,2008,ep,5564,152,159,311
Mexico,2008,ep,65,165,184,349
Mexico,2008,sn,014,50,54,104
Mexico,2008,sn,1524,63,82,145
Mexico,2008,sn,2534,65,125,190
Mexico,2008,sn,3544,51,113,164
Mexico,2008,sn,4554,62,112,174
Mexico,2008,sn,5564,52,61,113
Mexico,2008,sn,65,68,104,172
Mexico,2008,sp,014,126,124,250
Mexico,2008,sp,1524,752,966,1718
Mexico,2008,sp,2534,826,1292,2118
Mexico,2008,sp,3544,710,1314,2024
Mexico,2008,sp,4554,774,1267,2041
Mexico,2008,sp,5564,699,1004,1703
Mexico,2008,sp,65,836,1213,2049
Mexico,2009,ep,014,196,217,413
Mexico,2009,ep,1524,239,249,488
Mexico,2009,ep,2534,292,368,660
Mexico,2009,ep,3544,221,308,529
Mexico,2009,ep,4554,180,234,414
Mexico,2009,ep,5564,188,169,357
Mexico,2009,ep,65,151,181,332
Mexico,2009,sn,014,10,8,18
Mexico,2009,sn,1524,63,81,144
Mexico,2009,sn,2534,61,98,159
Mexico,2009,sn,3544,57,109,166
Mexico,2009,sn,4554,67,107,174
Mexico,2009,sn,5564,52,80,132
Mexico,2009,sn,65,67,98,165
Mexico,2009,sp,014,131,103,234
Mexico,2009,sp,1524,741,1030,1771
Mexico,2009,sp,2534,712,1262,1974
Mexico,2009,sp,3544,665,1401,2066
Mexico,2009,sp,4554,788,1360,2148
Mexico,2009,sp,5564,608,1024,1632
Mexico,2009,sp,65,785,1252,2037
Mexico,2010,ep,014,223,225,448
Mexico,2010,ep,1524,244,286,530
Mexico,2010,ep,2534,306,407,713
Mexico,2010,ep,3544,257,339,596
Mexico,2010,ep,4554,202,231,433
Mexico,2010,ep,5564,173,196,369
Mexico,2010,ep,65,187,188,375
Mexico,2010,sn,014,106,130,236
Mexico,2010,sn,1524,159,250,409
Mexico,2010,sn,2534,138,331,469
Mexico,2010,sn,3544,140,300,440
Mexico,2010,sn,4554,123,287,410
Mexico,2010,sn,5564,141,238,379
Mexico,2010,sn,65,176,293,469
Mexico,2010,sp,014,112,125,237
Mexico,2010,sp,1524,791,1081,1872
Mexico,2010,sp,2534,763,1375,2138
Mexico,2010,sp,3544,730,1380,2110
Mexico,2010,sp,4554,852,1392,2244
Mexico,2010,sp,5564,713,1119,1832
Mexico,2010,sp,65,836,1303,2139
Mexico,2011,ep,014,194,205,399
Mexico,2011,ep,1524,298,267,565
Mexico,2011,ep,2534,333,384,717
Mexico,2011,ep,3544,271,364,635
Mexico,2011,ep,4554,229,244,473
Mexico,2011,ep,5564,192,170,362
Mexico,2011,ep,65,187,191,378
Mexico,2011,sn,014,99,124,223
Mexico,2011,sn,1524,135,222,357
Mexico,2011,sn,2534,140,324,464
Mexico,2011,sn,3544,109,290,399
Mexico,2011,sn,4554,141,251,392
Mexico,2011,sn,5564,101,189,290
Mexico,2011,sn,65,152,220,372
Mexico,2011,sp,014,136,128,264
Mexico,2011,sp,1524,776,1124,1900
Mexico,2011,sp,2534,765,1440,2205
Mexico,2011,sp,3544,698,1503,2201
Mexico,2011,sp,4554,889,1532,2421
Mexico,2011,sp,5564,734,1112,1846
Mexico,2011,sp,65,824,1299,2123
Mexico,2012,ep,014,212,208,420
Mexico,2012,ep,1524,299,268,567
Mexico,2012,ep,2534,352,468,820
Mexico,2012,ep,3544,289,387,676
Mexico,2012,ep,4554,250,275,525
Mexico,2012,ep,5564,187,204,391
Mexico,2012,ep,65,202,238,440
Mexico,2012,sn,014,121,143,264
Mexico,2012,sn,1524,143,248,391
Mexico,2012,sn,2534,132,295,427
Mexico,2012,sn,3544,141,282,423
Mexico,2012,sn,4554,165,253,418
Mexico,2012,sn,5564,130,211,341
Mexico,2012,sn,65,165,252,417
Mexico,2012,sp,014,134,133,267
Mexico,2012,sp,1524,778,1153,1931
Mexico,2012,sp,2534,743,1480,2223
Mexico,2012,sp,3544,686,1522,2208
Mexico,2012,sp,4554,840,1484,2324
Mexico,2012,sp,5564,824,1153,1977
Mexico,2012,sp,65,824,1284,2108
Mexico,2013,rel,014,376,429,805
Mexico,2013,rel,1524,1262,1797,3059
Mexico,2013,rel,2534,1315,2230,3545
Mexico,2013,rel,3544,1230,2409,3639
Mexico,2013,rel,4554,1307,2289,3596
Mexico,2013,rel,5564,1156,1736,2892
Mexico,2013,rel,65,1232,1940,3172
Micronesia (Federated States of),1995,sp,014,0,0,0
Micronesia (Federated States of),1995,sp,1524,0,1,1
Micronesia (Federated States of),1995,sp,2534,1,0,1
Micronesia (Federated States of),1995,sp,3544,0,3,3
Micronesia (Federated States of),1995,sp,4554,0,1,1
Micronesia (Federated States of),1995,sp,5564,0,0,0
Micronesia (Federated States of),1995,sp,65,1,0,1
Micronesia (Federated States of),1996,sp,014,0,0,0
Micronesia (Federated States of),1996,sp,1524,1,1,2
Micronesia (Federated States of),1996,sp,2534,1,0,1
Micronesia (Federated States of),1996,sp,3544,1,0,1
Micronesia (Federated States of),1996,sp,4554,3,1,4
Micronesia (Federated States of),1996,sp,5564,0,2,2
Micronesia (Federated States of),1996,sp,65,0,0,0
Micronesia (Federated States of),1997,sp,014,1,0,1
Micronesia (Federated States of),1997,sp,1524,1,0,1
Micronesia (Federated States of),1997,sp,2534,1,0,1
Micronesia (Federated States of),1997,sp,3544,2,0,2
Micronesia (Federated States of),1997,sp,4554,2,2,4
Micronesia (Federated States of),1997,sp,5564,0,0,0
Micronesia (Federated States of),1997,sp,65,2,0,2
Micronesia (Federated States of),1998,sp,014,2,4,6
Micronesia (Federated States of),1998,sp,1524,1,5,6
Micronesia (Federated States of),1998,sp,2534,0,3,3
Micronesia (Federated States of),1998,sp,3544,1,4,5
Micronesia (Federated States of),1998,sp,4554,2,1,3
Micronesia (Federated States of),1998,sp,5564,0,0,0
Micronesia (Federated States of),1998,sp,65,0,5,5
Micronesia (Federated States of),2000,sp,014,4,0,4
Micronesia (Federated States of),2000,sp,1524,3,2,5
Micronesia (Federated States of),2000,sp,2534,1,0,1
Micronesia (Federated States of),2000,sp,3544,1,1,2
Micronesia (Federated States of),2000,sp,4554,0,0,0
Micronesia (Federated States of),2000,sp,5564,1,0,1
Micronesia (Federated States of),2000,sp,65,1,1,2
Micronesia (Federated States of),2001,sp,014,1,0,1
Micronesia (Federated States of),2001,sp,1524,0,2,2
Micronesia (Federated States of),2001,sp,2534,1,0,1
Micronesia (Federated States of),2001,sp,3544,0,0,0
Micronesia (Federated States of),2001,sp,4554,0,2,2
Micronesia (Federated States of),2001,sp,5564,1,1,2
Micronesia (Federated States of),2001,sp,65,0,0,0
Micronesia (Federated States of),2002,sp,014,3,2,5
Micronesia (Federated States of),2002,sp,1524,5,0,5
Micronesia (Federated States of),2002,sp,2534,1,1,2
Micronesia (Federated States of),2002,sp,3544,1,1,2
Micronesia (Federated States of),2002,sp,4554,2,1,3
Micronesia (Federated States of),2002,sp,5564,0,1,1
Micronesia (Federated States of),2002,sp,65,2,0,2
Micronesia (Federated States of),2003,sp,014,4,0,4
Micronesia (Federated States of),2003,sp,1524,4,3,7
Micronesia (Federated States of),2003,sp,2534,4,2,6
Micronesia (Federated States of),2003,sp,3544,1,2,3
Micronesia (Federated States of),2003,sp,4554,1,0,1
Micronesia (Federated States of),2003,sp,5564,2,2,4
Micronesia (Federated States of),2003,sp,65,1,1,2
Micronesia (Federated States of),2004,sp,014,3,0,3
Micronesia (Federated States of),2004,sp,1524,4,4,8
Micronesia (Federated States of),2004,sp,2534,4,0,4
Micronesia (Federated States of),2004,sp,3544,1,2,3
Micronesia (Federated States of),2004,sp,4554,1,0,1
Micronesia (Federated States of),2004,sp,5564,3,2,5
Micronesia (Federated States of),2004,sp,65,1,1,2
Micronesia (Federated States of),2006,ep,014,1,1,2
Micronesia (Federated States of),2006,ep,1524,1,2,3
Micronesia (Federated States of),2006,ep,2534,1,1,2
Micronesia (Federated States of),2006,ep,3544,1,1,2
Micronesia (Federated States of),2006,ep,4554,0,2,2
Micronesia (Federated States of),2006,ep,5564,0,1,1
Micronesia (Federated States of),2006,ep,65,0,0,0
Micronesia (Federated States of),2006,sn,014,0,3,3
Micronesia (Federated States of),2006,sn,1524,7,8,15
Micronesia (Federated States of),2006,sn,2534,0,1,1
Micronesia (Federated States of),2006,sn,3544,1,2,3
Micronesia (Federated States of),2006,sn,4554,2,1,3
Micronesia (Federated States of),2006,sn,5564,2,1,3
Micronesia (Federated States of),2006,sn,65,1,0,1
Micronesia (Federated States of),2006,sp,014,5,14,19
Micronesia (Federated States of),2006,sp,1524,23,21,44
Micronesia (Federated States of),2006,sp,2534,5,3,8
Micronesia (Federated States of),2006,sp,3544,7,6,13
Micronesia (Federated States of),2006,sp,4554,4,8,12
Micronesia (Federated States of),2006,sp,5564,6,6,12
Micronesia (Federated States of),2006,sp,65,4,1,5
Micronesia (Federated States of),2007,ep,014,1,3,4
Micronesia (Federated States of),2007,ep,1524,0,0,0
Micronesia (Federated States of),2007,ep,2534,2,0,2
Micronesia (Federated States of),2007,ep,3544,0,0,0
Micronesia (Federated States of),2007,ep,4554,0,0,0
Micronesia (Federated States of),2007,ep,5564,0,0,0
Micronesia (Federated States of),2007,ep,65,0,0,0
Micronesia (Federated States of),2007,sn,014,3,5,8
Micronesia (Federated States of),2007,sn,1524,4,4,8
Micronesia (Federated States of),2007,sn,2534,3,0,3
Micronesia (Federated States of),2007,sn,3544,1,1,2
Micronesia (Federated States of),2007,sn,4554,1,1,2
Micronesia (Federated States of),2007,sn,5564,0,2,2
Micronesia (Federated States of),2007,sn,65,2,0,2
Micronesia (Federated States of),2007,sp,014,5,1,6
Micronesia (Federated States of),2007,sp,1524,11,8,19
Micronesia (Federated States of),2007,sp,2534,6,5,11
Micronesia (Federated States of),2007,sp,3544,2,4,6
Micronesia (Federated States of),2007,sp,4554,2,0,2
Micronesia (Federated States of),2007,sp,5564,2,1,3
Micronesia (Federated States of),2007,sp,65,0,0,0
Micronesia (Federated States of),2008,ep,014,3,4,7
Micronesia (Federated States of),2008,ep,1524,5,6,11
Micronesia (Federated States of),2008,ep,2534,3,0,3
Micronesia (Federated States of),2008,ep,3544,1,0,1
Micronesia (Federated States of),2008,ep,4554,2,3,5
Micronesia (Federated States of),2008,ep,5564,0,2,2
Micronesia (Federated States of),2008,ep,65,0,0,0
Micronesia (Federated States of),2008,sn,014,14,6,20
Micronesia (Federated States of),2008,sn,1524,5,5,10
Micronesia (Federated States of),2008,sn,2534,3,5,8
Micronesia (Federated States of),2008,sn,3544,1,4,5
Micronesia (Federated States of),2008,sn,4554,2,5,7
Micronesia (Federated States of),2008,sn,5564,0,3,3
Micronesia (Federated States of),2008,sn,65,0,4,4
Micronesia (Federated States of),2008,sp,014,1,1,2
Micronesia (Federated States of),2008,sp,1524,10,9,19
Micronesia (Federated States of),2008,sp,2534,2,3,5
Micronesia (Federated States of),2008,sp,3544,5,1,6
Micronesia (Federated States of),2008,sp,4554,1,3,4
Micronesia (Federated States of),2008,sp,5564,0,1,1
Micronesia (Federated States of),2008,sp,65,0,0,0
Micronesia (Federated States of),2009,ep,014,8,8,16
Micronesia (Federated States of),2009,ep,1524,3,3,6
Micronesia (Federated States of),2009,ep,2534,3,0,3
Micronesia (Federated States of),2009,ep,3544,4,2,6
Micronesia (Federated States of),2009,ep,4554,0,1,1
Micronesia (Federated States of),2009,ep,5564,1,1,2
Micronesia (Federated States of),2009,ep,65,0,0,0
Micronesia (Federated States of),2009,sn,014,8,18,26
Micronesia (Federated States of),2009,sn,1524,7,8,15
Micronesia (Federated States of),2009,sn,2534,8,3,11
Micronesia (Federated States of),2009,sn,3544,3,6,9
Micronesia (Federated States of),2009,sn,4554,0,3,3
Micronesia (Federated States of),2009,sn,5564,3,6,9
Micronesia (Federated States of),2009,sn,65,2,0,2
Micronesia (Federated States of),2009,sp,014,8,5,13
Micronesia (Federated States of),2009,sp,1524,6,7,13
Micronesia (Federated States of),2009,sp,2534,9,5,14
Micronesia (Federated States of),2009,sp,3544,4,5,9
Micronesia (Federated States of),2009,sp,4554,4,2,6
Micronesia (Federated States of),2009,sp,5564,1,1,2
Micronesia (Federated States of),2009,sp,65,1,2,3
Micronesia (Federated States of),2010,ep,014,4,5,9
Micronesia (Federated States of),2010,ep,1524,2,3,5
Micronesia (Federated States of),2010,ep,2534,2,1,3
Micronesia (Federated States of),2010,ep,3544,1,4,5
Micronesia (Federated States of),2010,ep,4554,0,2,2
Micronesia (Federated States of),2010,ep,5564,1,0,1
Micronesia (Federated States of),2010,ep,65,0,0,0
Micronesia (Federated States of),2010,sn,014,11,16,27
Micronesia (Federated States of),2010,sn,1524,5,8,13
Micronesia (Federated States of),2010,sn,2534,4,6,10
Micronesia (Federated States of),2010,sn,3544,3,3,6
Micronesia (Federated States of),2010,sn,4554,5,2,7
Micronesia (Federated States of),2010,sn,5564,3,5,8
Micronesia (Federated States of),2010,sn,65,4,4,8
Micronesia (Federated States of),2010,sp,014,5,3,8
Micronesia (Federated States of),2010,sp,1524,8,8,16
Micronesia (Federated States of),2010,sp,2534,9,1,10
Micronesia (Federated States of),2010,sp,3544,3,2,5
Micronesia (Federated States of),2010,sp,4554,4,4,8
Micronesia (Federated States of),2010,sp,5564,2,4,6
Micronesia (Federated States of),2010,sp,65,0,0,0
Micronesia (Federated States of),2011,ep,014,1,5,6
Micronesia (Federated States of),2011,ep,1524,2,3,5
Micronesia (Federated States of),2011,ep,2534,3,3,6
Micronesia (Federated States of),2011,ep,3544,1,4,5
Micronesia (Federated States of),2011,ep,4554,0,2,2
Micronesia (Federated States of),2011,ep,5564,0,1,1
Micronesia (Federated States of),2011,ep,65,0,0,0
Micronesia (Federated States of),2011,sn,014,14,12,26
Micronesia (Federated States of),2011,sn,1524,2,5,7
Micronesia (Federated States of),2011,sn,2534,1,7,8
Micronesia (Federated States of),2011,sn,3544,2,4,6
Micronesia (Federated States of),2011,sn,4554,3,6,9
Micronesia (Federated States of),2011,sn,5564,8,5,13
Micronesia (Federated States of),2011,sn,65,1,3,4
Micronesia (Federated States of),2011,sp,014,5,4,9
Micronesia (Federated States of),2011,sp,1524,5,8,13
Micronesia (Federated States of),2011,sp,2534,2,5,7
Micronesia (Federated States of),2011,sp,3544,3,6,9
Micronesia (Federated States of),2011,sp,4554,1,2,3
Micronesia (Federated States of),2011,sp,5564,2,0,2
Micronesia (Federated States of),2011,sp,65,1,1,2
Micronesia (Federated States of),2012,ep,014,1,2,3
Micronesia (Federated States of),2012,ep,1524,2,4,6
Micronesia (Federated States of),2012,ep,2534,3,3,6
Micronesia (Federated States of),2012,ep,3544,2,2,4
Micronesia (Federated States of),2012,ep,4554,0,2,2
Micronesia (Federated States of),2012,ep,5564,0,1,1
Micronesia (Federated States of),2012,ep,65,0,0,0
Micronesia (Federated States of),2012,sn,014,15,14,29
Micronesia (Federated States of),2012,sn,1524,3,6,9
Micronesia (Federated States of),2012,sn,2534,1,6,7
Micronesia (Federated States of),2012,sn,3544,3,4,7
Micronesia (Federated States of),2012,sn,4554,3,6,9
Micronesia (Federated States of),2012,sn,5564,7,3,10
Micronesia (Federated States of),2012,sn,65,2,3,5
Micronesia (Federated States of),2012,sp,014,5,3,8
Micronesia (Federated States of),2012,sp,1524,6,8,14
Micronesia (Federated States of),2012,sp,2534,2,5,7
Micronesia (Federated States of),2012,sp,3544,3,4,7
Micronesia (Federated States of),2012,sp,4554,1,2,3
Micronesia (Federated States of),2012,sp,5564,3,0,3
Micronesia (Federated States of),2012,sp,65,0,1,1
Monaco,1999,sp,014,0,0,0
Monaco,1999,sp,1524,0,0,0
Monaco,1999,sp,2534,0,0,0
Monaco,1999,sp,3544,0,0,0
Monaco,1999,sp,4554,0,1,1
Monaco,1999,sp,5564,0,0,0
Monaco,1999,sp,65,1,0,1
Monaco,2010,ep,5564,1,NA,NA
Mongolia,1994,sp,014,10,1,11
Mongolia,1994,sp,1524,27,23,50
Mongolia,1994,sp,2534,24,40,64
Mongolia,1994,sp,3544,13,25,38
Mongolia,1994,sp,4554,8,19,27
Mongolia,1994,sp,5564,2,6,8
Mongolia,1994,sp,65,1,1,2
Mongolia,1995,sp,014,30,37,67
Mongolia,1995,sp,1524,70,99,169
Mongolia,1995,sp,2534,78,111,189
Mongolia,1995,sp,3544,33,68,101
Mongolia,1995,sp,4554,15,19,34
Mongolia,1995,sp,5564,9,13,22
Mongolia,1995,sp,65,25,15,40
Mongolia,1996,sp,014,17,8,25
Mongolia,1996,sp,1524,98,103,201
Mongolia,1996,sp,2534,114,150,264
Mongolia,1996,sp,3544,45,91,136
Mongolia,1996,sp,4554,27,42,69
Mongolia,1996,sp,5564,19,24,43
Mongolia,1996,sp,65,12,19,31
Mongolia,1997,sp,014,12,6,18
Mongolia,1997,sp,1524,109,173,282
Mongolia,1997,sp,2534,134,298,432
Mongolia,1997,sp,3544,71,204,275
Mongolia,1997,sp,4554,21,72,93
Mongolia,1997,sp,5564,13,32,45
Mongolia,1997,sp,65,9,17,26
Mongolia,1998,sp,014,32,17,49
Mongolia,1998,sp,1524,162,213,375
Mongolia,1998,sp,2534,221,251,472
Mongolia,1998,sp,3544,115,158,273
Mongolia,1998,sp,4554,32,65,97
Mongolia,1998,sp,5564,21,32,53
Mongolia,1998,sp,65,15,22,37
Mongolia,1999,sp,014,25,12,37
Mongolia,1999,sp,1524,205,213,418
Mongolia,1999,sp,2534,252,314,566
Mongolia,1999,sp,3544,113,178,291
Mongolia,1999,sp,4554,43,63,106
Mongolia,1999,sp,5564,18,34,52
Mongolia,1999,sp,65,17,26,43
Mongolia,2000,sp,014,32,6,38
Mongolia,2000,sp,1524,200,181,381
Mongolia,2000,sp,2534,213,260,473
Mongolia,2000,sp,3544,113,171,284
Mongolia,2000,sp,4554,41,68,109
Mongolia,2000,sp,5564,26,38,64
Mongolia,2000,sp,65,17,23,40
Mongolia,2001,sp,014,25,13,38
Mongolia,2001,sp,1524,253,236,489
Mongolia,2001,sp,2534,260,269,529
Mongolia,2001,sp,3544,125,179,304
Mongolia,2001,sp,4554,48,86,134
Mongolia,2001,sp,5564,28,45,73
Mongolia,2001,sp,65,29,36,65
Mongolia,2002,sp,014,16,9,25
Mongolia,2002,sp,1524,263,242,505
Mongolia,2002,sp,2534,253,272,525
Mongolia,2002,sp,3544,133,184,317
Mongolia,2002,sp,4554,55,94,149
Mongolia,2002,sp,5564,22,57,79
Mongolia,2002,sp,65,23,47,70
Mongolia,2003,sp,014,19,10,29
Mongolia,2003,sp,1524,254,206,460
Mongolia,2003,sp,2534,233,217,450
Mongolia,2003,sp,3544,148,171,319
Mongolia,2003,sp,4554,45,93,138
Mongolia,2003,sp,5564,32,55,87
Mongolia,2003,sp,65,19,39,58
Mongolia,2004,sp,014,18,6,24
Mongolia,2004,sp,1524,283,287,570
Mongolia,2004,sp,2534,249,256,505
Mongolia,2004,sp,3544,162,229,391
Mongolia,2004,sp,4554,62,112,174
Mongolia,2004,sp,5564,24,54,78
Mongolia,2004,sp,65,23,43,66
Mongolia,2005,sp,014,15,7,22
Mongolia,2005,sp,1524,320,271,591
Mongolia,2005,sp,2534,270,253,523
Mongolia,2005,sp,3544,145,232,377
Mongolia,2005,sp,4554,63,147,210
Mongolia,2005,sp,5564,32,52,84
Mongolia,2005,sp,65,25,36,61
Mongolia,2006,sp,014,16,7,23
Mongolia,2006,sp,1524,372,317,689
Mongolia,2006,sp,2534,265,335,600
Mongolia,2006,sp,3544,180,241,421
Mongolia,2006,sp,4554,81,157,238
Mongolia,2006,sp,5564,24,64,88
Mongolia,2006,sp,65,29,41,70
Mongolia,2007,sp,014,23,4,27
Mongolia,2007,sp,1524,273,280,553
Mongolia,2007,sp,2534,250,270,520
Mongolia,2007,sp,3544,139,232,371
Mongolia,2007,sp,4554,80,158,238
Mongolia,2007,sp,5564,36,48,84
Mongolia,2007,sp,65,29,34,63
Mongolia,2008,sp,014,18,7,25
Mongolia,2008,sp,1524,283,289,572
Mongolia,2008,sp,2534,229,260,489
Mongolia,2008,sp,3544,127,235,362
Mongolia,2008,sp,4554,86,151,237
Mongolia,2008,sp,5564,32,59,91
Mongolia,2008,sp,65,26,36,62
Mongolia,2009,sp,014,20,2,22
Mongolia,2009,sp,1524,306,280,586
Mongolia,2009,sp,2534,235,264,499
Mongolia,2009,sp,3544,140,199,339
Mongolia,2009,sp,4554,61,157,218
Mongolia,2009,sp,5564,27,64,91
Mongolia,2009,sp,65,27,27,54
Mongolia,2010,ep,014,84,111,195
Mongolia,2010,ep,1524,254,263,517
Mongolia,2010,ep,2534,204,201,405
Mongolia,2010,ep,3544,120,117,237
Mongolia,2010,ep,4554,98,92,190
Mongolia,2010,ep,5564,34,36,70
Mongolia,2010,ep,65,39,22,61
Mongolia,2010,sn,014,92,82,174
Mongolia,2010,sn,1524,103,85,188
Mongolia,2010,sn,2534,76,50,126
Mongolia,2010,sn,3544,30,39,69
Mongolia,2010,sn,4554,26,48,74
Mongolia,2010,sn,5564,8,25,33
Mongolia,2010,sn,65,13,24,37
Mongolia,2010,sp,014,12,3,15
Mongolia,2010,sp,1524,296,285,581
Mongolia,2010,sp,2534,246,255,501
Mongolia,2010,sp,3544,112,231,343
Mongolia,2010,sp,4554,83,154,237
Mongolia,2010,sp,5564,42,50,92
Mongolia,2010,sp,65,28,40,68
Mongolia,2011,ep,014,77,105,182
Mongolia,2011,ep,1524,221,268,489
Mongolia,2011,ep,2534,211,206,417
Mongolia,2011,ep,3544,115,118,233
Mongolia,2011,ep,4554,87,69,156
Mongolia,2011,ep,5564,25,28,53
Mongolia,2011,ep,65,20,28,48
Mongolia,2011,sn,014,81,95,176
Mongolia,2011,sn,1524,85,79,164
Mongolia,2011,sn,2534,70,50,120
Mongolia,2011,sn,3544,29,47,76
Mongolia,2011,sn,4554,26,44,70
Mongolia,2011,sn,5564,16,25,41
Mongolia,2011,sn,65,12,25,37
Mongolia,2011,sp,014,10,2,12
Mongolia,2011,sp,1524,250,246,496
Mongolia,2011,sp,2534,192,289,481
Mongolia,2011,sp,3544,121,205,326
Mongolia,2011,sp,4554,61,170,231
Mongolia,2011,sp,5564,40,71,111
Mongolia,2011,sp,65,25,41,66
Mongolia,2012,ep,014,76,89,165
Mongolia,2012,ep,1524,258,250,508
Mongolia,2012,ep,2534,169,230,399
Mongolia,2012,ep,3544,106,121,227
Mongolia,2012,ep,4554,84,86,170
Mongolia,2012,ep,5564,38,39,77
Mongolia,2012,ep,65,28,37,65
Mongolia,2012,sn,014,65,63,128
Mongolia,2012,sn,1524,77,70,147
Mongolia,2012,sn,2534,60,66,126
Mongolia,2012,sn,3544,25,56,81
Mongolia,2012,sn,4554,18,47,65
Mongolia,2012,sn,5564,16,21,37
Mongolia,2012,sn,65,15,18,33
Mongolia,2012,sp,014,11,7,18
Mongolia,2012,sp,1524,250,257,507
Mongolia,2012,sp,2534,208,268,476
Mongolia,2012,sp,3544,97,191,288
Mongolia,2012,sp,4554,82,184,266
Mongolia,2012,sp,5564,28,63,91
Mongolia,2012,sp,65,33,37,70
Mongolia,2013,rel,014,185,174,359
Mongolia,2013,rel,1524,579,621,1200
Mongolia,2013,rel,2534,541,576,1117
Mongolia,2013,rel,3544,241,457,698
Mongolia,2013,rel,4554,181,334,515
Mongolia,2013,rel,5564,92,166,258
Mongolia,2013,rel,65,83,101,184
Montenegro,2005,sp,014,0,0,0
Montenegro,2005,sp,1524,0,3,3
Montenegro,2005,sp,2534,7,5,12
Montenegro,2005,sp,3544,3,7,10
Montenegro,2005,sp,4554,4,15,19
Montenegro,2005,sp,5564,0,4,4
Montenegro,2005,sp,65,8,8,16
Montenegro,2006,ep,1524,1,3,4
Montenegro,2006,ep,2534,2,2,4
Montenegro,2006,ep,3544,0,1,1
Montenegro,2006,ep,4554,0,2,2
Montenegro,2006,ep,5564,0,4,4
Montenegro,2006,ep,65,2,0,2
Montenegro,2006,sn,014,1,NA,NA
Montenegro,2006,sn,1524,2,5,7
Montenegro,2006,sn,2534,2,2,4
Montenegro,2006,sn,3544,3,10,13
Montenegro,2006,sn,4554,3,15,18
Montenegro,2006,sn,5564,4,7,11
Montenegro,2006,sn,65,11,9,20
Montenegro,2006,sp,014,NA,0,NA
Montenegro,2006,sp,1524,3,0,3
Montenegro,2006,sp,2534,4,7,11
Montenegro,2006,sp,3544,4,7,11
Montenegro,2006,sp,4554,4,12,16
Montenegro,2006,sp,5564,3,9,12
Montenegro,2006,sp,65,2,3,5
Montenegro,2007,ep,014,0,0,0
Montenegro,2007,ep,1524,1,2,3
Montenegro,2007,ep,2534,2,3,5
Montenegro,2007,ep,3544,2,1,3
Montenegro,2007,ep,4554,1,2,3
Montenegro,2007,ep,5564,1,0,1
Montenegro,2007,ep,65,1,2,3
Montenegro,2007,sn,014,0,2,2
Montenegro,2007,sn,1524,4,4,8
Montenegro,2007,sn,2534,6,3,9
Montenegro,2007,sn,3544,7,6,13
Montenegro,2007,sn,4554,1,15,16
Montenegro,2007,sn,5564,3,9,12
Montenegro,2007,sn,65,3,15,18
Montenegro,2007,sp,014,0,0,0
Montenegro,2007,sp,1524,3,0,3
Montenegro,2007,sp,2534,3,6,9
Montenegro,2007,sp,3544,4,3,7
Montenegro,2007,sp,4554,3,10,13
Montenegro,2007,sp,5564,3,1,4
Montenegro,2007,sp,65,1,3,4
Montenegro,2008,ep,014,0,0,0
Montenegro,2008,ep,1524,3,0,3
Montenegro,2008,ep,2534,1,0,1
Montenegro,2008,ep,3544,2,3,5
Montenegro,2008,ep,4554,2,1,3
Montenegro,2008,ep,5564,3,1,4
Montenegro,2008,ep,65,0,4,4
Montenegro,2008,sn,014,1,0,1
Montenegro,2008,sn,1524,3,2,5
Montenegro,2008,sn,2534,1,4,5
Montenegro,2008,sn,3544,3,1,4
Montenegro,2008,sn,4554,3,4,7
Montenegro,2008,sn,5564,3,3,6
Montenegro,2008,sn,65,7,3,10
Montenegro,2008,sp,014,0,0,0
Montenegro,2008,sp,1524,4,2,6
Montenegro,2008,sp,2534,5,7,12
Montenegro,2008,sp,3544,5,10,15
Montenegro,2008,sp,4554,10,5,15
Montenegro,2008,sp,5564,4,5,9
Montenegro,2008,sp,65,7,1,8
Montenegro,2009,ep,014,0,0,0
Montenegro,2009,ep,1524,0,1,1
Montenegro,2009,ep,2534,1,1,2
Montenegro,2009,ep,3544,0,1,1
Montenegro,2009,ep,4554,3,2,5
Montenegro,2009,ep,5564,1,0,1
Montenegro,2009,ep,65,0,2,2
Montenegro,2009,sn,014,1,0,1
Montenegro,2009,sn,1524,4,3,7
Montenegro,2009,sn,2534,1,1,2
Montenegro,2009,sn,3544,2,8,10
Montenegro,2009,sn,4554,5,5,10
Montenegro,2009,sn,5564,4,2,6
Montenegro,2009,sn,65,2,5,7
Montenegro,2009,sp,014,1,0,1
Montenegro,2009,sp,1524,1,1,2
Montenegro,2009,sp,2534,5,5,10
Montenegro,2009,sp,3544,3,6,9
Montenegro,2009,sp,4554,2,10,12
Montenegro,2009,sp,5564,2,5,7
Montenegro,2009,sp,65,3,9,12
Montenegro,2010,ep,014,0,1,1
Montenegro,2010,ep,1524,1,1,2
Montenegro,2010,ep,2534,1,1,2
Montenegro,2010,ep,3544,1,2,3
Montenegro,2010,ep,4554,0,3,3
Montenegro,2010,ep,5564,1,0,1
Montenegro,2010,ep,65,2,0,2
Montenegro,2010,sn,014,0,1,1
Montenegro,2010,sn,1524,5,1,6
Montenegro,2010,sn,2534,2,2,4
Montenegro,2010,sn,3544,3,2,5
Montenegro,2010,sn,4554,1,7,8
Montenegro,2010,sn,5564,3,7,10
Montenegro,2010,sn,65,6,9,15
Montenegro,2010,sp,014,1,0,1
Montenegro,2010,sp,1524,3,1,4
Montenegro,2010,sp,2534,3,1,4
Montenegro,2010,sp,3544,2,4,6
Montenegro,2010,sp,4554,3,4,7
Montenegro,2010,sp,5564,1,7,8
Montenegro,2010,sp,65,8,1,9
Montenegro,2011,ep,014,1,0,1
Montenegro,2011,ep,1524,1,1,2
Montenegro,2011,ep,2534,1,0,1
Montenegro,2011,ep,3544,2,0,2
Montenegro,2011,ep,4554,1,0,1
Montenegro,2011,ep,5564,1,1,2
Montenegro,2011,ep,65,3,0,3
Montenegro,2011,sn,014,1,0,1
Montenegro,2011,sn,1524,6,1,7
Montenegro,2011,sn,2534,1,6,7
Montenegro,2011,sn,3544,3,3,6
Montenegro,2011,sn,4554,5,6,11
Montenegro,2011,sn,5564,1,1,2
Montenegro,2011,sn,65,2,4,6
Montenegro,2011,sp,014,1,0,1
Montenegro,2011,sp,1524,4,1,5
Montenegro,2011,sp,2534,2,2,4
Montenegro,2011,sp,3544,4,8,12
Montenegro,2011,sp,4554,3,11,14
Montenegro,2011,sp,5564,1,7,8
Montenegro,2011,sp,65,1,3,4
Montenegro,2012,ep,014,0,0,0
Montenegro,2012,ep,1524,0,0,0
Montenegro,2012,ep,2534,1,0,1
Montenegro,2012,ep,3544,1,2,3
Montenegro,2012,ep,4554,2,1,3
Montenegro,2012,ep,5564,1,2,3
Montenegro,2012,ep,65,3,0,3
Montenegro,2012,sn,014,0,0,0
Montenegro,2012,sn,1524,1,0,1
Montenegro,2012,sn,2534,6,2,8
Montenegro,2012,sn,3544,1,5,6
Montenegro,2012,sn,4554,1,3,4
Montenegro,2012,sn,5564,4,4,8
Montenegro,2012,sn,65,0,9,9
Montenegro,2012,sp,014,0,0,0
Montenegro,2012,sp,1524,4,3,7
Montenegro,2012,sp,2534,5,4,9
Montenegro,2012,sp,3544,1,5,6
Montenegro,2012,sp,4554,2,10,12
Montenegro,2012,sp,5564,1,3,4
Montenegro,2012,sp,65,3,4,7
Montenegro,2013,rel,014,1,0,1
Montenegro,2013,rel,1524,6,8,14
Montenegro,2013,rel,2534,6,8,14
Montenegro,2013,rel,3544,7,17,24
Montenegro,2013,rel,4554,6,16,22
Montenegro,2013,rel,5564,8,11,19
Montenegro,2013,rel,65,11,14,25
Montserrat,2003,sp,014,0,0,0
Montserrat,2003,sp,1524,0,0,0
Montserrat,2003,sp,2534,0,1,1
Montserrat,2003,sp,3544,0,0,0
Montserrat,2003,sp,4554,0,0,0
Montserrat,2003,sp,5564,0,0,0
Montserrat,2003,sp,65,0,1,1
Montserrat,2004,sp,014,0,0,0
Montserrat,2004,sp,1524,0,0,0
Montserrat,2004,sp,2534,0,0,0
Montserrat,2004,sp,3544,0,0,0
Montserrat,2004,sp,4554,0,0,0
Montserrat,2004,sp,5564,0,0,0
Montserrat,2004,sp,65,0,0,0
Montserrat,2005,sp,4554,NA,1,NA
Montserrat,2007,sp,65,1,NA,NA
Montserrat,2010,ep,014,0,0,0
Montserrat,2010,ep,1524,0,0,0
Montserrat,2010,ep,2534,0,0,0
Montserrat,2010,ep,3544,0,0,0
Montserrat,2010,ep,4554,0,0,0
Montserrat,2010,ep,5564,0,0,0
Montserrat,2010,ep,65,0,0,0
Montserrat,2010,sn,014,0,0,0
Montserrat,2010,sn,1524,0,0,0
Montserrat,2010,sn,2534,0,0,0
Montserrat,2010,sn,3544,0,0,0
Montserrat,2010,sn,4554,0,0,0
Montserrat,2010,sn,5564,0,0,0
Montserrat,2010,sn,65,0,0,0
Montserrat,2010,sp,014,0,0,0
Montserrat,2010,sp,1524,0,0,0
Montserrat,2010,sp,2534,0,0,0
Montserrat,2010,sp,3544,0,0,0
Montserrat,2010,sp,4554,0,0,0
Montserrat,2010,sp,5564,0,0,0
Montserrat,2010,sp,65,0,0,0
Montserrat,2011,ep,014,0,0,0
Montserrat,2011,ep,1524,0,0,0
Montserrat,2011,ep,2534,0,0,0
Montserrat,2011,ep,3544,0,0,0
Montserrat,2011,ep,4554,0,0,0
Montserrat,2011,ep,5564,0,0,0
Montserrat,2011,ep,65,0,0,0
Montserrat,2011,sn,014,0,0,0
Montserrat,2011,sn,1524,0,0,0
Montserrat,2011,sn,2534,0,0,0
Montserrat,2011,sn,3544,0,0,0
Montserrat,2011,sn,4554,0,0,0
Montserrat,2011,sn,5564,0,0,0
Montserrat,2011,sn,65,0,0,0
Montserrat,2011,sp,014,0,0,0
Montserrat,2011,sp,1524,0,0,0
Montserrat,2011,sp,2534,0,0,0
Montserrat,2011,sp,3544,0,0,0
Montserrat,2011,sp,4554,0,0,0
Montserrat,2011,sp,5564,0,0,0
Montserrat,2011,sp,65,0,0,0
Montserrat,2012,ep,014,0,0,0
Montserrat,2012,ep,1524,0,0,0
Montserrat,2012,ep,2534,0,0,0
Montserrat,2012,ep,3544,0,0,0
Montserrat,2012,ep,4554,0,0,0
Montserrat,2012,ep,5564,0,0,0
Montserrat,2012,ep,65,0,0,0
Montserrat,2012,sn,014,0,0,0
Montserrat,2012,sn,1524,0,0,0
Montserrat,2012,sn,2534,0,0,0
Montserrat,2012,sn,3544,0,0,0
Montserrat,2012,sn,4554,0,0,0
Montserrat,2012,sn,5564,0,0,0
Montserrat,2012,sn,65,0,0,0
Montserrat,2012,sp,014,0,0,0
Montserrat,2012,sp,1524,0,0,0
Montserrat,2012,sp,2534,0,0,0
Montserrat,2012,sp,3544,0,0,0
Montserrat,2012,sp,4554,0,0,0
Montserrat,2012,sp,5564,0,0,0
Montserrat,2012,sp,65,0,0,0
Morocco,1995,sp,014,191,142,333
Morocco,1995,sp,1524,1708,2508,4216
Morocco,1995,sp,2534,1288,2872,4160
Morocco,1995,sp,3544,703,1737,2440
Morocco,1995,sp,4554,461,819,1280
Morocco,1995,sp,5564,317,573,890
Morocco,1995,sp,65,299,553,852
Morocco,1996,sp,014,217,118,335
Morocco,1996,sp,1524,1697,2618,4315
Morocco,1996,sp,2534,1300,2844,4144
Morocco,1996,sp,3544,677,1721,2398
Morocco,1996,sp,4554,437,772,1209
Morocco,1996,sp,5564,400,602,1002
Morocco,1996,sp,65,292,583,875
Morocco,1997,sp,014,238,119,357
Morocco,1997,sp,1524,1799,2328,4127
Morocco,1997,sp,2534,1331,2891,4222
Morocco,1997,sp,3544,745,1659,2404
Morocco,1997,sp,4554,416,761,1177
Morocco,1997,sp,5564,424,591,1015
Morocco,1997,sp,65,275,557,832
Morocco,1998,sp,014,182,116,298
Morocco,1998,sp,1524,1600,2308,3908
Morocco,1998,sp,2534,1150,2573,3723
Morocco,1998,sp,3544,679,1744,2423
Morocco,1998,sp,4554,412,843,1255
Morocco,1998,sp,5564,402,560,962
Morocco,1998,sp,65,330,527,857
Morocco,1999,sp,014,156,78,234
Morocco,1999,sp,1524,1654,2296,3950
Morocco,1999,sp,2534,1143,2696,3839
Morocco,1999,sp,3544,691,1641,2332
Morocco,1999,sp,4554,446,815,1261
Morocco,1999,sp,5564,351,559,910
Morocco,1999,sp,65,332,562,894
Morocco,2000,sp,014,170,99,269
Morocco,2000,sp,1524,1530,2061,3591
Morocco,2000,sp,2534,1121,2423,3544
Morocco,2000,sp,3544,672,1705,2377
Morocco,2000,sp,4554,398,855,1253
Morocco,2000,sp,5564,406,485,891
Morocco,2000,sp,65,352,595,947
Morocco,2001,sp,014,156,85,241
Morocco,2001,sp,1524,1477,2200,3677
Morocco,2001,sp,2534,1046,2256,3302
Morocco,2001,sp,3544,596,1731,2327
Morocco,2001,sp,4554,402,929,1331
Morocco,2001,sp,5564,399,561,960
Morocco,2001,sp,65,360,606,966
Morocco,2002,sp,014,144,79,223
Morocco,2002,sp,1524,1483,2190,3673
Morocco,2002,sp,2534,1088,2341,3429
Morocco,2002,sp,3544,713,1647,2360
Morocco,2002,sp,4554,443,941,1384
Morocco,2002,sp,5564,357,525,882
Morocco,2002,sp,65,386,577,963
Morocco,2003,sp,014,168,91,259
Morocco,2003,sp,1524,1455,2225,3680
Morocco,2003,sp,2534,1029,2347,3376
Morocco,2003,sp,3544,633,1667,2300
Morocco,2003,sp,4554,431,1004,1435
Morocco,2003,sp,5564,366,525,891
Morocco,2003,sp,65,351,550,901
Morocco,2004,sp,014,149,68,217
Morocco,2004,sp,1524,1196,2081,3277
Morocco,2004,sp,2534,981,2397,3378
Morocco,2004,sp,3544,517,1676,2193
Morocco,2004,sp,4554,373,1114,1487
Morocco,2004,sp,5564,331,533,864
Morocco,2004,sp,65,325,539,864
Morocco,2005,sp,014,167,79,246
Morocco,2005,sp,1524,1330,2222,3552
Morocco,2005,sp,2534,943,2515,3458
Morocco,2005,sp,3544,546,1583,2129
Morocco,2005,sp,4554,403,1057,1460
Morocco,2005,sp,5564,343,580,923
Morocco,2005,sp,65,398,591,989
Morocco,2006,ep,014,984,1125,2109
Morocco,2006,ep,1524,1517,1694,3211
Morocco,2006,ep,2534,1284,1263,2547
Morocco,2006,ep,3544,796,684,1480
Morocco,2006,ep,4554,582,470,1052
Morocco,2006,ep,5564,360,294,654
Morocco,2006,ep,65,317,394,711
Morocco,2006,sn,014,85,72,157
Morocco,2006,sn,1524,214,273,487
Morocco,2006,sn,2534,166,249,415
Morocco,2006,sn,3544,126,173,299
Morocco,2006,sn,4554,90,162,252
Morocco,2006,sn,5564,82,113,195
Morocco,2006,sn,65,101,149,250
Morocco,2006,sp,014,155,73,228
Morocco,2006,sp,1524,1273,2104,3377
Morocco,2006,sp,2534,1025,2373,3398
Morocco,2006,sp,3544,597,1498,2095
Morocco,2006,sp,4554,426,1036,1462
Morocco,2006,sp,5564,335,527,862
Morocco,2006,sp,65,307,551,858
Morocco,2007,ep,014,876,948,1824
Morocco,2007,ep,1524,1571,1600,3171
Morocco,2007,ep,2534,1302,1253,2555
Morocco,2007,ep,3544,844,625,1469
Morocco,2007,ep,4554,575,448,1023
Morocco,2007,ep,5564,380,286,666
Morocco,2007,ep,65,402,456,858
Morocco,2007,sn,014,82,50,132
Morocco,2007,sn,1524,220,259,479
Morocco,2007,sn,2534,166,254,420
Morocco,2007,sn,3544,97,185,282
Morocco,2007,sn,4554,91,177,268
Morocco,2007,sn,5564,69,128,197
Morocco,2007,sn,65,122,159,281
Morocco,2007,sp,014,123,74,197
Morocco,2007,sp,1524,1177,2098,3275
Morocco,2007,sp,2534,837,2370,3207
Morocco,2007,sp,3544,444,1545,1989
Morocco,2007,sp,4554,354,1165,1519
Morocco,2007,sp,5564,306,545,851
Morocco,2007,sp,65,370,529,899
Morocco,2008,ep,014,921,990,1911
Morocco,2008,ep,1524,1446,1494,2940
Morocco,2008,ep,2534,1388,1263,2651
Morocco,2008,ep,3544,863,644,1507
Morocco,2008,ep,4554,637,464,1101
Morocco,2008,ep,5564,379,321,700
Morocco,2008,ep,65,399,437,836
Morocco,2008,sn,014,58,45,103
Morocco,2008,sn,1524,185,289,474
Morocco,2008,sn,2534,146,253,399
Morocco,2008,sn,3544,104,169,273
Morocco,2008,sn,4554,113,171,284
Morocco,2008,sn,5564,83,117,200
Morocco,2008,sn,65,109,160,269
Morocco,2008,sp,014,124,51,175
Morocco,2008,sp,1524,1081,1992,3073
Morocco,2008,sp,2534,803,2372,3175
Morocco,2008,sp,3544,479,1514,1993
Morocco,2008,sp,4554,360,1179,1539
Morocco,2008,sp,5564,290,633,923
Morocco,2008,sp,65,358,589,947
Morocco,2009,ep,014,954,992,1946
Morocco,2009,ep,1524,1486,1626,3112
Morocco,2009,ep,2534,1400,1330,2730
Morocco,2009,ep,3544,840,675,1515
Morocco,2009,ep,4554,648,534,1182
Morocco,2009,ep,5564,421,371,792
Morocco,2009,ep,65,424,430,854
Morocco,2009,sn,014,58,65,123
Morocco,2009,sn,1524,199,262,461
Morocco,2009,sn,2534,154,242,396
Morocco,2009,sn,3544,112,182,294
Morocco,2009,sn,4554,103,163,266
Morocco,2009,sn,5564,88,138,226
Morocco,2009,sn,65,103,152,255
Morocco,2009,sp,014,132,63,195
Morocco,2009,sp,1524,1195,1960,3155
Morocco,2009,sp,2534,889,2412,3301
Morocco,2009,sp,3544,450,1428,1878
Morocco,2009,sp,4554,410,1140,1550
Morocco,2009,sp,5564,333,639,972
Morocco,2009,sp,65,346,510,856
Morocco,2010,ep,014,932,949,1881
Morocco,2010,ep,1524,1723,1711,3434
Morocco,2010,ep,2534,1510,1427,2937
Morocco,2010,ep,3544,878,684,1562
Morocco,2010,ep,4554,775,490,1265
Morocco,2010,ep,5564,435,366,801
Morocco,2010,ep,65,418,432,850
Morocco,2010,sn,014,69,41,110
Morocco,2010,sn,1524,202,307,509
Morocco,2010,sn,2534,162,295,457
Morocco,2010,sn,3544,118,202,320
Morocco,2010,sn,4554,89,190,279
Morocco,2010,sn,5564,89,117,206
Morocco,2010,sn,65,117,176,293
Morocco,2010,sp,014,117,51,168
Morocco,2010,sp,1524,1098,1982,3080
Morocco,2010,sp,2534,841,2553,3394
Morocco,2010,sp,3544,426,1611,2037
Morocco,2010,sp,4554,386,1273,1659
Morocco,2010,sp,5564,310,712,1022
Morocco,2010,sp,65,364,515,879
Morocco,2011,ep,014,948,1004,1952
Morocco,2011,ep,1524,1765,1662,3427
Morocco,2011,ep,2534,1663,1413,3076
Morocco,2011,ep,3544,980,698,1678
Morocco,2011,ep,4554,796,522,1318
Morocco,2011,ep,5564,483,400,883
Morocco,2011,ep,65,470,527,997
Morocco,2011,sn,014,64,47,111
Morocco,2011,sn,1524,221,325,546
Morocco,2011,sn,2534,160,341,501
Morocco,2011,sn,3544,118,199,317
Morocco,2011,sn,4554,124,180,304
Morocco,2011,sn,5564,85,144,229
Morocco,2011,sn,65,116,148,264
Morocco,2011,sp,014,100,79,179
Morocco,2011,sp,1524,1153,1929,3082
Morocco,2011,sp,2534,794,2450,3244
Morocco,2011,sp,3544,433,1479,1912
Morocco,2011,sp,4554,371,1175,1546
Morocco,2011,sp,5564,324,682,1006
Morocco,2011,sp,65,335,518,853
Morocco,2012,ep,014,905,863,1768
Morocco,2012,ep,1524,1822,1807,3629
Morocco,2012,ep,2534,1592,1503,3095
Morocco,2012,ep,3544,1016,704,1720
Morocco,2012,ep,4554,803,534,1337
Morocco,2012,ep,5564,563,440,1003
Morocco,2012,ep,65,479,491,970
Morocco,2012,sn,014,56,45,101
Morocco,2012,sn,1524,227,331,558
Morocco,2012,sn,2534,176,332,508
Morocco,2012,sn,3544,115,225,340
Morocco,2012,sn,4554,103,187,290
Morocco,2012,sn,5564,88,165,253
Morocco,2012,sn,65,142,151,293
Morocco,2012,sp,014,77,54,131
Morocco,2012,sp,1524,1162,1840,3002
Morocco,2012,sp,2534,832,2426,3258
Morocco,2012,sp,3544,408,1423,1831
Morocco,2012,sp,4554,306,1183,1489
Morocco,2012,sp,5564,286,672,958
Morocco,2012,sp,65,342,561,903
Morocco,2013,rel,014,1085,966,2051
Morocco,2013,rel,1524,3097,4109,7206
Morocco,2013,rel,2534,2569,4164,6733
Morocco,2013,rel,3544,1572,2383,3955
Morocco,2013,rel,4554,1174,1946,3120
Morocco,2013,rel,5564,1006,1389,2395
Morocco,2013,rel,65,921,1185,2106
Mozambique,1995,sp,014,226,187,413
Mozambique,1995,sp,1524,994,1136,2130
Mozambique,1995,sp,2534,1314,1475,2789
Mozambique,1995,sp,3544,1016,1338,2354
Mozambique,1995,sp,4554,551,1022,1573
Mozambique,1995,sp,5564,234,664,898
Mozambique,1995,sp,65,89,320,409
Mozambique,1996,sp,014,205,141,346
Mozambique,1996,sp,1524,1060,1163,2223
Mozambique,1996,sp,2534,1357,1507,2864
Mozambique,1996,sp,3544,938,1367,2305
Mozambique,1996,sp,4554,533,980,1513
Mozambique,1996,sp,5564,239,639,878
Mozambique,1996,sp,65,74,275,349
Mozambique,1997,sp,014,187,163,350
Mozambique,1997,sp,1524,1147,1194,2341
Mozambique,1997,sp,2534,1381,1608,2989
Mozambique,1997,sp,3544,1002,1439,2441
Mozambique,1997,sp,4554,606,1076,1682
Mozambique,1997,sp,5564,265,666,931
Mozambique,1997,sp,65,78,313,391
Myanmar,1995,sp,014,58,42,100
Myanmar,1995,sp,1524,535,713,1248
Myanmar,1995,sp,2534,729,1423,2152
Myanmar,1995,sp,3544,729,1401,2130
Myanmar,1995,sp,4554,450,977,1427
Myanmar,1995,sp,5564,343,677,1020
Myanmar,1995,sp,65,154,298,452
Myanmar,1996,sp,014,55,58,113
Myanmar,1996,sp,1524,577,767,1344
Myanmar,1996,sp,2534,938,1511,2449
Myanmar,1996,sp,3544,817,1535,2352
Myanmar,1996,sp,4554,558,1110,1668
Myanmar,1996,sp,5564,408,798,1206
Myanmar,1996,sp,65,184,400,584
Myanmar,1997,sp,014,54,56,110
Myanmar,1997,sp,1524,535,676,1211
Myanmar,1997,sp,2534,883,1452,2335
Myanmar,1997,sp,3544,715,1405,2120
Myanmar,1997,sp,4554,492,1061,1553
Myanmar,1997,sp,5564,308,753,1061
Myanmar,1997,sp,65,183,441,624
Myanmar,1998,sp,014,73,64,137
Myanmar,1998,sp,1524,650,798,1448
Myanmar,1998,sp,2534,997,1491,2488
Myanmar,1998,sp,3544,856,1584,2440
Myanmar,1998,sp,4554,577,1187,1764
Myanmar,1998,sp,5564,382,763,1145
Myanmar,1998,sp,65,229,438,667
Myanmar,1999,sp,014,58,37,95
Myanmar,1999,sp,1524,737,936,1673
Myanmar,1999,sp,2534,1076,1800,2876
Myanmar,1999,sp,3544,919,1805,2724
Myanmar,1999,sp,4554,647,1366,2013
Myanmar,1999,sp,5564,420,833,1253
Myanmar,1999,sp,65,284,540,824
Myanmar,2000,sp,014,72,88,160
Myanmar,2000,sp,1524,1040,1459,2499
Myanmar,2000,sp,2534,1592,2636,4228
Myanmar,2000,sp,3544,1397,2781,4178
Myanmar,2000,sp,4554,987,2161,3148
Myanmar,2000,sp,5564,592,1235,1827
Myanmar,2000,sp,65,378,836,1214
Myanmar,2001,sp,014,98,69,167
Myanmar,2001,sp,1524,1306,1800,3106
Myanmar,2001,sp,2534,1918,3253,5171
Myanmar,2001,sp,3544,1568,3353,4921
Myanmar,2001,sp,4554,1186,2624,3810
Myanmar,2001,sp,5564,650,1443,2093
Myanmar,2001,sp,65,487,931,1418
Myanmar,2002,sp,014,109,64,173
Myanmar,2002,sp,1524,1563,2125,3688
Myanmar,2002,sp,2534,2044,3986,6030
Myanmar,2002,sp,3544,1758,4016,5774
Myanmar,2002,sp,4554,1348,3022,4370
Myanmar,2002,sp,5564,845,1671,2516
Myanmar,2002,sp,65,544,1067,1611
Myanmar,2003,sp,014,154,107,261
Myanmar,2003,sp,1524,1781,2536,4317
Myanmar,2003,sp,2534,2442,4408,6850
Myanmar,2003,sp,3544,2003,4427,6430
Myanmar,2003,sp,4554,1491,3269,4760
Myanmar,2003,sp,5564,943,1974,2917
Myanmar,2003,sp,65,617,1296,1913
Myanmar,2004,sp,014,120,96,216
Myanmar,2004,sp,1524,2020,2777,4797
Myanmar,2004,sp,2534,2622,5025,7647
Myanmar,2004,sp,3544,2228,4966,7194
Myanmar,2004,sp,4554,1800,4081,5881
Myanmar,2004,sp,5564,1122,2271,3393
Myanmar,2004,sp,65,713,1567,2280
Myanmar,2005,sp,014,147,132,279
Myanmar,2005,sp,1524,2376,3401,5777
Myanmar,2005,sp,2534,3047,5877,8924
Myanmar,2005,sp,3544,2563,5888,8451
Myanmar,2005,sp,4554,2101,4585,6686
Myanmar,2005,sp,5564,1218,2557,3775
Myanmar,2005,sp,65,885,1764,2649
Myanmar,2006,sp,014,171,113,284
Myanmar,2006,sp,1524,2453,3572,6025
Myanmar,2006,sp,2534,3338,6328,9666
Myanmar,2006,sp,3544,2820,6536,9356
Myanmar,2006,sp,4554,2282,5143,7425
Myanmar,2006,sp,5564,1448,2988,4436
Myanmar,2006,sp,65,1016,2033,3049
Myanmar,2007,sp,014,159,127,286
Myanmar,2007,sp,1524,2719,3591,6310
Myanmar,2007,sp,2534,3500,6569,10069
Myanmar,2007,sp,3544,2998,6826,9824
Myanmar,2007,sp,4554,2486,5507,7993
Myanmar,2007,sp,5564,1601,3152,4753
Myanmar,2007,sp,65,1198,2155,3353
Myanmar,2008,sp,014,180,118,298
Myanmar,2008,sp,1524,2526,3416,5942
Myanmar,2008,sp,2534,3474,6311,9785
Myanmar,2008,sp,3544,2850,6396,9246
Myanmar,2008,sp,4554,2357,5327,7684
Myanmar,2008,sp,5564,1644,3312,4956
Myanmar,2008,sp,65,1102,2235,3337
Myanmar,2009,sp,014,165,127,292
Myanmar,2009,sp,1524,2559,3259,5818
Myanmar,2009,sp,2534,3298,6371,9669
Myanmar,2009,sp,3544,2745,6633,9378
Myanmar,2009,sp,4554,2463,5319,7782
Myanmar,2009,sp,5564,1679,3435,5114
Myanmar,2009,sp,65,1100,2248,3348
Myanmar,2010,sp,014,196,106,302
Myanmar,2010,sp,1524,2452,3043,5495
Myanmar,2010,sp,2534,3454,6578,10032
Myanmar,2010,sp,3544,2752,6688,9440
Myanmar,2010,sp,4554,2525,5607,8132
Myanmar,2010,sp,5564,1838,3632,5470
Myanmar,2010,sp,65,1139,2308,3447
Myanmar,2011,sp,014,187,120,307
Myanmar,2011,sp,1524,2401,2923,5324
Myanmar,2011,sp,2534,3317,6182,9499
Myanmar,2011,sp,3544,2760,6319,9079
Myanmar,2011,sp,4554,2554,5680,8234
Myanmar,2011,sp,5564,2010,3954,5964
Myanmar,2011,sp,65,1407,2500,3907
Myanmar,2012,sp,014,192,146,338
Myanmar,2012,sp,1524,2357,2898,5255
Myanmar,2012,sp,2534,3368,6263,9631
Myanmar,2012,sp,3544,2721,6469,9190
Myanmar,2012,sp,4554,2600,5837,8437
Myanmar,2012,sp,5564,2023,3945,5968
Myanmar,2012,sp,65,1464,2626,4090
Namibia,1995,sp,014,5,0,5
Namibia,1995,sp,1524,49,68,117
Namibia,1995,sp,2534,78,235,313
Namibia,1995,sp,3544,50,113,163
Namibia,1995,sp,4554,16,55,71
Namibia,1995,sp,5564,1,21,22
Namibia,1995,sp,65,0,6,6
Namibia,1996,sp,014,17,16,33
Namibia,1996,sp,1524,249,205,454
Namibia,1996,sp,2534,330,613,943
Namibia,1996,sp,3544,245,472,717
Namibia,1996,sp,4554,87,230,317
Namibia,1996,sp,5564,72,137,209
Namibia,1996,sp,65,51,101,152
Namibia,1997,sp,014,23,18,41
Namibia,1997,sp,1524,249,232,481
Namibia,1997,sp,2534,401,791,1192
Namibia,1997,sp,3544,275,479,754
Namibia,1997,sp,4554,104,296,400
Namibia,1997,sp,5564,56,161,217
Namibia,1997,sp,65,47,93,140
Namibia,1998,sp,014,34,21,55
Namibia,1998,sp,1524,300,270,570
Namibia,1998,sp,2534,536,816,1352
Namibia,1998,sp,3544,310,541,851
Namibia,1998,sp,4554,117,267,384
Namibia,1998,sp,5564,62,148,210
Namibia,1998,sp,65,65,111,176
Namibia,1999,sp,014,25,20,45
Namibia,1999,sp,1524,339,247,586
Namibia,1999,sp,2534,540,908,1448
Namibia,1999,sp,3544,336,613,949
Namibia,1999,sp,4554,114,260,374
Namibia,1999,sp,5564,77,135,212
Namibia,1999,sp,65,36,110,146
Namibia,2000,sp,014,16,18,34
Namibia,2000,sp,1524,352,269,621
Namibia,2000,sp,2534,654,874,1528
Namibia,2000,sp,3544,348,665,1013
Namibia,2000,sp,4554,161,300,461
Namibia,2000,sp,5564,76,147,223
Namibia,2000,sp,65,52,81,133
Namibia,2001,sp,014,32,20,52
Namibia,2001,sp,1524,394,322,716
Namibia,2001,sp,2534,729,993,1722
Namibia,2001,sp,3544,404,732,1136
Namibia,2001,sp,4554,168,318,486
Namibia,2001,sp,5564,91,150,241
Namibia,2001,sp,65,66,116,182
Namibia,2002,sp,014,42,19,61
Namibia,2002,sp,1524,357,301,658
Namibia,2002,sp,2534,795,1033,1828
Namibia,2002,sp,3544,484,750,1234
Namibia,2002,sp,4554,182,326,508
Namibia,2002,sp,5564,91,146,237
Namibia,2002,sp,65,67,96,163
Namibia,2003,sp,014,47,31,78
Namibia,2003,sp,1524,451,364,815
Namibia,2003,sp,2534,927,1109,2036
Namibia,2003,sp,3544,571,838,1409
Namibia,2003,sp,4554,216,419,635
Namibia,2003,sp,5564,108,196,304
Namibia,2003,sp,65,102,108,210
Namibia,2004,sp,014,30,31,61
Namibia,2004,sp,1524,400,319,719
Namibia,2004,sp,2534,819,1092,1911
Namibia,2004,sp,3544,554,866,1420
Namibia,2004,sp,4554,203,371,574
Namibia,2004,sp,5564,106,159,265
Namibia,2004,sp,65,74,131,205
Namibia,2005,sp,014,105,98,203
Namibia,2005,sp,1524,399,355,754
Namibia,2005,sp,2534,809,1027,1836
Namibia,2005,sp,3544,525,874,1399
Namibia,2005,sp,4554,213,365,578
Namibia,2005,sp,5564,95,146,241
Namibia,2005,sp,65,91,120,211
Namibia,2006,sp,014,74,86,160
Namibia,2006,sp,1524,485,347,832
Namibia,2006,sp,2534,875,1052,1927
Namibia,2006,sp,3544,521,799,1320
Namibia,2006,sp,4554,239,386,625
Namibia,2006,sp,5564,92,174,266
Namibia,2006,sp,65,80,146,226
Namibia,2007,sp,014,69,57,126
Namibia,2007,sp,1524,417,370,787
Namibia,2007,sp,2534,826,1018,1844
Namibia,2007,sp,3544,513,786,1299
Namibia,2007,sp,4554,242,346,588
Namibia,2007,sp,5564,102,149,251
Namibia,2007,sp,65,76,120,196
Namibia,2008,sp,014,73,30,103
Namibia,2008,sp,1524,466,387,853
Namibia,2008,sp,2534,702,1033,1735
Namibia,2008,sp,3544,437,757,1194
Namibia,2008,sp,4554,226,346,572
Namibia,2008,sp,5564,110,149,259
Namibia,2008,sp,65,80,132,212
Namibia,2009,sp,014,84,41,125
Namibia,2009,sp,1524,384,357,741
Namibia,2009,sp,2534,678,936,1614
Namibia,2009,sp,3544,407,689,1096
Namibia,2009,sp,4554,214,348,562
Namibia,2009,sp,5564,97,166,263
Namibia,2009,sp,65,86,121,207
Namibia,2010,sp,014,67,36,103
Namibia,2010,sp,1524,429,359,788
Namibia,2010,sp,2534,685,852,1537
Namibia,2010,sp,3544,382,680,1062
Namibia,2010,sp,4554,206,287,493
Namibia,2010,sp,5564,122,146,268
Namibia,2010,sp,65,87,126,213
Namibia,2011,sp,014,78,48,126
Namibia,2011,sp,1524,427,337,764
Namibia,2011,sp,2534,653,844,1497
Namibia,2011,sp,3544,410,660,1070
Namibia,2011,sp,4554,185,361,546
Namibia,2011,sp,5564,100,152,252
Namibia,2011,sp,65,110,138,248
Namibia,2012,ep,014,163,180,343
Namibia,2012,ep,1524,116,126,242
Namibia,2012,ep,2534,219,228,447
Namibia,2012,ep,3544,177,261,438
Namibia,2012,ep,4554,84,138,222
Namibia,2012,ep,5564,25,46,71
Namibia,2012,ep,65,47,55,102
Namibia,2012,sn,014,339,386,725
Namibia,2012,sn,1524,200,153,353
Namibia,2012,sn,2534,379,477,856
Namibia,2012,sn,3544,306,516,822
Namibia,2012,sn,4554,183,268,451
Namibia,2012,sn,5564,98,162,260
Namibia,2012,sn,65,90,135,225
Namibia,2012,sp,014,81,61,142
Namibia,2012,sp,1524,394,358,752
Namibia,2012,sp,2534,582,810,1392
Namibia,2012,sp,3544,396,686,1082
Namibia,2012,sp,4554,198,292,490
Namibia,2012,sp,5564,84,157,241
Namibia,2012,sp,65,97,137,234
Namibia,2013,rel,014,491,603,1094
Namibia,2013,rel,1524,688,612,1300
Namibia,2013,rel,2534,1137,1496,2633
Namibia,2013,rel,3544,747,1404,2151
Namibia,2013,rel,4554,408,723,1131
Namibia,2013,rel,5564,220,392,612
Namibia,2013,rel,65,202,309,511
Nauru,1999,sp,014,0,0,0
Nauru,1999,sp,1524,0,0,0
Nauru,1999,sp,2534,1,0,1
Nauru,1999,sp,3544,3,0,3
Nauru,1999,sp,4554,0,1,1
Nauru,1999,sp,5564,0,1,1
Nauru,1999,sp,65,0,0,0
Nauru,2000,sp,4554,1,1,2
Nauru,2000,sp,5564,1,NA,NA
Nauru,2001,sp,3544,NA,1,NA
Nauru,2001,sp,4554,1,NA,NA
Nauru,2002,sp,2534,NA,1,NA
Nauru,2002,sp,3544,1,NA,NA
Nauru,2003,sp,014,0,0,0
Nauru,2003,sp,1524,0,0,0
Nauru,2003,sp,2534,0,0,0
Nauru,2003,sp,3544,0,0,0
Nauru,2003,sp,4554,0,1,1
Nauru,2003,sp,5564,0,0,0
Nauru,2003,sp,65,0,0,0
Nauru,2006,ep,014,0,0,0
Nauru,2006,ep,1524,0,3,3
Nauru,2006,ep,2534,0,1,1
Nauru,2006,ep,3544,1,0,1
Nauru,2006,ep,4554,0,0,0
Nauru,2006,ep,5564,1,0,1
Nauru,2006,ep,65,0,0,0
Nauru,2006,sn,014,0,0,0
Nauru,2006,sn,1524,0,1,1
Nauru,2006,sn,2534,0,0,0
Nauru,2006,sn,3544,0,0,0
Nauru,2006,sn,4554,1,2,3
Nauru,2006,sn,5564,0,0,0
Nauru,2006,sn,65,0,0,0
Nauru,2006,sp,014,0,0,0
Nauru,2006,sp,1524,0,1,1
Nauru,2006,sp,2534,0,0,0
Nauru,2006,sp,3544,1,0,1
Nauru,2006,sp,4554,0,0,0
Nauru,2006,sp,5564,0,0,0
Nauru,2006,sp,65,0,0,0
Nauru,2007,ep,014,0,0,0
Nauru,2007,ep,1524,0,0,0
Nauru,2007,ep,2534,0,0,0
Nauru,2007,ep,3544,0,0,0
Nauru,2007,ep,4554,0,0,0
Nauru,2007,ep,5564,0,0,0
Nauru,2007,ep,65,0,0,0
Nauru,2007,sn,014,0,0,0
Nauru,2007,sn,1524,0,0,0
Nauru,2007,sn,2534,0,0,0
Nauru,2007,sn,3544,0,0,0
Nauru,2007,sn,4554,0,0,0
Nauru,2007,sn,5564,0,0,0
Nauru,2007,sn,65,0,0,0
Nauru,2007,sp,014,0,1,1
Nauru,2007,sp,1524,0,1,1
Nauru,2007,sp,2534,0,0,0
Nauru,2007,sp,3544,0,1,1
Nauru,2007,sp,4554,0,0,0
Nauru,2007,sp,5564,0,0,0
Nauru,2007,sp,65,0,0,0
Nauru,2008,ep,014,0,0,0
Nauru,2008,ep,1524,0,0,0
Nauru,2008,ep,2534,0,0,0
Nauru,2008,ep,3544,0,0,0
Nauru,2008,ep,4554,0,0,0
Nauru,2008,ep,5564,0,0,0
Nauru,2008,ep,65,0,0,0
Nauru,2008,sn,014,0,0,0
Nauru,2008,sn,1524,0,0,0
Nauru,2008,sn,2534,0,0,0
Nauru,2008,sn,3544,0,0,0
Nauru,2008,sn,4554,1,1,2
Nauru,2008,sn,5564,0,0,0
Nauru,2008,sn,65,0,0,0
Nauru,2008,sp,014,0,0,0
Nauru,2008,sp,1524,0,1,1
Nauru,2008,sp,2534,0,0,0
Nauru,2008,sp,3544,0,0,0
Nauru,2008,sp,4554,0,1,1
Nauru,2008,sp,5564,0,0,0
Nauru,2008,sp,65,0,0,0
Nauru,2009,ep,014,0,0,0
Nauru,2009,ep,1524,0,0,0
Nauru,2009,ep,2534,0,0,0
Nauru,2009,ep,3544,0,0,0
Nauru,2009,ep,4554,1,0,1
Nauru,2009,ep,5564,0,1,1
Nauru,2009,ep,65,0,0,0
Nauru,2009,sp,014,0,0,0
Nauru,2009,sp,1524,1,0,1
Nauru,2009,sp,2534,0,0,0
Nauru,2009,sp,3544,0,0,0
Nauru,2009,sp,4554,0,0,0
Nauru,2009,sp,5564,0,0,0
Nauru,2009,sp,65,0,0,0
Nauru,2010,ep,014,0,0,0
Nauru,2010,ep,1524,0,0,0
Nauru,2010,ep,2534,0,1,1
Nauru,2010,ep,3544,0,0,0
Nauru,2010,ep,4554,0,0,0
Nauru,2010,ep,5564,0,0,0
Nauru,2010,ep,65,0,0,0
Nauru,2010,sn,014,0,0,0
Nauru,2010,sn,1524,0,0,0
Nauru,2010,sn,2534,0,0,0
Nauru,2010,sn,3544,0,0,0
Nauru,2010,sn,4554,0,0,0
Nauru,2010,sn,5564,0,1,1
Nauru,2010,sn,65,0,0,0
Nauru,2010,sp,014,0,0,0
Nauru,2010,sp,1524,0,0,0
Nauru,2010,sp,2534,0,0,0
Nauru,2010,sp,3544,1,0,1
Nauru,2010,sp,4554,0,0,0
Nauru,2010,sp,5564,0,0,0
Nauru,2010,sp,65,0,0,0
Nauru,2011,ep,014,0,0,0
Nauru,2011,ep,1524,0,0,0
Nauru,2011,ep,2534,0,0,0
Nauru,2011,ep,3544,0,0,0
Nauru,2011,ep,4554,0,0,0
Nauru,2011,ep,5564,1,0,1
Nauru,2011,ep,65,0,0,0
Nauru,2011,sn,014,0,0,0
Nauru,2011,sn,1524,0,0,0
Nauru,2011,sn,2534,1,0,1
Nauru,2011,sn,3544,0,0,0
Nauru,2011,sn,4554,0,0,0
Nauru,2011,sn,5564,0,0,0
Nauru,2011,sn,65,0,0,0
Nauru,2011,sp,014,0,0,0
Nauru,2011,sp,1524,0,0,0
Nauru,2011,sp,2534,0,0,0
Nauru,2011,sp,3544,0,1,1
Nauru,2011,sp,4554,0,1,1
Nauru,2011,sp,5564,0,0,0
Nauru,2011,sp,65,1,0,1
Nepal,1996,sp,014,155,91,246
Nepal,1996,sp,1524,853,1451,2304
Nepal,1996,sp,2534,734,1285,2019
Nepal,1996,sp,3544,534,1221,1755
Nepal,1996,sp,4554,288,1035,1323
Nepal,1996,sp,5564,190,738,928
Nepal,1996,sp,65,110,407,517
Nepal,1998,sp,014,173,133,306
Nepal,1998,sp,1524,1112,1621,2733
Nepal,1998,sp,2534,838,1522,2360
Nepal,1998,sp,3544,621,1500,2121
Nepal,1998,sp,4554,407,1292,1699
Nepal,1998,sp,5564,219,884,1103
Nepal,1998,sp,65,170,480,650
Nepal,1999,sp,014,185,150,335
Nepal,1999,sp,1524,1239,1872,3111
Nepal,1999,sp,2534,1133,1800,2933
Nepal,1999,sp,3544,754,1703,2457
Nepal,1999,sp,4554,553,1545,2098
Nepal,1999,sp,5564,316,1161,1477
Nepal,1999,sp,65,200,799,999
Nepal,2000,sp,014,176,170,346
Nepal,2000,sp,1524,1267,1904,3171
Nepal,2000,sp,2534,1078,1763,2841
Nepal,2000,sp,3544,833,1713,2546
Nepal,2000,sp,4554,575,1491,2066
Nepal,2000,sp,5564,419,1294,1713
Nepal,2000,sp,65,228,772,1000
Nepal,2001,sp,014,171,155,326
Nepal,2001,sp,1524,1295,1957,3252
Nepal,2001,sp,2534,1060,1709,2769
Nepal,2001,sp,3544,838,1743,2581
Nepal,2001,sp,4554,573,1491,2064
Nepal,2001,sp,5564,375,1300,1675
Nepal,2001,sp,65,222,775,997
Nepal,2002,sp,014,202,129,331
Nepal,2002,sp,1524,1203,1980,3183
Nepal,2002,sp,2534,1041,1707,2748
Nepal,2002,sp,3544,796,1686,2482
Nepal,2002,sp,4554,544,1579,2123
Nepal,2002,sp,5564,426,1465,1891
Nepal,2002,sp,65,198,758,956
Nepal,2003,sp,014,189,122,311
Nepal,2003,sp,1524,1283,2039,3322
Nepal,2003,sp,2534,1107,1658,2765
Nepal,2003,sp,3544,873,1619,2492
Nepal,2003,sp,4554,609,1769,2378
Nepal,2003,sp,5564,486,1639,2125
Nepal,2003,sp,65,220,735,955
Nepal,2004,sp,014,188,121,309
Nepal,2004,sp,1524,1282,1991,3273
Nepal,2004,sp,2534,1138,1749,2887
Nepal,2004,sp,3544,849,1652,2501
Nepal,2004,sp,4554,677,1710,2387
Nepal,2004,sp,5564,540,1739,2279
Nepal,2004,sp,65,215,763,978
Nepal,2005,sp,014,195,148,343
Nepal,2005,sp,1524,1208,1946,3154
Nepal,2005,sp,2534,1111,1685,2796
Nepal,2005,sp,3544,797,1722,2519
Nepal,2005,sp,4554,658,1806,2464
Nepal,2005,sp,5564,532,1759,2291
Nepal,2005,sp,65,230,820,1050
Nepal,2006,ep,014,0,0,0
Nepal,2006,ep,1524,0,0,0
Nepal,2006,ep,2534,0,0,0
Nepal,2006,ep,3544,0,0,0
Nepal,2006,ep,4554,0,0,0
Nepal,2006,ep,5564,0,0,0
Nepal,2006,ep,65,0,0,0
Nepal,2006,sn,014,0,0,0
Nepal,2006,sn,1524,0,0,0
Nepal,2006,sn,2534,0,0,0
Nepal,2006,sn,3544,0,0,0
Nepal,2006,sn,4554,0,0,0
Nepal,2006,sn,5564,0,0,0
Nepal,2006,sn,65,0,0,0
Nepal,2006,sp,014,179,125,304
Nepal,2006,sp,1524,1164,1914,3078
Nepal,2006,sp,2534,1001,1651,2652
Nepal,2006,sp,3544,788,1640,2428
Nepal,2006,sp,4554,613,1688,2301
Nepal,2006,sp,5564,519,1695,2214
Nepal,2006,sp,65,243,808,1051
Nepal,2007,ep,014,0,0,0
Nepal,2007,ep,1524,0,0,0
Nepal,2007,ep,2534,0,0,0
Nepal,2007,ep,3544,0,0,0
Nepal,2007,ep,4554,0,0,0
Nepal,2007,ep,5564,0,0,0
Nepal,2007,ep,65,0,0,0
Nepal,2007,sn,014,0,0,0
Nepal,2007,sn,1524,0,0,0
Nepal,2007,sn,2534,0,0,0
Nepal,2007,sn,3544,0,0,0
Nepal,2007,sn,4554,0,0,0
Nepal,2007,sn,5564,0,0,0
Nepal,2007,sn,65,0,0,0
Nepal,2007,sp,014,175,150,325
Nepal,2007,sp,1524,1149,2025,3174
Nepal,2007,sp,2534,1027,1591,2618
Nepal,2007,sp,3544,793,1636,2429
Nepal,2007,sp,4554,619,1720,2339
Nepal,2007,sp,5564,578,1715,2293
Nepal,2007,sp,65,258,919,1177
Nepal,2008,sp,014,107,81,188
Nepal,2008,sp,1524,832,150,982
Nepal,2008,sp,2534,820,1409,2229
Nepal,2008,sp,3544,704,1558,2262
Nepal,2008,sp,4554,630,1706,2336
Nepal,2008,sp,5564,523,1515,2038
Nepal,2008,sp,65,226,792,1018
Nepal,2009,sp,014,181,149,330
Nepal,2009,sp,1524,1223,1991,3214
Nepal,2009,sp,2534,1022,1864,2886
Nepal,2009,sp,3544,845,1761,2606
Nepal,2009,sp,4554,675,1897,2572
Nepal,2009,sp,5564,579,1871,2450
Nepal,2009,sp,65,317,1067,1384
Nepal,2010,sp,014,192,165,357
Nepal,2010,sp,1524,1177,2110,3287
Nepal,2010,sp,2534,1036,1832,2868
Nepal,2010,sp,3544,819,1724,2543
Nepal,2010,sp,4554,681,1856,2537
Nepal,2010,sp,5564,642,1857,2499
Nepal,2010,sp,65,352,1126,1478
Nepal,2011,ep,014,0,0,0
Nepal,2011,ep,1524,0,0,0
Nepal,2011,ep,2534,0,0,0
Nepal,2011,ep,3544,0,0,0
Nepal,2011,ep,4554,0,0,0
Nepal,2011,ep,5564,0,0,0
Nepal,2011,ep,65,0,0,0
Nepal,2011,sn,014,0,0,0
Nepal,2011,sn,1524,0,0,0
Nepal,2011,sn,2534,0,0,0
Nepal,2011,sn,3544,0,0,0
Nepal,2011,sn,4554,0,0,0
Nepal,2011,sn,5564,0,0,0
Nepal,2011,sn,65,0,0,0
Nepal,2011,sp,014,247,245,492
Nepal,2011,sp,1524,1182,1914,3096
Nepal,2011,sp,2534,978,1755,2733
Nepal,2011,sp,3544,752,1723,2475
Nepal,2011,sp,4554,624,1732,2356
Nepal,2011,sp,5564,604,1710,2314
Nepal,2011,sp,65,354,1180,1534
Nepal,2012,sp,014,210,250,460
Nepal,2012,sp,1524,1227,1906,3133
Nepal,2012,sp,2534,1036,1756,2792
Nepal,2012,sp,3544,666,1644,2310
Nepal,2012,sp,4554,638,1708,2346
Nepal,2012,sp,5564,643,1773,2416
Nepal,2012,sp,65,397,1203,1600
Nepal,2013,rel,014,223,186,409
Nepal,2013,rel,1524,1203,1889,3092
Nepal,2013,rel,2534,1007,1768,2775
Nepal,2013,rel,3544,737,1525,2262
Nepal,2013,rel,4554,660,1690,2350
Nepal,2013,rel,5564,691,1675,2366
Nepal,2013,rel,65,430,1415,1845
Netherlands,1995,sp,014,24,22,46
Netherlands,1995,sp,1524,56,79,135
Netherlands,1995,sp,2534,50,119,169
Netherlands,1995,sp,3544,13,75,88
Netherlands,1995,sp,4554,10,28,38
Netherlands,1995,sp,5564,8,9,17
Netherlands,1995,sp,65,7,10,17
Netherlands,1996,sp,014,1,8,9
Netherlands,1996,sp,1524,24,48,72
Netherlands,1996,sp,2534,40,65,105
Netherlands,1996,sp,3544,14,46,60
Netherlands,1996,sp,4554,5,26,31
Netherlands,1996,sp,5564,6,21,27
Netherlands,1996,sp,65,20,34,54
Netherlands,1997,sp,014,4,3,7
Netherlands,1997,sp,1524,17,33,50
Netherlands,1997,sp,2534,31,65,96
Netherlands,1997,sp,3544,10,47,57
Netherlands,1997,sp,4554,12,32,44
Netherlands,1997,sp,5564,4,12,16
Netherlands,1997,sp,65,11,31,42
Netherlands,1998,sp,014,2,2,4
Netherlands,1998,sp,1524,19,31,50
Netherlands,1998,sp,2534,25,40,65
Netherlands,1998,sp,3544,17,41,58
Netherlands,1998,sp,4554,4,21,25
Netherlands,1998,sp,5564,6,11,17
Netherlands,1998,sp,65,9,26,35
Netherlands,1999,sp,014,5,5,10
Netherlands,1999,sp,1524,26,44,70
Netherlands,1999,sp,2534,39,67,106
Netherlands,1999,sp,3544,16,32,48
Netherlands,1999,sp,4554,2,24,26
Netherlands,1999,sp,5564,1,12,13
Netherlands,1999,sp,65,16,19,35
Netherlands,2000,sp,014,4,0,4
Netherlands,2000,sp,1524,29,34,63
Netherlands,2000,sp,2534,22,63,85
Netherlands,2000,sp,3544,16,41,57
Netherlands,2000,sp,4554,9,25,34
Netherlands,2000,sp,5564,5,10,15
Netherlands,2000,sp,65,10,21,31
Netherlands,2001,sp,014,1,1,2
Netherlands,2001,sp,1524,26,51,77
Netherlands,2001,sp,2534,32,51,83
Netherlands,2001,sp,3544,19,33,52
Netherlands,2001,sp,4554,9,29,38
Netherlands,2001,sp,5564,5,12,17
Netherlands,2001,sp,65,10,24,34
Netherlands,2002,sp,014,5,1,6
Netherlands,2002,sp,1524,27,40,67
Netherlands,2002,sp,2534,32,54,86
Netherlands,2002,sp,3544,12,39,51
Netherlands,2002,sp,4554,13,33,46
Netherlands,2002,sp,5564,4,7,11
Netherlands,2002,sp,65,9,20,29
Netherlands,2003,sp,014,0,2,2
Netherlands,2003,sp,1524,16,35,51
Netherlands,2003,sp,2534,30,50,80
Netherlands,2003,sp,3544,12,38,50
Netherlands,2003,sp,4554,10,17,27
Netherlands,2003,sp,5564,3,15,18
Netherlands,2003,sp,65,5,15,20
Netherlands,2004,sp,014,4,6,10
Netherlands,2004,sp,1524,20,36,56
Netherlands,2004,sp,2534,33,54,87
Netherlands,2004,sp,3544,15,37,52
Netherlands,2004,sp,4554,4,26,30
Netherlands,2004,sp,5564,4,22,26
Netherlands,2004,sp,65,12,31,43
Netherlands,2005,sp,014,3,0,3
Netherlands,2005,sp,1524,14,23,37
Netherlands,2005,sp,2534,19,42,61
Netherlands,2005,sp,3544,11,23,34
Netherlands,2005,sp,4554,9,26,35
Netherlands,2005,sp,5564,1,14,15
Netherlands,2005,sp,65,4,19,23
Netherlands,2006,ep,014,8,5,13
Netherlands,2006,ep,1524,19,22,41
Netherlands,2006,ep,2534,37,39,76
Netherlands,2006,ep,3544,33,26,59
Netherlands,2006,ep,4554,23,29,52
Netherlands,2006,ep,5564,23,15,38
Netherlands,2006,ep,65,32,30,62
Netherlands,2006,sn,014,19,13,32
Netherlands,2006,sn,1524,23,40,63
Netherlands,2006,sn,2534,40,65,105
Netherlands,2006,sn,3544,28,48,76
Netherlands,2006,sn,4554,24,25,49
Netherlands,2006,sn,5564,15,16,31
Netherlands,2006,sn,65,36,49,85
Netherlands,2006,sp,014,3,0,3
Netherlands,2006,sp,1524,15,25,40
Netherlands,2006,sp,2534,17,23,40
Netherlands,2006,sp,3544,12,31,43
Netherlands,2006,sp,4554,5,23,28
Netherlands,2006,sp,5564,3,17,20
Netherlands,2006,sp,65,10,19,29
Netherlands,2007,ep,014,12,16,28
Netherlands,2007,ep,1524,27,31,58
Netherlands,2007,ep,2534,31,42,73
Netherlands,2007,ep,3544,19,35,54
Netherlands,2007,ep,4554,26,26,52
Netherlands,2007,ep,5564,19,19,38
Netherlands,2007,ep,65,34,29,63
Netherlands,2007,sn,014,6,12,18
Netherlands,2007,sn,1524,25,27,52
Netherlands,2007,sn,2534,31,40,71
Netherlands,2007,sn,3544,23,37,60
Netherlands,2007,sn,4554,13,27,40
Netherlands,2007,sn,5564,12,20,32
Netherlands,2007,sn,65,41,49,90
Netherlands,2007,sp,014,1,1,2
Netherlands,2007,sp,1524,12,10,22
Netherlands,2007,sp,2534,22,22,44
Netherlands,2007,sp,3544,17,28,45
Netherlands,2007,sp,4554,6,21,27
Netherlands,2007,sp,5564,5,15,20
Netherlands,2007,sp,65,12,15,27
Netherlands,2008,ep,014,10,19,29
Netherlands,2008,ep,1524,35,26,61
Netherlands,2008,ep,2534,55,50,105
Netherlands,2008,ep,3544,32,37,69
Netherlands,2008,ep,4554,23,23,46
Netherlands,2008,ep,5564,13,13,26
Netherlands,2008,ep,65,29,23,52
Netherlands,2008,sn,014,14,5,19
Netherlands,2008,sn,1524,31,45,76
Netherlands,2008,sn,2534,42,34,76
Netherlands,2008,sn,3544,22,43,65
Netherlands,2008,sn,4554,13,29,42
Netherlands,2008,sn,5564,11,25,36
Netherlands,2008,sn,65,24,33,57
Netherlands,2008,sp,014,2,0,2
Netherlands,2008,sp,1524,13,16,29
Netherlands,2008,sp,2534,19,24,43
Netherlands,2008,sp,3544,14,26,40
Netherlands,2008,sp,4554,6,19,25
Netherlands,2008,sp,5564,6,18,24
Netherlands,2008,sp,65,7,19,26
Netherlands,2009,ep,014,20,16,36
Netherlands,2009,ep,1524,29,62,91
Netherlands,2009,ep,2534,59,52,111
Netherlands,2009,ep,3544,36,48,84
Netherlands,2009,ep,4554,30,19,49
Netherlands,2009,ep,5564,36,19,55
Netherlands,2009,ep,65,36,34,70
Netherlands,2009,sn,014,7,12,19
Netherlands,2009,sn,1524,19,53,72
Netherlands,2009,sn,2534,31,58,89
Netherlands,2009,sn,3544,14,42,56
Netherlands,2009,sn,4554,17,31,48
Netherlands,2009,sn,5564,16,23,39
Netherlands,2009,sn,65,27,41,68
Netherlands,2009,sp,014,1,1,2
Netherlands,2009,sp,1524,21,28,49
Netherlands,2009,sp,2534,24,21,45
Netherlands,2009,sp,3544,7,25,32
Netherlands,2009,sp,4554,8,22,30
Netherlands,2009,sp,5564,4,13,17
Netherlands,2009,sp,65,13,14,27
Netherlands,2010,ep,014,10,9,19
Netherlands,2010,ep,1524,36,35,71
Netherlands,2010,ep,2534,50,72,122
Netherlands,2010,ep,3544,47,40,87
Netherlands,2010,ep,4554,30,30,60
Netherlands,2010,ep,5564,29,15,44
Netherlands,2010,ep,65,25,28,53
Netherlands,2010,sn,014,4,10,14
Netherlands,2010,sn,1524,28,30,58
Netherlands,2010,sn,2534,50,44,94
Netherlands,2010,sn,3544,23,37,60
Netherlands,2010,sn,4554,10,25,35
Netherlands,2010,sn,5564,15,26,41
Netherlands,2010,sn,65,33,35,68
Netherlands,2010,sp,014,1,0,1
Netherlands,2010,sp,1524,9,23,32
Netherlands,2010,sp,2534,14,29,43
Netherlands,2010,sp,3544,13,22,35
Netherlands,2010,sp,4554,6,20,26
Netherlands,2010,sp,5564,4,11,15
Netherlands,2010,sp,65,11,18,29
Netherlands,2011,ep,014,16,17,33
Netherlands,2011,ep,1524,26,21,47
Netherlands,2011,ep,2534,55,71,126
Netherlands,2011,ep,3544,37,38,75
Netherlands,2011,ep,4554,30,21,51
Netherlands,2011,ep,5564,23,20,43
Netherlands,2011,ep,65,21,24,45
Netherlands,2011,sn,014,9,9,18
Netherlands,2011,sn,1524,31,32,63
Netherlands,2011,sn,2534,38,41,79
Netherlands,2011,sn,3544,16,24,40
Netherlands,2011,sn,4554,22,23,45
Netherlands,2011,sn,5564,19,26,45
Netherlands,2011,sn,65,28,39,67
Netherlands,2011,sp,014,2,2,4
Netherlands,2011,sp,1524,13,22,35
Netherlands,2011,sp,2534,14,35,49
Netherlands,2011,sp,3544,7,19,26
Netherlands,2011,sp,4554,7,24,31
Netherlands,2011,sp,5564,4,13,17
Netherlands,2011,sp,65,3,13,16
Netherlands,2012,ep,014,16,12,28
Netherlands,2012,ep,1524,31,24,55
Netherlands,2012,ep,2534,61,59,120
Netherlands,2012,ep,3544,26,45,71
Netherlands,2012,ep,4554,28,27,55
Netherlands,2012,ep,5564,20,20,40
Netherlands,2012,ep,65,35,40,75
Netherlands,2012,sn,014,8,8,16
Netherlands,2012,sn,1524,17,27,44
Netherlands,2012,sn,2534,31,42,73
Netherlands,2012,sn,3544,20,25,45
Netherlands,2012,sn,4554,20,19,39
Netherlands,2012,sn,5564,13,21,34
Netherlands,2012,sn,65,18,31,49
Netherlands,2012,sp,014,4,1,5
Netherlands,2012,sp,1524,7,15,22
Netherlands,2012,sp,2534,18,31,49
Netherlands,2012,sp,3544,15,14,29
Netherlands,2012,sp,4554,4,18,22
Netherlands,2012,sp,5564,6,9,15
Netherlands,2012,sp,65,6,15,21
Netherlands,2013,rel,014,14,18,32
Netherlands,2013,rel,1524,47,71,118
Netherlands,2013,rel,2534,90,129,219
Netherlands,2013,rel,3544,46,82,128
Netherlands,2013,rel,4554,48,76,124
Netherlands,2013,rel,5564,34,46,80
Netherlands,2013,rel,65,54,76,130
Netherlands Antilles,1996,sp,014,0,0,0
Netherlands Antilles,1996,sp,1524,0,0,0
Netherlands Antilles,1996,sp,2534,0,0,0
Netherlands Antilles,1996,sp,3544,1,0,1
Netherlands Antilles,1996,sp,4554,0,1,1
Netherlands Antilles,1996,sp,5564,0,1,1
Netherlands Antilles,1996,sp,65,0,1,1
Netherlands Antilles,1997,sp,014,0,0,0
Netherlands Antilles,1997,sp,1524,0,0,0
Netherlands Antilles,1997,sp,2534,2,1,3
Netherlands Antilles,1997,sp,3544,2,1,3
Netherlands Antilles,1997,sp,4554,1,0,1
Netherlands Antilles,1997,sp,5564,1,1,2
Netherlands Antilles,1997,sp,65,1,3,4
Netherlands Antilles,1998,sp,014,0,0,0
Netherlands Antilles,1998,sp,1524,1,0,1
Netherlands Antilles,1998,sp,2534,0,0,0
Netherlands Antilles,1998,sp,3544,2,0,2
Netherlands Antilles,1998,sp,4554,1,0,1
Netherlands Antilles,1998,sp,5564,0,1,1
Netherlands Antilles,1998,sp,65,0,2,2
Netherlands Antilles,1999,sp,014,0,0,0
Netherlands Antilles,1999,sp,1524,1,0,1
Netherlands Antilles,1999,sp,2534,1,1,2
Netherlands Antilles,1999,sp,3544,0,0,0
Netherlands Antilles,1999,sp,4554,0,1,1
Netherlands Antilles,1999,sp,5564,0,0,0
Netherlands Antilles,1999,sp,65,0,0,0
Netherlands Antilles,2000,sp,014,0,0,0
Netherlands Antilles,2000,sp,1524,0,0,0
Netherlands Antilles,2000,sp,2534,1,1,2
Netherlands Antilles,2000,sp,3544,0,2,2
Netherlands Antilles,2000,sp,4554,0,0,0
Netherlands Antilles,2000,sp,5564,1,0,1
Netherlands Antilles,2000,sp,65,0,0,0
Netherlands Antilles,2001,sp,014,0,0,0
Netherlands Antilles,2001,sp,1524,0,0,0
Netherlands Antilles,2001,sp,2534,1,1,2
Netherlands Antilles,2001,sp,3544,0,5,5
Netherlands Antilles,2001,sp,4554,0,0,0
Netherlands Antilles,2001,sp,5564,1,0,1
Netherlands Antilles,2001,sp,65,0,0,0
Netherlands Antilles,2002,sp,014,0,0,0
Netherlands Antilles,2002,sp,1524,1,1,2
Netherlands Antilles,2002,sp,2534,0,1,1
Netherlands Antilles,2002,sp,3544,0,3,3
Netherlands Antilles,2002,sp,4554,1,2,3
Netherlands Antilles,2002,sp,5564,0,3,3
Netherlands Antilles,2002,sp,65,1,1,2
Netherlands Antilles,2003,sp,014,0,0,0
Netherlands Antilles,2003,sp,1524,0,0,0
Netherlands Antilles,2003,sp,2534,1,2,3
Netherlands Antilles,2003,sp,3544,1,1,2
Netherlands Antilles,2003,sp,4554,0,0,0
Netherlands Antilles,2003,sp,5564,1,0,1
Netherlands Antilles,2003,sp,65,0,3,3
Netherlands Antilles,2004,sp,014,0,1,1
Netherlands Antilles,2004,sp,1524,0,1,1
Netherlands Antilles,2004,sp,2534,NA,0,NA
Netherlands Antilles,2004,sp,3544,1,4,5
Netherlands Antilles,2004,sp,4554,0,3,3
Netherlands Antilles,2004,sp,5564,0,0,0
Netherlands Antilles,2004,sp,65,0,1,1
Netherlands Antilles,2006,ep,014,0,0,0
Netherlands Antilles,2006,ep,1524,0,0,0
Netherlands Antilles,2006,ep,2534,0,0,0
Netherlands Antilles,2006,ep,3544,0,0,0
Netherlands Antilles,2006,ep,4554,0,0,0
Netherlands Antilles,2006,ep,5564,0,0,0
Netherlands Antilles,2006,ep,65,0,0,0
Netherlands Antilles,2006,sn,014,0,0,0
Netherlands Antilles,2006,sn,1524,0,0,0
Netherlands Antilles,2006,sn,2534,0,0,0
Netherlands Antilles,2006,sn,3544,0,0,0
Netherlands Antilles,2006,sn,4554,0,0,0
Netherlands Antilles,2006,sn,5564,0,0,0
Netherlands Antilles,2006,sn,65,0,0,0
Netherlands Antilles,2006,sp,014,1,0,1
Netherlands Antilles,2006,sp,1524,0,0,0
Netherlands Antilles,2006,sp,2534,0,0,0
Netherlands Antilles,2006,sp,3544,0,2,2
Netherlands Antilles,2006,sp,4554,0,1,1
Netherlands Antilles,2006,sp,5564,0,1,1
Netherlands Antilles,2006,sp,65,0,0,0
New Caledonia,1995,sp,014,2,3,5
New Caledonia,1995,sp,1524,1,2,3
New Caledonia,1995,sp,2534,1,3,4
New Caledonia,1995,sp,3544,3,4,7
New Caledonia,1995,sp,4554,3,2,5
New Caledonia,1995,sp,5564,0,2,2
New Caledonia,1995,sp,65,1,3,4
New Caledonia,1996,sp,014,0,1,1
New Caledonia,1996,sp,1524,2,3,5
New Caledonia,1996,sp,2534,2,1,3
New Caledonia,1996,sp,3544,1,3,4
New Caledonia,1996,sp,4554,2,5,7
New Caledonia,1996,sp,5564,1,8,9
New Caledonia,1996,sp,65,1,3,4
New Caledonia,1999,sp,014,0,0,0
New Caledonia,1999,sp,1524,0,0,0
New Caledonia,1999,sp,2534,4,6,10
New Caledonia,1999,sp,3544,1,1,2
New Caledonia,1999,sp,4554,0,2,2
New Caledonia,1999,sp,5564,2,1,3
New Caledonia,1999,sp,65,3,7,10
New Caledonia,2000,sp,014,1,1,2
New Caledonia,2000,sp,1524,8,1,9
New Caledonia,2000,sp,2534,1,3,4
New Caledonia,2000,sp,3544,1,4,5
New Caledonia,2000,sp,4554,3,2,5
New Caledonia,2000,sp,5564,2,3,5
New Caledonia,2000,sp,65,4,4,8
New Caledonia,2001,sp,014,1,0,1
New Caledonia,2001,sp,1524,1,1,2
New Caledonia,2001,sp,2534,2,8,10
New Caledonia,2001,sp,3544,1,1,2
New Caledonia,2001,sp,4554,0,5,5
New Caledonia,2001,sp,5564,0,6,6
New Caledonia,2001,sp,65,3,6,9
New Caledonia,2002,sp,014,0,0,0
New Caledonia,2002,sp,1524,4,2,6
New Caledonia,2002,sp,2534,2,2,4
New Caledonia,2002,sp,3544,2,1,3
New Caledonia,2002,sp,4554,3,1,4
New Caledonia,2002,sp,5564,0,1,1
New Caledonia,2002,sp,65,0,3,3
New Caledonia,2003,sp,014,0,0,0
New Caledonia,2003,sp,1524,0,1,1
New Caledonia,2003,sp,2534,2,1,3
New Caledonia,2003,sp,3544,2,1,3
New Caledonia,2003,sp,4554,0,1,1
New Caledonia,2003,sp,5564,0,1,1
New Caledonia,2003,sp,65,3,3,6
New Caledonia,2004,sp,014,0,0,0
New Caledonia,2004,sp,1524,2,2,4
New Caledonia,2004,sp,2534,1,1,2
New Caledonia,2004,sp,3544,0,3,3
New Caledonia,2004,sp,4554,0,2,2
New Caledonia,2004,sp,5564,1,1,2
New Caledonia,2004,sp,65,0,2,2
New Caledonia,2005,sp,014,0,0,0
New Caledonia,2005,sp,1524,1,2,3
New Caledonia,2005,sp,2534,2,1,3
New Caledonia,2005,sp,3544,1,0,1
New Caledonia,2005,sp,4554,2,0,2
New Caledonia,2005,sp,5564,0,3,3
New Caledonia,2005,sp,65,4,0,4
New Caledonia,2006,ep,014,0,0,0
New Caledonia,2006,ep,1524,1,1,2
New Caledonia,2006,ep,2534,0,0,0
New Caledonia,2006,ep,3544,0,0,0
New Caledonia,2006,ep,4554,3,2,5
New Caledonia,2006,ep,5564,1,0,1
New Caledonia,2006,ep,65,2,0,2
New Caledonia,2006,sn,014,0,1,1
New Caledonia,2006,sn,1524,0,1,1
New Caledonia,2006,sn,2534,0,1,1
New Caledonia,2006,sn,3544,2,1,3
New Caledonia,2006,sn,4554,1,2,3
New Caledonia,2006,sn,5564,2,2,4
New Caledonia,2006,sn,65,4,5,9
New Caledonia,2006,sp,014,0,0,0
New Caledonia,2006,sp,1524,1,0,1
New Caledonia,2006,sp,2534,0,3,3
New Caledonia,2006,sp,3544,0,1,1
New Caledonia,2006,sp,4554,0,1,1
New Caledonia,2006,sp,5564,0,NA,NA
New Caledonia,2006,sp,65,2,1,3
New Caledonia,2007,ep,014,0,0,0
New Caledonia,2007,ep,1524,0,2,2
New Caledonia,2007,ep,2534,0,1,1
New Caledonia,2007,ep,3544,0,0,0
New Caledonia,2007,ep,4554,3,1,4
New Caledonia,2007,ep,5564,2,3,5
New Caledonia,2007,ep,65,1,3,4
New Caledonia,2007,sn,014,0,1,1
New Caledonia,2007,sn,1524,1,1,2
New Caledonia,2007,sn,2534,0,1,1
New Caledonia,2007,sn,3544,0,1,1
New Caledonia,2007,sn,4554,0,0,0
New Caledonia,2007,sn,5564,1,4,5
New Caledonia,2007,sn,65,2,3,5
New Caledonia,2007,sp,014,0,0,0
New Caledonia,2007,sp,1524,0,1,1
New Caledonia,2007,sp,2534,0,1,1
New Caledonia,2007,sp,3544,1,2,3
New Caledonia,2007,sp,4554,0,1,1
New Caledonia,2007,sp,5564,0,3,3
New Caledonia,2007,sp,65,1,2,3
New Caledonia,2008,ep,014,0,0,0
New Caledonia,2008,ep,1524,0,0,0
New Caledonia,2008,ep,2534,0,0,0
New Caledonia,2008,ep,3544,0,1,1
New Caledonia,2008,ep,4554,1,0,1
New Caledonia,2008,ep,5564,1,3,4
New Caledonia,2008,ep,65,2,1,3
New Caledonia,2008,sn,014,1,0,1
New Caledonia,2008,sn,1524,0,0,0
New Caledonia,2008,sn,2534,0,1,1
New Caledonia,2008,sn,3544,1,0,1
New Caledonia,2008,sn,4554,1,4,5
New Caledonia,2008,sn,5564,0,3,3
New Caledonia,2008,sn,65,4,4,8
New Caledonia,2008,sp,014,0,0,0
New Caledonia,2008,sp,1524,0,1,1
New Caledonia,2008,sp,2534,1,1,2
New Caledonia,2008,sp,3544,0,0,0
New Caledonia,2008,sp,4554,0,2,2
New Caledonia,2008,sp,5564,0,1,1
New Caledonia,2008,sp,65,1,2,3
New Caledonia,2009,ep,014,0,2,2
New Caledonia,2009,ep,1524,0,0,0
New Caledonia,2009,ep,2534,0,0,0
New Caledonia,2009,ep,3544,1,1,2
New Caledonia,2009,ep,4554,2,1,3
New Caledonia,2009,ep,5564,2,0,2
New Caledonia,2009,ep,65,3,1,4
New Caledonia,2009,sn,014,1,3,4
New Caledonia,2009,sn,1524,1,2,3
New Caledonia,2009,sn,2534,0,0,0
New Caledonia,2009,sn,3544,2,3,5
New Caledonia,2009,sn,4554,1,0,1
New Caledonia,2009,sn,5564,3,4,7
New Caledonia,2009,sn,65,2,4,6
New Caledonia,2009,sp,014,0,0,0
New Caledonia,2009,sp,1524,1,0,1
New Caledonia,2009,sp,2534,1,0,1
New Caledonia,2009,sp,3544,3,0,3
New Caledonia,2009,sp,4554,0,1,1
New Caledonia,2009,sp,5564,2,0,2
New Caledonia,2009,sp,65,2,5,7
New Caledonia,2010,ep,014,0,1,1
New Caledonia,2010,ep,1524,0,0,0
New Caledonia,2010,ep,2534,0,0,0
New Caledonia,2010,ep,3544,1,0,1
New Caledonia,2010,ep,4554,0,2,2
New Caledonia,2010,ep,5564,1,2,3
New Caledonia,2010,ep,65,4,2,6
New Caledonia,2010,sn,014,1,0,1
New Caledonia,2010,sn,1524,0,1,1
New Caledonia,2010,sn,2534,1,1,2
New Caledonia,2010,sn,3544,0,3,3
New Caledonia,2010,sn,4554,1,0,1
New Caledonia,2010,sn,5564,0,1,1
New Caledonia,2010,sn,65,5,2,7
New Caledonia,2010,sp,014,0,0,0
New Caledonia,2010,sp,1524,1,1,2
New Caledonia,2010,sp,2534,0,2,2
New Caledonia,2010,sp,3544,1,3,4
New Caledonia,2010,sp,4554,0,1,1
New Caledonia,2010,sp,5564,1,4,5
New Caledonia,2010,sp,65,3,3,6
New Caledonia,2011,ep,014,0,0,0
New Caledonia,2011,ep,1524,0,2,2
New Caledonia,2011,ep,2534,0,2,2
New Caledonia,2011,ep,3544,1,2,3
New Caledonia,2011,ep,4554,1,2,3
New Caledonia,2011,ep,5564,0,3,3
New Caledonia,2011,ep,65,2,4,6
New Caledonia,2011,sn,014,2,5,7
New Caledonia,2011,sn,1524,1,0,1
New Caledonia,2011,sn,2534,2,0,2
New Caledonia,2011,sn,3544,1,2,3
New Caledonia,2011,sn,4554,0,1,1
New Caledonia,2011,sn,5564,0,1,1
New Caledonia,2011,sn,65,0,3,3
New Caledonia,2011,sp,014,0,0,0
New Caledonia,2011,sp,1524,0,0,0
New Caledonia,2011,sp,2534,1,0,1
New Caledonia,2011,sp,3544,1,3,4
New Caledonia,2011,sp,4554,0,1,1
New Caledonia,2011,sp,5564,1,2,3
New Caledonia,2011,sp,65,1,3,4
New Caledonia,2012,ep,4554,1,NA,NA
New Caledonia,2012,ep,5564,3,NA,NA
New Caledonia,2012,ep,65,NA,2,NA
New Caledonia,2012,sn,1524,NA,1,NA
New Caledonia,2012,sn,3544,1,1,2
New Caledonia,2012,sn,4554,NA,1,NA
New Caledonia,2012,sn,5564,NA,2,NA
New Caledonia,2012,sn,65,3,1,4
New Caledonia,2012,sp,2534,NA,2,NA
New Caledonia,2012,sp,4554,1,3,4
New Caledonia,2012,sp,5564,1,2,3
New Caledonia,2012,sp,65,1,1,2
New Zealand,1995,sp,014,1,0,1
New Zealand,1995,sp,1524,2,4,6
New Zealand,1995,sp,2534,3,3,6
New Zealand,1995,sp,3544,4,3,7
New Zealand,1995,sp,4554,2,5,7
New Zealand,1995,sp,5564,2,7,9
New Zealand,1995,sp,65,4,7,11
New Zealand,1996,sp,014,2,2,4
New Zealand,1996,sp,1524,6,4,10
New Zealand,1996,sp,2534,9,3,12
New Zealand,1996,sp,3544,3,9,12
New Zealand,1996,sp,4554,6,10,16
New Zealand,1996,sp,5564,3,3,6
New Zealand,1996,sp,65,13,12,25
New Zealand,1997,sp,014,0,0,0
New Zealand,1997,sp,1524,4,3,7
New Zealand,1997,sp,2534,6,6,12
New Zealand,1997,sp,3544,5,3,8
New Zealand,1997,sp,4554,2,4,6
New Zealand,1997,sp,5564,5,4,9
New Zealand,1997,sp,65,7,7,14
New Zealand,1998,sp,014,0,1,1
New Zealand,1998,sp,1524,11,8,19
New Zealand,1998,sp,2534,6,10,16
New Zealand,1998,sp,3544,8,8,16
New Zealand,1998,sp,4554,2,7,9
New Zealand,1998,sp,5564,4,7,11
New Zealand,1998,sp,65,5,4,9
New Zealand,1999,sp,014,1,1,2
New Zealand,1999,sp,1524,6,10,16
New Zealand,1999,sp,2534,7,8,15
New Zealand,1999,sp,3544,2,4,6
New Zealand,1999,sp,4554,3,3,6
New Zealand,1999,sp,5564,0,8,8
New Zealand,1999,sp,65,1,15,16
New Zealand,2000,sp,014,1,0,1
New Zealand,2000,sp,1524,6,6,12
New Zealand,2000,sp,2534,6,5,11
New Zealand,2000,sp,3544,5,6,11
New Zealand,2000,sp,4554,0,8,8
New Zealand,2000,sp,5564,4,10,14
New Zealand,2000,sp,65,10,7,17
New Zealand,2001,sp,014,3,1,4
New Zealand,2001,sp,1524,9,7,16
New Zealand,2001,sp,2534,14,2,16
New Zealand,2001,sp,3544,3,7,10
New Zealand,2001,sp,4554,1,4,5
New Zealand,2001,sp,5564,3,2,5
New Zealand,2001,sp,65,5,12,17
New Zealand,2002,sp,014,1,0,1
New Zealand,2002,sp,1524,15,10,25
New Zealand,2002,sp,2534,8,14,22
New Zealand,2002,sp,3544,4,5,9
New Zealand,2002,sp,4554,3,6,9
New Zealand,2002,sp,5564,5,4,9
New Zealand,2002,sp,65,3,10,13
New Zealand,2003,sp,014,7,5,12
New Zealand,2003,sp,1524,18,9,27
New Zealand,2003,sp,2534,8,10,18
New Zealand,2003,sp,3544,1,6,7
New Zealand,2003,sp,4554,10,6,16
New Zealand,2003,sp,5564,4,8,12
New Zealand,2003,sp,65,5,9,14
New Zealand,2004,sp,014,0,3,3
New Zealand,2004,sp,1524,10,10,20
New Zealand,2004,sp,2534,15,13,28
New Zealand,2004,sp,3544,4,10,14
New Zealand,2004,sp,4554,4,6,10
New Zealand,2004,sp,5564,1,5,6
New Zealand,2004,sp,65,13,16,29
New Zealand,2005,sp,014,1,4,5
New Zealand,2005,sp,1524,11,6,17
New Zealand,2005,sp,2534,9,10,19
New Zealand,2005,sp,3544,6,6,12
New Zealand,2005,sp,4554,6,6,12
New Zealand,2005,sp,5564,1,5,6
New Zealand,2005,sp,65,2,10,12
New Zealand,2006,ep,014,1,2,3
New Zealand,2006,ep,1524,6,10,16
New Zealand,2006,ep,2534,20,7,27
New Zealand,2006,ep,3544,11,6,17
New Zealand,2006,ep,4554,8,5,13
New Zealand,2006,ep,5564,7,3,10
New Zealand,2006,ep,65,13,5,18
New Zealand,2006,sn,014,7,13,20
New Zealand,2006,sn,1524,7,13,20
New Zealand,2006,sn,2534,9,6,15
New Zealand,2006,sn,3544,5,6,11
New Zealand,2006,sn,4554,5,6,11
New Zealand,2006,sn,5564,0,8,8
New Zealand,2006,sn,65,3,12,15
New Zealand,2006,sp,014,1,5,6
New Zealand,2006,sp,1524,12,14,26
New Zealand,2006,sp,2534,12,5,17
New Zealand,2006,sp,3544,12,8,20
New Zealand,2006,sp,4554,3,4,7
New Zealand,2006,sp,5564,6,3,9
New Zealand,2006,sp,65,4,7,11
New Zealand,2007,ep,014,2,0,2
New Zealand,2007,ep,1524,5,5,10
New Zealand,2007,ep,2534,10,8,18
New Zealand,2007,ep,3544,7,5,12
New Zealand,2007,ep,4554,6,3,9
New Zealand,2007,ep,5564,7,6,13
New Zealand,2007,ep,65,6,5,11
New Zealand,2007,sn,014,9,10,19
New Zealand,2007,sn,1524,9,6,15
New Zealand,2007,sn,2534,10,10,20
New Zealand,2007,sn,3544,9,5,14
New Zealand,2007,sn,4554,6,5,11
New Zealand,2007,sn,5564,2,7,9
New Zealand,2007,sn,65,10,10,20
New Zealand,2007,sp,014,1,0,1
New Zealand,2007,sp,1524,14,11,25
New Zealand,2007,sp,2534,7,1,8
New Zealand,2007,sp,3544,8,7,15
New Zealand,2007,sp,4554,6,4,10
New Zealand,2007,sp,5564,6,4,10
New Zealand,2007,sp,65,4,8,12
New Zealand,2008,ep,014,0,0,0
New Zealand,2008,ep,1524,4,4,8
New Zealand,2008,ep,2534,15,9,24
New Zealand,2008,ep,3544,9,11,20
New Zealand,2008,ep,4554,4,6,10
New Zealand,2008,ep,5564,7,6,13
New Zealand,2008,ep,65,8,9,17
New Zealand,2008,sn,014,7,8,15
New Zealand,2008,sn,1524,11,7,18
New Zealand,2008,sn,2534,8,8,16
New Zealand,2008,sn,3544,3,4,7
New Zealand,2008,sn,4554,4,6,10
New Zealand,2008,sn,5564,1,10,11
New Zealand,2008,sn,65,6,8,14
New Zealand,2008,sp,014,1,0,1
New Zealand,2008,sp,1524,8,9,17
New Zealand,2008,sp,2534,13,4,17
New Zealand,2008,sp,3544,9,9,18
New Zealand,2008,sp,4554,3,5,8
New Zealand,2008,sp,5564,3,10,13
New Zealand,2008,sp,65,9,18,27
New Zealand,2009,ep,014,2,3,5
New Zealand,2009,ep,1524,4,4,8
New Zealand,2009,ep,2534,16,7,23
New Zealand,2009,ep,3544,13,8,21
New Zealand,2009,ep,4554,7,12,19
New Zealand,2009,ep,5564,4,7,11
New Zealand,2009,ep,65,10,5,15
New Zealand,2009,sn,014,8,5,13
New Zealand,2009,sn,1524,9,3,12
New Zealand,2009,sn,2534,7,10,17
New Zealand,2009,sn,3544,9,9,18
New Zealand,2009,sn,4554,4,4,8
New Zealand,2009,sn,5564,4,5,9
New Zealand,2009,sn,65,4,9,13
New Zealand,2009,sp,014,0,1,1
New Zealand,2009,sp,1524,6,8,14
New Zealand,2009,sp,2534,10,11,21
New Zealand,2009,sp,3544,5,10,15
New Zealand,2009,sp,4554,5,5,10
New Zealand,2009,sp,5564,7,7,14
New Zealand,2009,sp,65,5,10,15
New Zealand,2010,ep,014,1,4,5
New Zealand,2010,ep,1524,8,8,16
New Zealand,2010,ep,2534,23,19,42
New Zealand,2010,ep,3544,12,10,22
New Zealand,2010,ep,4554,9,12,21
New Zealand,2010,ep,5564,6,7,13
New Zealand,2010,ep,65,8,7,15
New Zealand,2010,sn,014,3,3,6
New Zealand,2010,sn,1524,5,5,10
New Zealand,2010,sn,2534,7,3,10
New Zealand,2010,sn,3544,4,9,13
New Zealand,2010,sn,4554,3,3,6
New Zealand,2010,sn,5564,7,2,9
New Zealand,2010,sn,65,9,5,14
New Zealand,2010,sp,014,2,0,2
New Zealand,2010,sp,1524,12,6,18
New Zealand,2010,sp,2534,7,13,20
New Zealand,2010,sp,3544,6,4,10
New Zealand,2010,sp,4554,5,6,11
New Zealand,2010,sp,5564,3,5,8
New Zealand,2010,sp,65,6,11,17
New Zealand,2011,ep,014,3,2,5
New Zealand,2011,ep,1524,13,10,23
New Zealand,2011,ep,2534,13,16,29
New Zealand,2011,ep,3544,13,12,25
New Zealand,2011,ep,4554,9,3,12
New Zealand,2011,ep,5564,10,5,15
New Zealand,2011,ep,65,6,6,12
New Zealand,2011,sn,014,7,3,10
New Zealand,2011,sn,1524,5,11,16
New Zealand,2011,sn,2534,7,8,15
New Zealand,2011,sn,3544,6,5,11
New Zealand,2011,sn,4554,1,3,4
New Zealand,2011,sn,5564,7,5,12
New Zealand,2011,sn,65,5,8,13
New Zealand,2011,sp,014,4,1,5
New Zealand,2011,sp,1524,8,12,20
New Zealand,2011,sp,2534,8,5,13
New Zealand,2011,sp,3544,4,5,9
New Zealand,2011,sp,4554,5,7,12
New Zealand,2011,sp,5564,3,7,10
New Zealand,2011,sp,65,8,11,19
New Zealand,2012,ep,014,1,1,2
New Zealand,2012,ep,1524,11,7,18
New Zealand,2012,ep,2534,23,14,37
New Zealand,2012,ep,3544,9,19,28
New Zealand,2012,ep,4554,6,2,8
New Zealand,2012,ep,5564,3,5,8
New Zealand,2012,ep,65,8,3,11
New Zealand,2012,sn,014,3,5,8
New Zealand,2012,sn,1524,11,6,17
New Zealand,2012,sn,2534,10,7,17
New Zealand,2012,sn,3544,3,7,10
New Zealand,2012,sn,4554,3,7,10
New Zealand,2012,sn,5564,4,6,10
New Zealand,2012,sn,65,11,15,26
New Zealand,2012,sp,014,3,0,3
New Zealand,2012,sp,1524,4,7,11
New Zealand,2012,sp,2534,8,9,17
New Zealand,2012,sp,3544,2,2,4
New Zealand,2012,sp,4554,3,4,7
New Zealand,2012,sp,5564,1,6,7
New Zealand,2012,sp,65,5,14,19
New Zealand,2013,rel,014,4,6,10
New Zealand,2013,rel,1524,19,16,35
New Zealand,2013,rel,2534,32,40,72
New Zealand,2013,rel,3544,17,23,40
New Zealand,2013,rel,4554,17,18,35
New Zealand,2013,rel,5564,14,13,27
New Zealand,2013,rel,65,24,29,53
Nicaragua,1995,sp,014,24,23,47
Nicaragua,1995,sp,1524,176,178,354
Nicaragua,1995,sp,2534,215,172,387
Nicaragua,1995,sp,3544,98,175,273
Nicaragua,1995,sp,4554,83,126,209
Nicaragua,1995,sp,5564,64,96,160
Nicaragua,1995,sp,65,46,92,138
Nicaragua,1996,sp,014,33,27,60
Nicaragua,1996,sp,1524,200,231,431
Nicaragua,1996,sp,2534,199,200,399
Nicaragua,1996,sp,3544,137,191,328
Nicaragua,1996,sp,4554,77,120,197
Nicaragua,1996,sp,5564,63,94,157
Nicaragua,1996,sp,65,56,94,150
Nicaragua,1997,sp,014,37,18,55
Nicaragua,1997,sp,1524,212,211,423
Nicaragua,1997,sp,2534,223,210,433
Nicaragua,1997,sp,3544,117,163,280
Nicaragua,1997,sp,4554,77,115,192
Nicaragua,1997,sp,5564,61,90,151
Nicaragua,1997,sp,65,53,83,136
Nicaragua,1998,sp,014,34,24,58
Nicaragua,1998,sp,1524,202,221,423
Nicaragua,1998,sp,2534,215,193,408
Nicaragua,1998,sp,3544,114,155,269
Nicaragua,1998,sp,4554,64,106,170
Nicaragua,1998,sp,5564,61,94,155
Nicaragua,1998,sp,65,55,110,165
Nicaragua,1999,sp,014,27,26,53
Nicaragua,1999,sp,1524,194,217,411
Nicaragua,1999,sp,2534,168,212,380
Nicaragua,1999,sp,3544,108,167,275
Nicaragua,1999,sp,4554,73,125,198
Nicaragua,1999,sp,5564,42,75,117
Nicaragua,1999,sp,65,45,85,130
Nicaragua,2000,sp,014,34,18,52
Nicaragua,2000,sp,1524,188,194,382
Nicaragua,2000,sp,2534,173,174,347
Nicaragua,2000,sp,3544,98,147,245
Nicaragua,2000,sp,4554,76,108,184
Nicaragua,2000,sp,5564,46,64,110
Nicaragua,2000,sp,65,61,90,151
Nicaragua,2001,sp,014,32,24,56
Nicaragua,2001,sp,1524,188,213,401
Nicaragua,2001,sp,2534,173,203,376
Nicaragua,2001,sp,3544,92,139,231
Nicaragua,2001,sp,4554,67,93,160
Nicaragua,2001,sp,5564,52,75,127
Nicaragua,2001,sp,65,64,95,159
Nicaragua,2002,sp,014,26,22,48
Nicaragua,2002,sp,1524,149,168,317
Nicaragua,2002,sp,2534,135,180,315
Nicaragua,2002,sp,3544,91,140,231
Nicaragua,2002,sp,4554,72,101,173
Nicaragua,2002,sp,5564,45,73,118
Nicaragua,2002,sp,65,44,74,118
Nicaragua,2003,sp,014,42,14,56
Nicaragua,2003,sp,1524,174,179,353
Nicaragua,2003,sp,2534,150,210,360
Nicaragua,2003,sp,3544,91,135,226
Nicaragua,2003,sp,4554,71,103,174
Nicaragua,2003,sp,5564,54,68,122
Nicaragua,2003,sp,65,48,65,113
Nicaragua,2004,sp,014,23,24,47
Nicaragua,2004,sp,1524,159,161,320
Nicaragua,2004,sp,2534,154,179,333
Nicaragua,2004,sp,3544,90,105,195
Nicaragua,2004,sp,4554,75,104,179
Nicaragua,2004,sp,5564,44,87,131
Nicaragua,2004,sp,65,50,72,122
Nicaragua,2005,sp,014,23,17,40
Nicaragua,2005,sp,1524,135,163,298
Nicaragua,2005,sp,2534,122,159,281
Nicaragua,2005,sp,3544,103,116,219
Nicaragua,2005,sp,4554,61,106,167
Nicaragua,2005,sp,5564,54,61,115
Nicaragua,2005,sp,65,47,79,126
Nicaragua,2006,ep,014,0,0,0
Nicaragua,2006,ep,1524,0,0,0
Nicaragua,2006,ep,2534,0,0,0
Nicaragua,2006,ep,3544,0,0,0
Nicaragua,2006,ep,4554,0,0,0
Nicaragua,2006,ep,5564,0,0,0
Nicaragua,2006,ep,65,0,0,0
Nicaragua,2006,sn,014,0,0,0
Nicaragua,2006,sn,1524,0,0,0
Nicaragua,2006,sn,2534,0,0,0
Nicaragua,2006,sn,3544,0,0,0
Nicaragua,2006,sn,4554,0,0,0
Nicaragua,2006,sn,5564,0,0,0
Nicaragua,2006,sn,65,0,0,0
Nicaragua,2006,sp,014,25,15,40
Nicaragua,2006,sp,1524,168,162,330
Nicaragua,2006,sp,2534,144,151,295
Nicaragua,2006,sp,3544,90,129,219
Nicaragua,2006,sp,4554,65,98,163
Nicaragua,2006,sp,5564,38,90,128
Nicaragua,2006,sp,65,38,72,110
Nicaragua,2007,ep,014,0,0,0
Nicaragua,2007,ep,1524,20,30,50
Nicaragua,2007,ep,2534,52,40,92
Nicaragua,2007,ep,3544,20,30,50
Nicaragua,2007,ep,4554,5,10,15
Nicaragua,2007,ep,5564,10,10,20
Nicaragua,2007,ep,65,5,5,10
Nicaragua,2007,sn,014,0,0,0
Nicaragua,2007,sn,1524,0,0,0
Nicaragua,2007,sn,2534,0,0,0
Nicaragua,2007,sn,3544,0,0,0
Nicaragua,2007,sn,4554,0,0,0
Nicaragua,2007,sn,5564,0,0,0
Nicaragua,2007,sn,65,0,0,0
Nicaragua,2007,sp,014,27,16,43
Nicaragua,2007,sp,1524,158,172,330
Nicaragua,2007,sp,2534,168,194,362
Nicaragua,2007,sp,3544,100,144,244
Nicaragua,2007,sp,4554,76,130,206
Nicaragua,2007,sp,5564,45,77,122
Nicaragua,2007,sp,65,55,91,146
Nicaragua,2008,ep,014,0,0,0
Nicaragua,2008,ep,1524,10,30,40
Nicaragua,2008,ep,2534,10,20,30
Nicaragua,2008,ep,3544,10,10,20
Nicaragua,2008,ep,4554,10,20,30
Nicaragua,2008,ep,5564,10,10,20
Nicaragua,2008,ep,65,15,20,35
Nicaragua,2008,sn,014,0,0,0
Nicaragua,2008,sn,1524,0,0,0
Nicaragua,2008,sn,2534,0,0,0
Nicaragua,2008,sn,3544,0,0,0
Nicaragua,2008,sn,4554,0,0,0
Nicaragua,2008,sn,5564,0,0,0
Nicaragua,2008,sn,65,0,0,0
Nicaragua,2008,sp,014,38,20,58
Nicaragua,2008,sp,1524,165,174,339
Nicaragua,2008,sp,2534,164,190,354
Nicaragua,2008,sp,3544,93,130,223
Nicaragua,2008,sp,4554,54,108,162
Nicaragua,2008,sp,5564,54,90,144
Nicaragua,2008,sp,65,55,67,122
Nicaragua,2009,ep,014,35,33,68
Nicaragua,2009,ep,1524,122,166,288
Nicaragua,2009,ep,2534,139,168,307
Nicaragua,2009,ep,3544,80,121,201
Nicaragua,2009,ep,4554,60,98,158
Nicaragua,2009,ep,5564,52,79,131
Nicaragua,2009,ep,65,47,77,124
Nicaragua,2009,sn,014,35,33,68
Nicaragua,2009,sn,1524,122,166,288
Nicaragua,2009,sn,2534,139,168,307
Nicaragua,2009,sn,3544,80,121,201
Nicaragua,2009,sn,4554,60,98,158
Nicaragua,2009,sn,5564,52,79,131
Nicaragua,2009,sn,65,47,77,124
Nicaragua,2010,sp,014,27,22,49
Nicaragua,2010,sp,1524,154,157,311
Nicaragua,2010,sp,2534,149,189,338
Nicaragua,2010,sp,3544,92,141,233
Nicaragua,2010,sp,4554,75,115,190
Nicaragua,2010,sp,5564,50,82,132
Nicaragua,2010,sp,65,79,108,187
Nicaragua,2011,sp,014,4,10,14
Nicaragua,2011,sp,1524,61,273,334
Nicaragua,2011,sp,2534,145,235,380
Nicaragua,2011,sp,3544,161,156,317
Nicaragua,2011,sp,4554,108,108,216
Nicaragua,2011,sp,5564,64,61,125
Nicaragua,2011,sp,65,72,94,166
Nicaragua,2012,sn,014,0,0,0
Nicaragua,2012,sn,1524,0,0,0
Nicaragua,2012,sn,2534,0,0,0
Nicaragua,2012,sn,3544,0,0,0
Nicaragua,2012,sn,4554,0,0,0
Nicaragua,2012,sn,5564,0,0,0
Nicaragua,2012,sn,65,0,0,0
Nicaragua,2012,sp,014,0,0,0
Nicaragua,2012,sp,1524,0,0,0
Nicaragua,2012,sp,2534,0,0,0
Nicaragua,2012,sp,3544,0,0,0
Nicaragua,2012,sp,4554,0,0,0
Nicaragua,2012,sp,5564,0,0,0
Nicaragua,2012,sp,65,0,0,0
Nicaragua,2013,rel,014,31,28,59
Nicaragua,2013,rel,1524,203,206,409
Nicaragua,2013,rel,2534,161,171,332
Nicaragua,2013,rel,3544,146,143,289
Nicaragua,2013,rel,4554,121,116,237
Nicaragua,2013,rel,5564,85,52,137
Nicaragua,2013,rel,65,39,38,77
Niger,1997,sp,014,7,4,11
Niger,1997,sp,1524,70,148,218
Niger,1997,sp,2534,112,395,507
Niger,1997,sp,3544,67,215,282
Niger,1997,sp,4554,58,92,150
Niger,1997,sp,5564,14,58,72
Niger,1997,sp,65,8,25,33
Niger,1998,sp,014,14,4,18
Niger,1998,sp,1524,92,218,310
Niger,1998,sp,2534,160,511,671
Niger,1998,sp,3544,126,399,525
Niger,1998,sp,4554,86,234,320
Niger,1998,sp,5564,46,159,205
Niger,1998,sp,65,15,61,76
Niger,2000,sp,014,31,29,60
Niger,2000,sp,1524,123,270,393
Niger,2000,sp,2534,206,174,380
Niger,2000,sp,3544,168,441,609
Niger,2000,sp,4554,151,252,403
Niger,2000,sp,5564,63,151,214
Niger,2000,sp,65,9,78,87
Niger,2003,sp,014,30,41,71
Niger,2003,sp,1524,201,485,686
Niger,2003,sp,2534,356,1051,1407
Niger,2003,sp,3544,279,779,1058
Niger,2003,sp,4554,177,512,689
Niger,2003,sp,5564,83,299,382
Niger,2003,sp,65,42,169,211
Niger,2005,sp,014,34,35,69
Niger,2005,sp,1524,214,557,771
Niger,2005,sp,2534,388,1204,1592
Niger,2005,sp,3544,330,819,1149
Niger,2005,sp,4554,223,497,720
Niger,2005,sp,5564,131,350,481
Niger,2005,sp,65,70,198,268
Niger,2006,sp,014,37,25,62
Niger,2006,sp,1524,270,537,807
Niger,2006,sp,2534,427,1265,1692
Niger,2006,sp,3544,306,909,1215
Niger,2006,sp,4554,207,487,694
Niger,2006,sp,5564,149,359,508
Niger,2006,sp,65,84,217,301
Niger,2007,sp,014,57,40,97
Niger,2007,sp,1524,287,571,858
Niger,2007,sp,2534,412,1380,1792
Niger,2007,sp,3544,323,958,1281
Niger,2007,sp,4554,248,577,825
Niger,2007,sp,5564,157,405,562
Niger,2007,sp,65,109,249,358
Niger,2008,sp,014,57,35,92
Niger,2008,sp,1524,259,659,918
Niger,2008,sp,2534,414,1453,1867
Niger,2008,sp,3544,307,852,1159
Niger,2008,sp,4554,237,562,799
Niger,2008,sp,5564,146,429,575
Niger,2008,sp,65,110,333,443
Niger,2009,sp,014,36,52,88
Niger,2009,sp,1524,248,602,850
Niger,2009,sp,2534,464,1552,2016
Niger,2009,sp,3544,339,1019,1358
Niger,2009,sp,4554,239,654,893
Niger,2009,sp,5564,209,478,687
Niger,2009,sp,65,127,328,455
Niger,2010,sp,014,39,44,83
Niger,2010,sp,1524,272,669,941
Niger,2010,sp,2534,418,1587,2005
Niger,2010,sp,3544,347,988,1335
Niger,2010,sp,4554,238,615,853
Niger,2010,sp,5564,174,415,589
Niger,2010,sp,65,135,342,477
Niger,2011,sp,014,50,50,100
Niger,2011,sp,1524,285,709,994
Niger,2011,sp,2534,449,1673,2122
Niger,2011,sp,3544,323,1025,1348
Niger,2011,sp,4554,278,646,924
Niger,2011,sp,5564,189,436,625
Niger,2011,sp,65,147,347,494
Niger,2012,sp,014,48,40,88
Niger,2012,sp,1524,260,702,962
Niger,2012,sp,2534,485,1752,2237
Niger,2012,sp,3544,302,1133,1435
Niger,2012,sp,4554,237,747,984
Niger,2012,sp,5564,214,444,658
Niger,2012,sp,65,124,360,484
Niger,2013,rel,014,47,57,104
Niger,2013,rel,1524,287,749,1036
Niger,2013,rel,2534,487,1834,2321
Niger,2013,rel,3544,353,1151,1504
Niger,2013,rel,4554,253,677,930
Niger,2013,rel,5564,216,515,731
Niger,2013,rel,65,151,405,556
Nigeria,1995,sp,014,404,450,854
Nigeria,1995,sp,1524,842,845,1687
Nigeria,1995,sp,2534,795,921,1716
Nigeria,1995,sp,3544,770,937,1707
Nigeria,1995,sp,4554,724,557,1281
Nigeria,1995,sp,5564,654,611,1265
Nigeria,1995,sp,65,451,515,966
Nigeria,1996,sp,014,411,234,645
Nigeria,1996,sp,1524,1954,2097,4051
Nigeria,1996,sp,2534,2175,2557,4732
Nigeria,1996,sp,3544,1253,1791,3044
Nigeria,1996,sp,4554,871,853,1724
Nigeria,1996,sp,5564,458,486,944
Nigeria,1996,sp,65,215,309,524
Nigeria,1997,sp,014,156,116,272
Nigeria,1997,sp,1524,1556,1518,3074
Nigeria,1997,sp,2534,1517,2095,3612
Nigeria,1997,sp,3544,753,1177,1930
Nigeria,1997,sp,4554,458,734,1192
Nigeria,1997,sp,5564,261,436,697
Nigeria,1997,sp,65,120,338,458
Nigeria,1998,sp,014,169,125,294
Nigeria,1998,sp,1524,1856,1798,3654
Nigeria,1998,sp,2534,1808,2543,4351
Nigeria,1998,sp,3544,881,1282,2163
Nigeria,1998,sp,4554,560,889,1449
Nigeria,1998,sp,5564,298,451,749
Nigeria,1998,sp,65,132,369,501
Nigeria,2000,sp,014,239,157,396
Nigeria,2000,sp,1524,2934,2173,5107
Nigeria,2000,sp,2534,2434,3164,5598
Nigeria,2000,sp,3544,1110,1836,2946
Nigeria,2000,sp,4554,676,1091,1767
Nigeria,2000,sp,5564,344,566,910
Nigeria,2000,sp,65,231,463,694
Nigeria,2001,sp,014,272,164,436
Nigeria,2001,sp,1524,2619,2196,4815
Nigeria,2001,sp,2534,2510,3281,5791
Nigeria,2001,sp,3544,1201,2076,3277
Nigeria,2001,sp,4554,715,1283,1998
Nigeria,2001,sp,5564,387,654,1041
Nigeria,2001,sp,65,251,488,739
Nigeria,2002,sp,014,242,163,405
Nigeria,2002,sp,1524,2633,2274,4907
Nigeria,2002,sp,2534,2884,3719,6603
Nigeria,2002,sp,3544,1368,2283,3651
Nigeria,2002,sp,4554,787,1352,2139
Nigeria,2002,sp,5564,420,696,1116
Nigeria,2002,sp,65,241,534,775
Nigeria,2003,sp,014,356,267,623
Nigeria,2003,sp,1524,3394,3263,6657
Nigeria,2003,sp,2534,3956,5388,9344
Nigeria,2003,sp,3544,1973,3590,5563
Nigeria,2003,sp,4554,1159,2106,3265
Nigeria,2003,sp,5564,536,1139,1675
Nigeria,2003,sp,65,327,719,1046
Nigeria,2004,sp,014,469,408,877
Nigeria,2004,sp,1524,3768,3679,7447
Nigeria,2004,sp,2534,4463,6252,10715
Nigeria,2004,sp,3544,2220,4262,6482
Nigeria,2004,sp,4554,1495,2614,4109
Nigeria,2004,sp,5564,981,1310,2291
Nigeria,2004,sp,65,567,1267,1834
Nigeria,2005,sp,014,482,325,807
Nigeria,2005,sp,1524,3996,3824,7820
Nigeria,2005,sp,2534,4884,6758,11642
Nigeria,2005,sp,3544,2448,4544,6992
Nigeria,2005,sp,4554,1350,2863,4213
Nigeria,2005,sp,5564,745,1464,2209
Nigeria,2005,sp,65,415,950,1365
Nigeria,2006,sp,014,385,247,632
Nigeria,2006,sp,1524,4029,4488,8517
Nigeria,2006,sp,2534,5430,8145,13575
Nigeria,2006,sp,3544,2516,5517,8033
Nigeria,2006,sp,4554,1894,3330,5224
Nigeria,2006,sp,5564,1049,1431,2480
Nigeria,2006,sp,65,545,897,1442
Nigeria,2007,sp,014,685,503,1188
Nigeria,2007,sp,1524,4522,4251,8773
Nigeria,2007,sp,2534,5944,8541,14485
Nigeria,2007,sp,3544,3088,5776,8864
Nigeria,2007,sp,4554,1926,3767,5693
Nigeria,2007,sp,5564,1194,1853,3047
Nigeria,2007,sp,65,625,1341,1966
Nigeria,2008,sp,014,745,579,1324
Nigeria,2008,sp,1524,4431,4518,8949
Nigeria,2008,sp,2534,6391,8910,15301
Nigeria,2008,sp,3544,3351,6210,9561
Nigeria,2008,sp,4554,2057,3821,5878
Nigeria,2008,sp,5564,1099,1987,3086
Nigeria,2008,sp,65,660,1267,1927
Nigeria,2009,sp,014,804,711,1515
Nigeria,2009,sp,1524,4199,4342,8541
Nigeria,2009,sp,2534,6100,8649,14749
Nigeria,2009,sp,3544,3473,5975,9448
Nigeria,2009,sp,4554,1872,3766,5638
Nigeria,2009,sp,5564,1023,2057,3080
Nigeria,2009,sp,65,623,1269,1892
Nigeria,2010,sp,014,595,521,1116
Nigeria,2010,sp,1524,4182,4457,8639
Nigeria,2010,sp,2534,6117,9186,15303
Nigeria,2010,sp,3544,3431,6218,9649
Nigeria,2010,sp,4554,1846,3804,5650
Nigeria,2010,sp,5564,1040,1974,3014
Nigeria,2010,sp,65,682,1363,2045
Nigeria,2011,sp,014,578,529,1107
Nigeria,2011,sp,1524,4198,4549,8747
Nigeria,2011,sp,2534,6168,9520,15688
Nigeria,2011,sp,3544,3574,6550,10124
Nigeria,2011,sp,4554,2014,4230,6244
Nigeria,2011,sp,5564,1112,2248,3360
Nigeria,2011,sp,65,724,1443,2167
Nigeria,2012,sp,014,649,538,1187
Nigeria,2012,sp,1524,4652,5026,9678
Nigeria,2012,sp,2534,6762,10382,17144
Nigeria,2012,sp,3544,4084,7684,11768
Nigeria,2012,sp,4554,2243,4589,6832
Nigeria,2012,sp,5564,1290,2449,3739
Nigeria,2012,sp,65,867,1686,2553
Nigeria,2013,rel,014,2768,3008,5776
Nigeria,2013,rel,1524,7278,7843,15121
Nigeria,2013,rel,2534,11994,16463,28457
Nigeria,2013,rel,3544,8295,13958,22253
Nigeria,2013,rel,4554,5172,8853,14025
Nigeria,2013,rel,5564,2939,5140,8079
Nigeria,2013,rel,65,2434,4256,6690
Niue,1999,sp,1524,NA,1,NA
Niue,2002,sp,014,0,NA,NA
Niue,2002,sp,1524,1,NA,NA
Niue,2004,sp,014,0,0,0
Niue,2004,sp,1524,0,0,0
Niue,2004,sp,2534,0,0,0
Niue,2004,sp,3544,0,0,0
Niue,2004,sp,4554,0,0,0
Niue,2004,sp,5564,0,0,0
Niue,2004,sp,65,0,0,0
Niue,2005,sp,014,0,0,0
Niue,2005,sp,1524,0,0,0
Niue,2005,sp,2534,0,0,0
Niue,2005,sp,3544,0,0,0
Niue,2005,sp,4554,0,0,0
Niue,2005,sp,5564,0,0,0
Niue,2005,sp,65,0,0,0
Niue,2006,ep,014,0,0,0
Niue,2006,ep,1524,0,0,0
Niue,2006,ep,2534,0,0,0
Niue,2006,ep,3544,0,0,0
Niue,2006,ep,4554,0,0,0
Niue,2006,ep,5564,0,0,0
Niue,2006,ep,65,0,0,0
Niue,2006,sn,014,0,0,0
Niue,2006,sn,1524,0,0,0
Niue,2006,sn,2534,0,0,0
Niue,2006,sn,3544,0,0,0
Niue,2006,sn,4554,0,0,0
Niue,2006,sn,5564,0,0,0
Niue,2006,sn,65,0,0,0
Niue,2006,sp,014,0,0,0
Niue,2006,sp,1524,0,0,0
Niue,2006,sp,2534,0,0,0
Niue,2006,sp,3544,0,0,0
Niue,2006,sp,4554,0,0,0
Niue,2006,sp,5564,0,0,0
Niue,2006,sp,65,0,0,0
Niue,2007,sp,014,0,0,0
Niue,2007,sp,1524,0,0,0
Niue,2007,sp,2534,0,0,0
Niue,2007,sp,3544,0,0,0
Niue,2007,sp,4554,0,0,0
Niue,2007,sp,5564,0,0,0
Niue,2007,sp,65,0,0,0
Niue,2008,ep,014,0,0,0
Niue,2008,ep,1524,0,0,0
Niue,2008,ep,2534,0,0,0
Niue,2008,ep,3544,0,0,0
Niue,2008,ep,4554,0,0,0
Niue,2008,ep,5564,0,0,0
Niue,2008,ep,65,0,0,0
Niue,2008,sn,014,0,0,0
Niue,2008,sn,1524,0,0,0
Niue,2008,sn,2534,0,0,0
Niue,2008,sn,3544,0,0,0
Niue,2008,sn,4554,0,0,0
Niue,2008,sn,5564,0,0,0
Niue,2008,sn,65,0,0,0
Niue,2008,sp,014,0,0,0
Niue,2008,sp,1524,0,0,0
Niue,2008,sp,2534,0,0,0
Niue,2008,sp,3544,0,0,0
Niue,2008,sp,4554,0,0,0
Niue,2008,sp,5564,0,0,0
Niue,2008,sp,65,0,0,0
Niue,2011,sn,2534,NA,1,NA
Niue,2012,ep,014,0,0,0
Niue,2012,ep,1524,0,0,0
Niue,2012,ep,2534,0,0,0
Niue,2012,ep,3544,0,0,0
Niue,2012,ep,4554,0,0,0
Niue,2012,ep,5564,0,0,0
Niue,2012,ep,65,0,0,0
Niue,2012,sn,014,0,0,0
Niue,2012,sn,1524,0,0,0
Niue,2012,sn,2534,0,0,0
Niue,2012,sn,3544,0,0,0
Niue,2012,sn,4554,0,0,0
Niue,2012,sn,5564,0,0,0
Niue,2012,sn,65,0,0,0
Niue,2012,sp,014,0,0,0
Niue,2012,sp,1524,0,0,0
Niue,2012,sp,2534,0,0,0
Niue,2012,sp,3544,0,0,0
Niue,2012,sp,4554,0,0,0
Niue,2012,sp,5564,0,0,0
Niue,2012,sp,65,0,0,0
Northern Mariana Islands,1995,sp,014,0,1,1
Northern Mariana Islands,1995,sp,1524,0,1,1
Northern Mariana Islands,1995,sp,2534,2,3,5
Northern Mariana Islands,1995,sp,3544,6,5,11
Northern Mariana Islands,1995,sp,4554,4,10,14
Northern Mariana Islands,1995,sp,5564,1,3,4
Northern Mariana Islands,1995,sp,65,1,3,4
Northern Mariana Islands,1996,sp,014,1,0,1
Northern Mariana Islands,1996,sp,1524,1,2,3
Northern Mariana Islands,1996,sp,2534,1,8,9
Northern Mariana Islands,1996,sp,3544,0,5,5
Northern Mariana Islands,1996,sp,4554,1,3,4
Northern Mariana Islands,1996,sp,5564,1,1,2
Northern Mariana Islands,1996,sp,65,1,1,2
Northern Mariana Islands,1998,sp,014,0,0,0
Northern Mariana Islands,1998,sp,1524,3,0,3
Northern Mariana Islands,1998,sp,2534,4,6,10
Northern Mariana Islands,1998,sp,3544,1,3,4
Northern Mariana Islands,1998,sp,4554,0,5,5
Northern Mariana Islands,1998,sp,5564,0,2,2
Northern Mariana Islands,1998,sp,65,0,2,2
Northern Mariana Islands,2000,sp,014,0,1,1
Northern Mariana Islands,2000,sp,1524,10,4,14
Northern Mariana Islands,2000,sp,2534,17,8,25
Northern Mariana Islands,2000,sp,3544,7,9,16
Northern Mariana Islands,2000,sp,4554,3,9,12
Northern Mariana Islands,2000,sp,5564,1,3,4
Northern Mariana Islands,2000,sp,65,1,2,3
Northern Mariana Islands,2001,sp,014,0,0,0
Northern Mariana Islands,2001,sp,1524,5,1,6
Northern Mariana Islands,2001,sp,2534,4,3,7
Northern Mariana Islands,2001,sp,3544,0,0,0
Northern Mariana Islands,2001,sp,4554,0,4,4
Northern Mariana Islands,2001,sp,5564,0,2,2
Northern Mariana Islands,2001,sp,65,0,0,0
Northern Mariana Islands,2002,sp,014,0,1,1
Northern Mariana Islands,2002,sp,1524,9,2,11
Northern Mariana Islands,2002,sp,2534,10,3,13
Northern Mariana Islands,2002,sp,3544,3,7,10
Northern Mariana Islands,2002,sp,4554,1,10,11
Northern Mariana Islands,2002,sp,5564,0,5,5
Northern Mariana Islands,2002,sp,65,0,2,2
Northern Mariana Islands,2003,sp,014,1,0,1
Northern Mariana Islands,2003,sp,1524,3,2,5
Northern Mariana Islands,2003,sp,2534,0,2,2
Northern Mariana Islands,2003,sp,3544,2,2,4
Northern Mariana Islands,2003,sp,4554,1,1,2
Northern Mariana Islands,2003,sp,5564,0,0,0
Northern Mariana Islands,2003,sp,65,0,2,2
Northern Mariana Islands,2004,sp,014,0,0,0
Northern Mariana Islands,2004,sp,1524,1,0,1
Northern Mariana Islands,2004,sp,2534,2,2,4
Northern Mariana Islands,2004,sp,3544,1,2,3
Northern Mariana Islands,2004,sp,4554,1,4,5
Northern Mariana Islands,2004,sp,5564,0,1,1
Northern Mariana Islands,2004,sp,65,0,0,0
Northern Mariana Islands,2005,sp,014,0,0,0
Northern Mariana Islands,2005,sp,1524,0,0,0
Northern Mariana Islands,2005,sp,2534,0,1,1
Northern Mariana Islands,2005,sp,3544,1,3,4
Northern Mariana Islands,2005,sp,4554,1,4,5
Northern Mariana Islands,2005,sp,5564,1,1,2
Northern Mariana Islands,2005,sp,65,1,2,3
Northern Mariana Islands,2006,ep,014,0,0,0
Northern Mariana Islands,2006,ep,1524,0,0,0
Northern Mariana Islands,2006,ep,2534,0,0,0
Northern Mariana Islands,2006,ep,3544,2,0,2
Northern Mariana Islands,2006,ep,4554,0,1,1
Northern Mariana Islands,2006,ep,5564,0,0,0
Northern Mariana Islands,2006,ep,65,0,1,1
Northern Mariana Islands,2006,sn,014,0,1,1
Northern Mariana Islands,2006,sn,1524,6,0,6
Northern Mariana Islands,2006,sn,2534,4,1,5
Northern Mariana Islands,2006,sn,3544,1,7,8
Northern Mariana Islands,2006,sn,4554,1,5,6
Northern Mariana Islands,2006,sn,5564,3,2,5
Northern Mariana Islands,2006,sn,65,0,1,1
Northern Mariana Islands,2006,sp,014,0,0,0
Northern Mariana Islands,2006,sp,1524,2,0,2
Northern Mariana Islands,2006,sp,2534,2,2,4
Northern Mariana Islands,2006,sp,3544,3,3,6
Northern Mariana Islands,2006,sp,4554,1,1,2
Northern Mariana Islands,2006,sp,5564,0,0,0
Northern Mariana Islands,2006,sp,65,1,0,1
Northern Mariana Islands,2007,ep,014,0,0,0
Northern Mariana Islands,2007,ep,1524,0,0,0
Northern Mariana Islands,2007,ep,2534,0,0,0
Northern Mariana Islands,2007,ep,3544,0,0,0
Northern Mariana Islands,2007,ep,4554,0,1,1
Northern Mariana Islands,2007,ep,5564,1,0,1
Northern Mariana Islands,2007,ep,65,0,0,0
Northern Mariana Islands,2007,sn,014,0,1,1
Northern Mariana Islands,2007,sn,1524,1,1,2
Northern Mariana Islands,2007,sn,2534,3,3,6
Northern Mariana Islands,2007,sn,3544,4,8,12
Northern Mariana Islands,2007,sn,4554,2,0,2
Northern Mariana Islands,2007,sn,5564,1,4,5
Northern Mariana Islands,2007,sn,65,0,0,0
Northern Mariana Islands,2007,sp,014,0,0,0
Northern Mariana Islands,2007,sp,1524,0,0,0
Northern Mariana Islands,2007,sp,2534,2,0,2
Northern Mariana Islands,2007,sp,3544,1,3,4
Northern Mariana Islands,2007,sp,4554,1,4,5
Northern Mariana Islands,2007,sp,5564,1,0,1
Northern Mariana Islands,2007,sp,65,2,2,4
Northern Mariana Islands,2008,ep,014,0,0,0
Northern Mariana Islands,2008,ep,1524,0,0,0
Northern Mariana Islands,2008,ep,2534,0,0,0
Northern Mariana Islands,2008,ep,3544,1,0,1
Northern Mariana Islands,2008,ep,4554,0,2,2
Northern Mariana Islands,2008,ep,5564,0,0,0
Northern Mariana Islands,2008,ep,65,0,0,0
Northern Mariana Islands,2008,sn,014,0,0,0
Northern Mariana Islands,2008,sn,1524,1,0,1
Northern Mariana Islands,2008,sn,2534,1,0,1
Northern Mariana Islands,2008,sn,3544,0,5,5
Northern Mariana Islands,2008,sn,4554,1,2,3
Northern Mariana Islands,2008,sn,5564,1,1,2
Northern Mariana Islands,2008,sn,65,0,0,0
Northern Mariana Islands,2008,sp,014,0,0,0
Northern Mariana Islands,2008,sp,1524,0,1,1
Northern Mariana Islands,2008,sp,2534,0,0,0
Northern Mariana Islands,2008,sp,3544,2,1,3
Northern Mariana Islands,2008,sp,4554,0,5,5
Northern Mariana Islands,2008,sp,5564,1,0,1
Northern Mariana Islands,2008,sp,65,0,3,3
Northern Mariana Islands,2009,ep,014,0,0,0
Northern Mariana Islands,2009,ep,1524,0,0,0
Northern Mariana Islands,2009,ep,2534,0,0,0
Northern Mariana Islands,2009,ep,3544,0,1,1
Northern Mariana Islands,2009,ep,4554,4,1,5
Northern Mariana Islands,2009,ep,5564,0,0,0
Northern Mariana Islands,2009,ep,65,0,0,0
Northern Mariana Islands,2009,sn,014,0,0,0
Northern Mariana Islands,2009,sn,1524,2,0,2
Northern Mariana Islands,2009,sn,2534,1,1,2
Northern Mariana Islands,2009,sn,3544,1,1,2
Northern Mariana Islands,2009,sn,4554,3,2,5
Northern Mariana Islands,2009,sn,5564,0,5,5
Northern Mariana Islands,2009,sn,65,0,0,0
Northern Mariana Islands,2009,sp,014,0,0,0
Northern Mariana Islands,2009,sp,1524,1,0,1
Northern Mariana Islands,2009,sp,2534,0,1,1
Northern Mariana Islands,2009,sp,3544,0,4,4
Northern Mariana Islands,2009,sp,4554,1,4,5
Northern Mariana Islands,2009,sp,5564,1,3,4
Northern Mariana Islands,2009,sp,65,0,1,1
Northern Mariana Islands,2010,ep,014,0,0,0
Northern Mariana Islands,2010,ep,1524,0,0,0
Northern Mariana Islands,2010,ep,2534,0,0,0
Northern Mariana Islands,2010,ep,3544,0,1,1
Northern Mariana Islands,2010,ep,4554,0,0,0
Northern Mariana Islands,2010,ep,5564,0,0,0
Northern Mariana Islands,2010,ep,65,0,1,1
Northern Mariana Islands,2010,sn,014,0,0,0
Northern Mariana Islands,2010,sn,1524,0,1,1
Northern Mariana Islands,2010,sn,2534,2,1,3
Northern Mariana Islands,2010,sn,3544,1,1,2
Northern Mariana Islands,2010,sn,4554,0,2,2
Northern Mariana Islands,2010,sn,5564,0,2,2
Northern Mariana Islands,2010,sn,65,1,2,3
Northern Mariana Islands,2010,sp,014,0,0,0
Northern Mariana Islands,2010,sp,1524,2,2,4
Northern Mariana Islands,2010,sp,2534,0,0,0
Northern Mariana Islands,2010,sp,3544,1,0,1
Northern Mariana Islands,2010,sp,4554,3,3,6
Northern Mariana Islands,2010,sp,5564,2,3,5
Northern Mariana Islands,2010,sp,65,1,0,1
Northern Mariana Islands,2011,ep,014,0,0,0
Northern Mariana Islands,2011,ep,1524,1,0,1
Northern Mariana Islands,2011,ep,2534,1,0,1
Northern Mariana Islands,2011,ep,3544,0,0,0
Northern Mariana Islands,2011,ep,4554,0,0,0
Northern Mariana Islands,2011,ep,5564,0,0,0
Northern Mariana Islands,2011,ep,65,0,0,0
Northern Mariana Islands,2011,sn,014,0,0,0
Northern Mariana Islands,2011,sn,1524,1,0,1
Northern Mariana Islands,2011,sn,2534,0,0,0
Northern Mariana Islands,2011,sn,3544,1,2,3
Northern Mariana Islands,2011,sn,4554,2,3,5
Northern Mariana Islands,2011,sn,5564,1,6,7
Northern Mariana Islands,2011,sn,65,0,0,0
Northern Mariana Islands,2011,sp,014,0,0,0
Northern Mariana Islands,2011,sp,1524,0,0,0
Northern Mariana Islands,2011,sp,2534,1,0,1
Northern Mariana Islands,2011,sp,3544,0,0,0
Northern Mariana Islands,2011,sp,4554,2,1,3
Northern Mariana Islands,2011,sp,5564,3,5,8
Northern Mariana Islands,2011,sp,65,0,3,3
Northern Mariana Islands,2012,ep,014,0,0,0
Northern Mariana Islands,2012,ep,1524,0,0,0
Northern Mariana Islands,2012,ep,2534,0,0,0
Northern Mariana Islands,2012,ep,3544,0,0,0
Northern Mariana Islands,2012,ep,4554,0,1,1
Northern Mariana Islands,2012,ep,5564,0,2,2
Northern Mariana Islands,2012,ep,65,0,0,0
Northern Mariana Islands,2012,sn,014,0,0,0
Northern Mariana Islands,2012,sn,1524,0,1,1
Northern Mariana Islands,2012,sn,2534,4,1,5
Northern Mariana Islands,2012,sn,3544,3,6,9
Northern Mariana Islands,2012,sn,4554,1,3,4
Northern Mariana Islands,2012,sn,5564,0,2,2
Northern Mariana Islands,2012,sn,65,1,2,3
Northern Mariana Islands,2012,sp,014,0,0,0
Northern Mariana Islands,2012,sp,1524,0,0,0
Northern Mariana Islands,2012,sp,2534,3,0,3
Northern Mariana Islands,2012,sp,3544,1,3,4
Northern Mariana Islands,2012,sp,4554,0,1,1
Northern Mariana Islands,2012,sp,5564,0,1,1
Northern Mariana Islands,2012,sp,65,0,0,0
Northern Mariana Islands,2013,rel,014,0,0,0
Northern Mariana Islands,2013,rel,1524,1,2,3
Northern Mariana Islands,2013,rel,2534,4,2,6
Northern Mariana Islands,2013,rel,3544,2,1,3
Northern Mariana Islands,2013,rel,4554,6,3,9
Northern Mariana Islands,2013,rel,5564,4,5,9
Northern Mariana Islands,2013,rel,65,1,2,3
Norway,1995,sp,014,0,0,0
Norway,1995,sp,1524,4,4,8
Norway,1995,sp,2534,7,8,15
Norway,1995,sp,3544,2,6,8
Norway,1995,sp,4554,0,3,3
Norway,1995,sp,5564,3,5,8
Norway,1995,sp,65,8,12,20
Norway,1996,sp,014,1,3,4
Norway,1996,sp,1524,4,8,12
Norway,1996,sp,2534,10,7,17
Norway,1996,sp,3544,5,14,19
Norway,1996,sp,4554,2,6,8
Norway,1996,sp,5564,0,2,2
Norway,1996,sp,65,17,24,41
Norway,1997,sp,014,0,3,3
Norway,1997,sp,1524,3,6,9
Norway,1997,sp,2534,4,10,14
Norway,1997,sp,3544,8,7,15
Norway,1997,sp,4554,4,6,10
Norway,1997,sp,5564,2,2,4
Norway,1997,sp,65,18,27,45
Norway,1998,sp,014,0,0,0
Norway,1998,sp,1524,8,1,9
Norway,1998,sp,2534,2,4,6
Norway,1998,sp,3544,3,3,6
Norway,1998,sp,4554,1,1,2
Norway,1998,sp,5564,2,2,4
Norway,1998,sp,65,5,17,22
Norway,1999,sp,014,0,0,0
Norway,1999,sp,1524,3,2,5
Norway,1999,sp,2534,2,5,7
Norway,1999,sp,3544,2,3,5
Norway,1999,sp,4554,0,2,2
Norway,1999,sp,5564,0,1,1
Norway,1999,sp,65,0,1,1
Norway,2000,sp,014,1,0,1
Norway,2000,sp,1524,3,1,4
Norway,2000,sp,2534,1,9,10
Norway,2000,sp,3544,NA,3,NA
Norway,2000,sp,4554,NA,6,NA
Norway,2000,sp,5564,2,2,4
Norway,2000,sp,65,5,4,9
Norway,2001,sp,014,1,0,1
Norway,2001,sp,1524,6,6,12
Norway,2001,sp,2534,9,8,17
Norway,2001,sp,3544,1,8,9
Norway,2001,sp,4554,1,4,5
Norway,2001,sp,5564,2,1,3
Norway,2001,sp,65,4,8,12
Norway,2002,sp,014,0,0,0
Norway,2002,sp,1524,3,4,7
Norway,2002,sp,2534,5,4,9
Norway,2002,sp,3544,1,4,5
Norway,2002,sp,4554,2,2,4
Norway,2002,sp,5564,0,0,0
Norway,2002,sp,65,2,4,6
Norway,2003,sp,014,0,0,0
Norway,2003,sp,1524,4,3,7
Norway,2003,sp,2534,9,3,12
Norway,2003,sp,3544,4,4,8
Norway,2003,sp,4554,2,4,6
Norway,2003,sp,5564,0,2,2
Norway,2003,sp,65,1,2,3
Norway,2004,sp,014,0,1,1
Norway,2004,sp,1524,3,5,8
Norway,2004,sp,2534,8,6,14
Norway,2004,sp,3544,4,6,10
Norway,2004,sp,4554,2,1,3
Norway,2004,sp,5564,1,1,2
Norway,2004,sp,65,6,2,8
Norway,2005,sp,014,0,0,0
Norway,2005,sp,1524,4,9,13
Norway,2005,sp,2534,7,4,11
Norway,2005,sp,3544,2,6,8
Norway,2005,sp,4554,1,4,5
Norway,2005,sp,5564,0,4,4
Norway,2005,sp,65,3,3,6
Norway,2006,ep,014,5,2,7
Norway,2006,ep,1524,13,12,25
Norway,2006,ep,2534,12,13,25
Norway,2006,ep,3544,14,9,23
Norway,2006,ep,4554,5,4,9
Norway,2006,ep,5564,0,4,4
Norway,2006,ep,65,4,2,6
Norway,2006,sn,014,8,6,14
Norway,2006,sn,1524,12,11,23
Norway,2006,sn,2534,24,10,34
Norway,2006,sn,3544,8,9,17
Norway,2006,sn,4554,4,7,11
Norway,2006,sn,5564,5,6,11
Norway,2006,sn,65,7,14,21
Norway,2006,sp,014,1,0,1
Norway,2006,sp,1524,5,5,10
Norway,2006,sp,2534,5,10,15
Norway,2006,sp,3544,2,5,7
Norway,2006,sp,4554,2,3,5
Norway,2006,sp,5564,1,3,4
Norway,2006,sp,65,3,1,4
Norway,2007,ep,014,7,2,9
Norway,2007,ep,1524,11,12,23
Norway,2007,ep,2534,19,11,30
Norway,2007,ep,3544,10,14,24
Norway,2007,ep,4554,4,6,10
Norway,2007,ep,5564,2,0,2
Norway,2007,ep,65,10,8,18
Norway,2007,sn,014,4,5,9
Norway,2007,sn,1524,13,14,27
Norway,2007,sn,2534,20,17,37
Norway,2007,sn,3544,5,16,21
Norway,2007,sn,4554,5,3,8
Norway,2007,sn,5564,2,3,5
Norway,2007,sn,65,13,8,21
Norway,2007,sp,014,1,NA,NA
Norway,2007,sp,1524,4,4,8
Norway,2007,sp,2534,2,12,14
Norway,2007,sp,3544,5,2,7
Norway,2007,sp,4554,1,3,4
Norway,2007,sp,5564,NA,1,NA
Norway,2007,sp,65,1,2,3
Norway,2008,ep,014,5,7,12
Norway,2008,ep,1524,5,5,10
Norway,2008,ep,2534,23,22,45
Norway,2008,ep,3544,8,5,13
Norway,2008,ep,4554,3,4,7
Norway,2008,ep,5564,2,3,5
Norway,2008,ep,65,10,6,16
Norway,2008,sn,014,6,1,7
Norway,2008,sn,1524,10,14,24
Norway,2008,sn,2534,12,13,25
Norway,2008,sn,3544,12,3,15
Norway,2008,sn,4554,3,4,7
Norway,2008,sn,5564,1,2,3
Norway,2008,sn,65,2,8,10
Norway,2008,sp,014,0,1,1
Norway,2008,sp,1524,1,10,11
Norway,2008,sp,2534,6,8,14
Norway,2008,sp,3544,4,7,11
Norway,2008,sp,4554,0,2,2
Norway,2008,sp,5564,1,4,5
Norway,2008,sp,65,6,3,9
Norway,2009,ep,014,1,1,2
Norway,2009,ep,1524,16,11,27
Norway,2009,ep,2534,13,21,34
Norway,2009,ep,3544,12,12,24
Norway,2009,ep,4554,4,1,5
Norway,2009,ep,5564,1,3,4
Norway,2009,ep,65,3,2,5
Norway,2009,sn,014,4,6,10
Norway,2009,sn,1524,10,24,34
Norway,2009,sn,2534,20,25,45
Norway,2009,sn,3544,8,9,17
Norway,2009,sn,4554,1,5,6
Norway,2009,sn,5564,3,4,7
Norway,2009,sn,65,4,6,10
Norway,2009,sp,014,1,0,1
Norway,2009,sp,1524,2,6,8
Norway,2009,sp,2534,5,14,19
Norway,2009,sp,3544,4,5,9
Norway,2009,sp,4554,1,1,2
Norway,2009,sp,5564,1,2,3
Norway,2009,sp,65,3,0,3
Norway,2010,ep,014,5,2,7
Norway,2010,ep,1524,8,11,19
Norway,2010,ep,2534,22,27,49
Norway,2010,ep,3544,12,10,22
Norway,2010,ep,4554,5,4,9
Norway,2010,ep,5564,4,4,8
Norway,2010,ep,65,1,1,2
Norway,2010,sn,014,1,4,5
Norway,2010,sn,1524,8,15,23
Norway,2010,sn,2534,19,20,39
Norway,2010,sn,3544,10,10,20
Norway,2010,sn,4554,2,3,5
Norway,2010,sn,5564,6,2,8
Norway,2010,sn,65,3,7,10
Norway,2010,sp,014,0,0,0
Norway,2010,sp,1524,5,9,14
Norway,2010,sp,2534,7,9,16
Norway,2010,sp,3544,3,7,10
Norway,2010,sp,4554,2,1,3
Norway,2010,sp,5564,0,4,4
Norway,2010,sp,65,1,2,3
Norway,2011,ep,014,6,1,7
Norway,2011,ep,1524,14,21,35
Norway,2011,ep,2534,26,26,52
Norway,2011,ep,3544,11,7,18
Norway,2011,ep,4554,5,8,13
Norway,2011,ep,5564,4,2,6
Norway,2011,ep,65,3,3,6
Norway,2011,sn,014,4,5,9
Norway,2011,sn,1524,12,23,35
Norway,2011,sn,2534,25,20,45
Norway,2011,sn,3544,4,10,14
Norway,2011,sn,4554,3,7,10
Norway,2011,sn,5564,1,4,5
Norway,2011,sn,65,4,10,14
Norway,2011,sp,014,0,0,0
Norway,2011,sp,1524,14,3,17
Norway,2011,sp,2534,7,7,14
Norway,2011,sp,3544,0,3,3
Norway,2011,sp,4554,1,3,4
Norway,2011,sp,5564,0,1,1
Norway,2011,sp,65,1,1,2
Norway,2012,ep,014,4,3,7
Norway,2012,ep,1524,14,10,24
Norway,2012,ep,2534,25,23,48
Norway,2012,ep,3544,17,11,28
Norway,2012,ep,4554,6,3,9
Norway,2012,ep,5564,3,1,4
Norway,2012,ep,65,5,3,8
Norway,2012,sn,014,5,5,10
Norway,2012,sn,1524,12,25,37
Norway,2012,sn,2534,22,15,37
Norway,2012,sn,3544,11,10,21
Norway,2012,sn,4554,4,8,12
Norway,2012,sn,5564,4,5,9
Norway,2012,sn,65,7,7,14
Norway,2012,sp,014,0,1,1
Norway,2012,sp,1524,2,8,10
Norway,2012,sp,2534,8,15,23
Norway,2012,sp,3544,1,5,6
Norway,2012,sp,4554,4,8,12
Norway,2012,sp,5564,1,5,6
Norway,2012,sp,65,1,2,3
Norway,2013,rel,014,10,7,17
Norway,2013,rel,1524,46,54,100
Norway,2013,rel,2534,60,57,117
Norway,2013,rel,3544,26,30,56
Norway,2013,rel,4554,10,13,23
Norway,2013,rel,5564,8,14,22
Norway,2013,rel,65,16,11,27
Oman,1995,sp,014,2,1,3
Oman,1995,sp,1524,18,7,25
Oman,1995,sp,2534,13,12,25
Oman,1995,sp,3544,5,7,12
Oman,1995,sp,4554,5,7,12
Oman,1995,sp,5564,6,10,16
Oman,1995,sp,65,3,11,14
Oman,1996,sp,014,3,0,3
Oman,1996,sp,1524,18,15,33
Oman,1996,sp,2534,4,14,18
Oman,1996,sp,3544,3,8,11
Oman,1996,sp,4554,5,11,16
Oman,1996,sp,5564,1,8,9
Oman,1996,sp,65,7,11,18
Oman,1997,sp,014,2,0,2
Oman,1997,sp,1524,14,18,32
Oman,1997,sp,2534,7,16,23
Oman,1997,sp,3544,4,14,18
Oman,1997,sp,4554,5,10,15
Oman,1997,sp,5564,4,11,15
Oman,1997,sp,65,5,10,15
Oman,1998,sp,014,3,0,3
Oman,1998,sp,1524,14,18,32
Oman,1998,sp,2534,6,9,15
Oman,1998,sp,3544,6,8,14
Oman,1998,sp,4554,5,14,19
Oman,1998,sp,5564,3,9,12
Oman,1998,sp,65,2,12,14
Oman,1999,sp,014,3,2,5
Oman,1999,sp,1524,16,10,26
Oman,1999,sp,2534,4,11,15
Oman,1999,sp,3544,6,23,29
Oman,1999,sp,4554,1,15,16
Oman,1999,sp,5564,4,7,11
Oman,1999,sp,65,8,10,18
Oman,2000,sp,014,2,1,3
Oman,2000,sp,1524,17,8,25
Oman,2000,sp,2534,5,9,14
Oman,2000,sp,3544,7,11,18
Oman,2000,sp,4554,5,12,17
Oman,2000,sp,5564,11,9,20
Oman,2000,sp,65,6,11,17
Oman,2001,sp,014,4,1,5
Oman,2001,sp,1524,17,10,27
Oman,2001,sp,2534,8,8,16
Oman,2001,sp,3544,5,12,17
Oman,2001,sp,4554,9,6,15
Oman,2001,sp,5564,5,8,13
Oman,2001,sp,65,8,8,16
Oman,2002,sp,014,16,7,23
Oman,2002,sp,1524,41,22,63
Oman,2002,sp,2534,15,18,33
Oman,2002,sp,3544,12,20,32
Oman,2002,sp,4554,13,16,29
Oman,2002,sp,5564,7,26,33
Oman,2002,sp,65,7,20,27
Oman,2003,sp,014,10,5,15
Oman,2003,sp,1524,26,28,54
Oman,2003,sp,2534,18,32,50
Oman,2003,sp,3544,12,31,43
Oman,2003,sp,4554,13,29,42
Oman,2003,sp,5564,11,13,24
Oman,2003,sp,65,7,15,22
Oman,2004,sp,014,0,1,1
Oman,2004,sp,1524,0,15,15
Oman,2004,sp,2534,9,12,21
Oman,2004,sp,3544,1,23,24
Oman,2004,sp,4554,0,30,30
Oman,2004,sp,5564,0,12,12
Oman,2004,sp,65,0,14,14
Oman,2005,sp,014,2,1,3
Oman,2005,sp,1524,13,21,34
Oman,2005,sp,2534,5,11,16
Oman,2005,sp,3544,3,24,27
Oman,2005,sp,4554,4,15,19
Oman,2005,sp,5564,5,19,24
Oman,2005,sp,65,3,5,8
Oman,2006,ep,014,6,7,13
Oman,2006,ep,1524,17,11,28
Oman,2006,ep,2534,8,16,24
Oman,2006,ep,3544,4,9,13
Oman,2006,ep,4554,8,4,12
Oman,2006,ep,5564,5,4,9
Oman,2006,ep,65,4,5,9
Oman,2006,sn,014,11,10,21
Oman,2006,sn,1524,19,17,36
Oman,2006,sn,2534,7,23,30
Oman,2006,sn,3544,3,14,17
Oman,2006,sn,4554,8,8,16
Oman,2006,sn,5564,8,6,14
Oman,2006,sn,65,7,9,16
Oman,2006,sp,014,2,6,8
Oman,2006,sp,1524,21,18,39
Oman,2006,sp,2534,22,19,41
Oman,2006,sp,3544,7,18,25
Oman,2006,sp,4554,13,18,31
Oman,2006,sp,5564,12,12,24
Oman,2006,sp,65,14,2,16
Oman,2007,ep,014,7,3,10
Oman,2007,ep,1524,17,9,26
Oman,2007,ep,2534,8,8,16
Oman,2007,ep,3544,8,10,18
Oman,2007,ep,4554,5,6,11
Oman,2007,ep,5564,10,2,12
Oman,2007,ep,65,5,4,9
Oman,2007,sn,014,1,6,7
Oman,2007,sn,1524,4,3,7
Oman,2007,sn,2534,2,4,6
Oman,2007,sn,3544,0,1,1
Oman,2007,sn,4554,2,1,3
Oman,2007,sn,5564,1,2,3
Oman,2007,sn,65,1,5,6
Oman,2007,sp,014,3,0,3
Oman,2007,sp,1524,22,16,38
Oman,2007,sp,2534,13,25,38
Oman,2007,sp,3544,11,25,36
Oman,2007,sp,4554,10,20,30
Oman,2007,sp,5564,7,13,20
Oman,2007,sp,65,14,8,22
Oman,2008,ep,014,6,2,8
Oman,2008,ep,1524,26,14,40
Oman,2008,ep,2534,13,17,30
Oman,2008,ep,3544,7,10,17
Oman,2008,ep,4554,8,5,13
Oman,2008,ep,5564,12,6,18
Oman,2008,ep,65,2,1,3
Oman,2008,sn,014,0,4,4
Oman,2008,sn,1524,6,5,11
Oman,2008,sn,2534,2,7,9
Oman,2008,sn,3544,2,9,11
Oman,2008,sn,4554,3,1,4
Oman,2008,sn,5564,0,3,3
Oman,2008,sn,65,2,4,6
Oman,2008,sp,014,1,0,1
Oman,2008,sp,1524,20,18,38
Oman,2008,sp,2534,10,28,38
Oman,2008,sp,3544,4,28,32
Oman,2008,sp,4554,4,28,32
Oman,2008,sp,5564,5,14,19
Oman,2008,sp,65,1,10,11
Oman,2009,ep,014,7,4,11
Oman,2009,ep,1524,12,11,23
Oman,2009,ep,2534,26,14,40
Oman,2009,ep,3544,6,11,17
Oman,2009,ep,4554,11,3,14
Oman,2009,ep,5564,3,8,11
Oman,2009,ep,65,4,7,11
Oman,2009,sn,014,0,2,2
Oman,2009,sn,1524,2,6,8
Oman,2009,sn,2534,0,6,6
Oman,2009,sn,3544,0,4,4
Oman,2009,sn,4554,0,2,2
Oman,2009,sn,5564,2,6,8
Oman,2009,sn,65,2,4,6
Oman,2009,sp,014,2,0,2
Oman,2009,sp,1524,11,28,39
Oman,2009,sp,2534,14,35,49
Oman,2009,sp,3544,4,23,27
Oman,2009,sp,4554,6,13,19
Oman,2009,sp,5564,1,10,11
Oman,2009,sp,65,6,11,17
Oman,2010,ep,014,4,1,5
Oman,2010,ep,1524,18,8,26
Oman,2010,ep,2534,21,16,37
Oman,2010,ep,3544,9,7,16
Oman,2010,ep,4554,8,8,16
Oman,2010,ep,5564,4,8,12
Oman,2010,ep,65,6,6,12
Oman,2010,sn,014,2,2,4
Oman,2010,sn,1524,3,1,4
Oman,2010,sn,2534,1,5,6
Oman,2010,sn,3544,0,2,2
Oman,2010,sn,4554,1,2,3
Oman,2010,sn,5564,0,3,3
Oman,2010,sn,65,1,5,6
Oman,2010,sp,014,3,2,5
Oman,2010,sp,1524,18,12,30
Oman,2010,sp,2534,22,27,49
Oman,2010,sp,3544,6,15,21
Oman,2010,sp,4554,4,16,20
Oman,2010,sp,5564,4,8,12
Oman,2010,sp,65,5,10,15
Oman,2011,ep,014,7,5,12
Oman,2011,ep,1524,17,11,28
Oman,2011,ep,2534,15,16,31
Oman,2011,ep,3544,9,9,18
Oman,2011,ep,4554,12,4,16
Oman,2011,ep,5564,6,6,12
Oman,2011,ep,65,1,4,5
Oman,2011,sn,014,0,0,0
Oman,2011,sn,1524,3,3,6
Oman,2011,sn,2534,4,7,11
Oman,2011,sn,3544,2,3,5
Oman,2011,sn,4554,0,1,1
Oman,2011,sn,5564,1,1,2
Oman,2011,sn,65,3,4,7
Oman,2011,sp,014,5,1,6
Oman,2011,sp,1524,20,17,37
Oman,2011,sp,2534,21,25,46
Oman,2011,sp,3544,9,12,21
Oman,2011,sp,4554,13,23,36
Oman,2011,sp,5564,7,10,17
Oman,2011,sp,65,6,11,17
Oman,2012,ep,014,5,4,9
Oman,2012,ep,1524,9,12,21
Oman,2012,ep,2534,18,18,36
Oman,2012,ep,3544,7,11,18
Oman,2012,ep,4554,7,14,21
Oman,2012,ep,5564,6,5,11
Oman,2012,ep,65,6,9,15
Oman,2012,sn,014,2,3,5
Oman,2012,sn,1524,3,6,9
Oman,2012,sn,2534,5,5,10
Oman,2012,sn,3544,2,3,5
Oman,2012,sn,4554,2,2,4
Oman,2012,sn,5564,1,2,3
Oman,2012,sn,65,2,1,3
Oman,2012,sp,014,0,0,0
Oman,2012,sp,1524,20,18,38
Oman,2012,sp,2534,37,33,70
Oman,2012,sp,3544,10,23,33
Oman,2012,sp,4554,10,12,22
Oman,2012,sp,5564,9,8,17
Oman,2012,sp,65,6,19,25
Oman,2013,rel,014,10,6,16
Oman,2013,rel,1524,41,32,73
Oman,2013,rel,2534,42,49,91
Oman,2013,rel,3544,14,44,58
Oman,2013,rel,4554,11,19,30
Oman,2013,rel,5564,12,20,32
Oman,2013,rel,65,9,21,30
Pakistan,1995,sp,014,85,29,114
Pakistan,1995,sp,1524,375,274,649
Pakistan,1995,sp,2534,381,230,611
Pakistan,1995,sp,3544,267,178,445
Pakistan,1995,sp,4554,178,140,318
Pakistan,1995,sp,5564,143,124,267
Pakistan,1995,sp,65,79,95,174
Pakistan,1998,sp,014,159,59,218
Pakistan,1998,sp,1524,735,633,1368
Pakistan,1998,sp,2534,507,449,956
Pakistan,1998,sp,3544,260,328,588
Pakistan,1998,sp,4554,209,335,544
Pakistan,1998,sp,5564,90,194,284
Pakistan,1998,sp,65,50,137,187
Pakistan,1999,sp,014,33,49,82
Pakistan,1999,sp,1524,259,229,488
Pakistan,1999,sp,2534,373,178,551
Pakistan,1999,sp,3544,97,65,162
Pakistan,1999,sp,4554,146,211,357
Pakistan,1999,sp,5564,243,162,405
Pakistan,1999,sp,65,114,113,227
Pakistan,2000,sp,014,130,55,185
Pakistan,2000,sp,1524,591,498,1089
Pakistan,2000,sp,2534,416,387,803
Pakistan,2000,sp,3544,274,256,530
Pakistan,2000,sp,4554,163,232,395
Pakistan,2000,sp,5564,103,153,256
Pakistan,2000,sp,65,56,130,186
Pakistan,2001,sp,014,241,139,380
Pakistan,2001,sp,1524,1007,1191,2198
Pakistan,2001,sp,2534,915,891,1806
Pakistan,2001,sp,3544,650,673,1323
Pakistan,2001,sp,4554,421,664,1085
Pakistan,2001,sp,5564,252,496,748
Pakistan,2001,sp,65,142,306,448
Pakistan,2002,sp,014,512,225,737
Pakistan,2002,sp,1524,2401,1964,4365
Pakistan,2002,sp,2534,1917,1734,3651
Pakistan,2002,sp,3544,1283,1270,2553
Pakistan,2002,sp,4554,809,1113,1922
Pakistan,2002,sp,5564,539,864,1403
Pakistan,2002,sp,65,303,554,857
Pakistan,2003,sp,014,622,284,906
Pakistan,2003,sp,1524,3007,2605,5612
Pakistan,2003,sp,2534,2471,2346,4817
Pakistan,2003,sp,3544,1669,1851,3520
Pakistan,2003,sp,4554,1280,1652,2932
Pakistan,2003,sp,5564,845,1288,2133
Pakistan,2003,sp,65,503,870,1373
Pakistan,2004,sp,014,950,363,1313
Pakistan,2004,sp,1524,4281,3812,8093
Pakistan,2004,sp,2534,3656,3309,6965
Pakistan,2004,sp,3544,2452,2676,5128
Pakistan,2004,sp,4554,1794,2329,4123
Pakistan,2004,sp,5564,1350,2057,3407
Pakistan,2004,sp,65,837,1581,2418
Pakistan,2005,sp,014,1447,621,2068
Pakistan,2005,sp,1524,6463,5278,11741
Pakistan,2005,sp,2534,5611,4759,10370
Pakistan,2005,sp,3544,3987,4263,8250
Pakistan,2005,sp,4554,2866,3834,6700
Pakistan,2005,sp,5564,2060,3332,5392
Pakistan,2005,sp,65,1338,2453,3791
Pakistan,2006,sp,014,1941,820,2761
Pakistan,2006,sp,1524,8410,7290,15700
Pakistan,2006,sp,2534,7030,6896,13926
Pakistan,2006,sp,3544,5404,5594,10998
Pakistan,2006,sp,4554,3913,5427,9340
Pakistan,2006,sp,5564,2802,4392,7194
Pakistan,2006,sp,65,1950,3439,5389
Pakistan,2007,sp,014,2443,1017,3460
Pakistan,2007,sp,1524,11522,9598,21120
Pakistan,2007,sp,2534,9162,8790,17952
Pakistan,2007,sp,3544,7352,7717,15069
Pakistan,2007,sp,4554,5496,7237,12733
Pakistan,2007,sp,5564,4065,6258,10323
Pakistan,2007,sp,65,2934,5156,8090
Pakistan,2008,sp,014,2696,1213,3909
Pakistan,2008,sp,1524,12838,10521,23359
Pakistan,2008,sp,2534,10489,9889,20378
Pakistan,2008,sp,3544,8146,8428,16574
Pakistan,2008,sp,4554,6387,8284,14671
Pakistan,2008,sp,5564,4750,6890,11640
Pakistan,2008,sp,65,3547,5959,9506
Pakistan,2009,sp,014,2595,1052,3647
Pakistan,2009,sp,1524,13734,11090,24824
Pakistan,2009,sp,2534,10512,10035,20547
Pakistan,2009,sp,3544,8174,8472,16646
Pakistan,2009,sp,4554,6332,8366,14698
Pakistan,2009,sp,5564,4786,7053,11839
Pakistan,2009,sp,65,3492,5981,9473
Pakistan,2010,ep,014,4228,3293,7521
Pakistan,2010,ep,1524,0,0,0
Pakistan,2010,ep,2534,0,0,0
Pakistan,2010,ep,3544,0,0,0
Pakistan,2010,ep,4554,0,0,0
Pakistan,2010,ep,5564,0,0,0
Pakistan,2010,ep,65,0,0,0
Pakistan,2010,sn,014,6562,5631,12193
Pakistan,2010,sn,1524,0,0,0
Pakistan,2010,sn,2534,0,0,0
Pakistan,2010,sn,3544,0,0,0
Pakistan,2010,sn,4554,0,0,0
Pakistan,2010,sn,5564,0,0,0
Pakistan,2010,sn,65,0,0,0
Pakistan,2010,sp,014,3212,1548,4760
Pakistan,2010,sp,1524,14481,11860,26341
Pakistan,2010,sp,2534,10513,10462,20975
Pakistan,2010,sp,3544,7749,8320,16069
Pakistan,2010,sp,4554,6410,7969,14379
Pakistan,2010,sp,5564,4879,6934,11813
Pakistan,2010,sp,65,4338,6066,10404
Pakistan,2011,ep,014,4350,3346,7696
Pakistan,2011,sn,014,7048,7094,14142
Pakistan,2011,sp,014,2679,1216,3895
Pakistan,2011,sp,1524,14652,12143,26795
Pakistan,2011,sp,2534,10684,10515,21199
Pakistan,2011,sp,3544,7880,8435,16315
Pakistan,2011,sp,4554,6590,8608,15198
Pakistan,2011,sp,5564,4977,7320,12297
Pakistan,2011,sp,65,3711,6323,10034
Pakistan,2012,ep,014,4655,3673,8328
Pakistan,2012,sn,014,7493,6391,13884
Pakistan,2012,sp,014,2630,1317,3947
Pakistan,2012,sp,1524,15445,12605,28050
Pakistan,2012,sp,2534,10902,10838,21740
Pakistan,2012,sp,3544,8263,8848,17111
Pakistan,2012,sp,4554,6876,9026,15902
Pakistan,2012,sp,5564,5494,7753,13247
Pakistan,2012,sp,65,4056,6492,10548
Pakistan,2013,rel,014,15646,12467,28113
Palau,1995,sp,014,0,0,0
Palau,1995,sp,1524,0,2,2
Palau,1995,sp,2534,0,3,3
Palau,1995,sp,3544,0,0,0
Palau,1995,sp,4554,1,2,3
Palau,1995,sp,5564,0,1,1
Palau,1995,sp,65,0,0,0
Palau,1996,sp,014,NA,0,NA
Palau,1996,sp,1524,NA,1,NA
Palau,1996,sp,2534,NA,0,NA
Palau,1996,sp,3544,NA,0,NA
Palau,1996,sp,4554,NA,0,NA
Palau,1996,sp,5564,NA,2,NA
Palau,1996,sp,65,NA,1,NA
Palau,1997,sp,014,0,0,0
Palau,1997,sp,1524,0,0,0
Palau,1997,sp,2534,0,1,1
Palau,1997,sp,3544,2,2,4
Palau,1997,sp,4554,0,0,0
Palau,1997,sp,5564,0,2,2
Palau,1997,sp,65,0,0,0
Palau,1999,sp,014,0,0,0
Palau,1999,sp,1524,1,2,3
Palau,1999,sp,2534,3,2,5
Palau,1999,sp,3544,1,5,6
Palau,1999,sp,4554,0,1,1
Palau,1999,sp,5564,2,2,4
Palau,1999,sp,65,0,1,1
Palau,2002,sp,014,0,1,1
Palau,2002,sp,1524,0,0,0
Palau,2002,sp,2534,3,1,4
Palau,2002,sp,3544,0,1,1
Palau,2002,sp,4554,0,2,2
Palau,2002,sp,5564,0,2,2
Palau,2002,sp,65,0,1,1
Palau,2003,sp,014,1,0,1
Palau,2003,sp,1524,0,0,0
Palau,2003,sp,2534,0,1,1
Palau,2003,sp,3544,1,1,2
Palau,2003,sp,4554,0,1,1
Palau,2003,sp,5564,1,1,2
Palau,2003,sp,65,2,0,2
Palau,2004,sp,3544,1,NA,NA
Palau,2004,sp,4554,1,1,2
Palau,2004,sp,5564,NA,2,NA
Palau,2005,sp,2534,NA,2,NA
Palau,2005,sp,65,NA,1,NA
Palau,2006,ep,014,0,1,1
Palau,2006,ep,1524,0,0,0
Palau,2006,ep,2534,2,0,2
Palau,2006,ep,3544,0,0,0
Palau,2006,ep,4554,1,0,1
Palau,2006,ep,5564,0,0,0
Palau,2006,ep,65,0,0,0
Palau,2006,sn,014,0,0,0
Palau,2006,sn,1524,0,0,0
Palau,2006,sn,2534,1,0,1
Palau,2006,sn,3544,0,1,1
Palau,2006,sn,4554,0,0,0
Palau,2006,sn,5564,0,0,0
Palau,2006,sn,65,0,0,0
Palau,2006,sp,014,0,1,1
Palau,2006,sp,1524,0,0,0
Palau,2006,sp,2534,1,1,2
Palau,2006,sp,3544,0,2,2
Palau,2006,sp,4554,0,1,1
Palau,2006,sp,5564,0,0,0
Palau,2006,sp,65,0,0,0
Palau,2007,ep,014,0,0,0
Palau,2007,ep,1524,0,0,0
Palau,2007,ep,2534,0,0,0
Palau,2007,ep,3544,0,1,1
Palau,2007,ep,4554,0,0,0
Palau,2007,ep,5564,0,0,0
Palau,2007,ep,65,0,2,2
Palau,2007,sn,014,0,0,0
Palau,2007,sn,1524,0,0,0
Palau,2007,sn,2534,0,1,1
Palau,2007,sn,3544,0,0,0
Palau,2007,sn,4554,1,0,1
Palau,2007,sn,5564,1,0,1
Palau,2007,sn,65,0,0,0
Palau,2007,sp,014,0,0,0
Palau,2007,sp,1524,0,0,0
Palau,2007,sp,2534,0,1,1
Palau,2007,sp,3544,0,0,0
Palau,2007,sp,4554,0,2,2
Palau,2007,sp,5564,1,1,2
Palau,2007,sp,65,0,0,0
Palau,2009,ep,014,0,0,0
Palau,2009,ep,1524,0,0,0
Palau,2009,ep,2534,0,0,0
Palau,2009,ep,3544,0,1,1
Palau,2009,ep,4554,0,0,0
Palau,2009,ep,5564,0,2,2
Palau,2009,ep,65,0,1,1
Palau,2009,sn,014,0,0,0
Palau,2009,sn,1524,0,0,0
Palau,2009,sn,2534,0,0,0
Palau,2009,sn,3544,0,0,0
Palau,2009,sn,4554,1,1,2
Palau,2009,sn,5564,0,1,1
Palau,2009,sn,65,2,1,3
Palau,2009,sp,014,0,0,0
Palau,2009,sp,1524,0,0,0
Palau,2009,sp,2534,0,0,0
Palau,2009,sp,3544,0,0,0
Palau,2009,sp,4554,1,1,2
Palau,2009,sp,5564,0,1,1
Palau,2009,sp,65,2,1,3
Palau,2010,ep,014,0,0,0
Palau,2010,ep,1524,0,0,0
Palau,2010,ep,2534,0,0,0
Palau,2010,ep,3544,0,0,0
Palau,2010,ep,4554,0,0,0
Palau,2010,ep,5564,0,0,0
Palau,2010,ep,65,0,0,0
Palau,2010,sn,014,1,0,1
Palau,2010,sn,1524,0,1,1
Palau,2010,sn,2534,1,2,3
Palau,2010,sn,3544,1,1,2
Palau,2010,sn,4554,0,1,1
Palau,2010,sn,5564,0,1,1
Palau,2010,sn,65,0,1,1
Palau,2010,sp,014,1,0,1
Palau,2010,sp,1524,0,1,1
Palau,2010,sp,2534,1,2,3
Palau,2010,sp,3544,1,1,2
Palau,2010,sp,4554,0,1,1
Palau,2010,sp,5564,0,1,1
Palau,2010,sp,65,0,1,1
Palau,2011,ep,014,0,0,0
Palau,2011,ep,1524,0,0,0
Palau,2011,ep,2534,0,0,0
Palau,2011,ep,3544,0,0,0
Palau,2011,ep,4554,0,0,0
Palau,2011,ep,5564,1,0,1
Palau,2011,ep,65,0,0,0
Palau,2011,sn,014,0,0,0
Palau,2011,sn,1524,0,0,0
Palau,2011,sn,2534,1,0,1
Palau,2011,sn,3544,0,0,0
Palau,2011,sn,4554,0,1,1
Palau,2011,sn,5564,2,1,3
Palau,2011,sn,65,1,0,1
Palau,2011,sp,014,0,0,0
Palau,2011,sp,1524,0,0,0
Palau,2011,sp,2534,1,0,1
Palau,2011,sp,3544,0,1,1
Palau,2011,sp,4554,0,0,0
Palau,2011,sp,5564,0,2,2
Palau,2011,sp,65,0,0,0
Palau,2012,ep,014,0,0,0
Palau,2012,ep,1524,0,0,0
Palau,2012,ep,2534,0,0,0
Palau,2012,ep,3544,0,0,0
Palau,2012,ep,4554,0,0,0
Palau,2012,ep,5564,0,0,0
Palau,2012,ep,65,0,0,0
Palau,2012,sn,014,0,0,0
Palau,2012,sn,1524,0,0,0
Palau,2012,sn,2534,0,0,0
Palau,2012,sn,3544,0,0,0
Palau,2012,sn,4554,0,0,0
Palau,2012,sn,5564,0,1,1
Palau,2012,sn,65,0,0,0
Palau,2012,sp,014,0,0,0
Palau,2012,sp,1524,0,0,0
Palau,2012,sp,2534,0,0,0
Palau,2012,sp,3544,1,0,1
Palau,2012,sp,4554,1,0,1
Palau,2012,sp,5564,0,0,0
Palau,2012,sp,65,1,0,1
Palau,2013,rel,014,0,0,0
Palau,2013,rel,1524,0,0,0
Palau,2013,rel,2534,0,2,2
Palau,2013,rel,3544,0,1,1
Palau,2013,rel,4554,0,0,0
Palau,2013,rel,5564,1,2,3
Palau,2013,rel,65,2,0,2
Panama,1995,sp,014,72,86,158
Panama,1995,sp,1524,120,155,275
Panama,1995,sp,2534,111,193,304
Panama,1995,sp,3544,75,112,187
Panama,1995,sp,4554,57,126,183
Panama,1995,sp,5564,16,42,58
Panama,1995,sp,65,40,83,123
Panama,1996,sp,014,58,52,110
Panama,1996,sp,1524,62,68,130
Panama,1996,sp,2534,76,132,208
Panama,1996,sp,3544,59,87,146
Panama,1996,sp,4554,36,65,101
Panama,1996,sp,5564,35,44,79
Panama,1996,sp,65,26,45,71
Panama,1997,sp,014,23,41,64
Panama,1997,sp,1524,45,79,124
Panama,1997,sp,2534,86,173,259
Panama,1997,sp,3544,46,117,163
Panama,1997,sp,4554,23,75,98
Panama,1997,sp,5564,26,70,96
Panama,1997,sp,65,19,39,58
Panama,1998,sp,014,1,2,3
Panama,1998,sp,1524,9,14,23
Panama,1998,sp,2534,13,14,27
Panama,1998,sp,3544,7,10,17
Panama,1998,sp,4554,3,4,7
Panama,1998,sp,5564,1,3,4
Panama,1998,sp,65,2,5,7
Panama,1999,sp,014,53,38,91
Panama,1999,sp,1524,83,107,190
Panama,1999,sp,2534,100,209,309
Panama,1999,sp,3544,62,134,196
Panama,1999,sp,4554,52,106,158
Panama,1999,sp,5564,43,81,124
Panama,1999,sp,65,37,72,109
Panama,2000,sp,014,6,3,9
Panama,2000,sp,1524,43,44,87
Panama,2000,sp,2534,34,78,112
Panama,2000,sp,3544,35,61,96
Panama,2000,sp,4554,19,37,56
Panama,2000,sp,5564,12,27,39
Panama,2000,sp,65,16,26,42
Panama,2001,sp,014,9,7,16
Panama,2001,sp,1524,45,58,103
Panama,2001,sp,2534,70,109,179
Panama,2001,sp,3544,46,89,135
Panama,2001,sp,4554,27,73,100
Panama,2001,sp,5564,12,50,62
Panama,2001,sp,65,23,39,62
Panama,2002,sp,014,7,7,14
Panama,2002,sp,1524,50,89,139
Panama,2002,sp,2534,54,108,162
Panama,2002,sp,3544,59,101,160
Panama,2002,sp,4554,29,76,105
Panama,2002,sp,5564,18,68,86
Panama,2002,sp,65,34,68,102
Panama,2003,sp,014,14,10,24
Panama,2003,sp,1524,51,91,142
Panama,2003,sp,2534,77,122,199
Panama,2003,sp,3544,50,81,131
Panama,2003,sp,4554,30,74,104
Panama,2003,sp,5564,24,61,85
Panama,2003,sp,65,28,67,95
Panama,2004,sp,014,9,16,25
Panama,2004,sp,1524,98,89,187
Panama,2004,sp,2534,66,123,189
Panama,2004,sp,3544,59,118,177
Panama,2004,sp,4554,33,91,124
Panama,2004,sp,5564,34,65,99
Panama,2004,sp,65,33,50,83
Panama,2005,sp,014,11,5,16
Panama,2005,sp,1524,73,76,149
Panama,2005,sp,2534,81,129,210
Panama,2005,sp,3544,62,129,191
Panama,2005,sp,4554,33,84,117
Panama,2005,sp,5564,30,57,87
Panama,2005,sp,65,41,49,90
Panama,2006,ep,014,12,16,28
Panama,2006,ep,1524,19,20,39
Panama,2006,ep,2534,17,50,67
Panama,2006,ep,3544,15,35,50
Panama,2006,ep,4554,10,21,31
Panama,2006,ep,5564,5,11,16
Panama,2006,ep,65,11,12,23
Panama,2006,sn,014,75,75,150
Panama,2006,sn,1524,47,59,106
Panama,2006,sn,2534,38,96,134
Panama,2006,sn,3544,37,96,133
Panama,2006,sn,4554,22,57,79
Panama,2006,sn,5564,18,41,59
Panama,2006,sn,65,23,34,57
Panama,2006,sp,014,14,7,21
Panama,2006,sp,1524,64,100,164
Panama,2006,sp,2534,83,134,217
Panama,2006,sp,3544,52,107,159
Panama,2006,sp,4554,45,88,133
Panama,2006,sp,5564,26,48,74
Panama,2006,sp,65,33,57,90
Panama,2007,ep,014,11,11,22
Panama,2007,ep,1524,11,24,35
Panama,2007,ep,2534,20,40,60
Panama,2007,ep,3544,18,33,51
Panama,2007,ep,4554,4,13,17
Panama,2007,ep,5564,8,13,21
Panama,2007,ep,65,14,18,32
Panama,2007,sn,014,46,49,95
Panama,2007,sn,1524,22,39,61
Panama,2007,sn,2534,27,51,78
Panama,2007,sn,3544,31,57,88
Panama,2007,sn,4554,14,48,62
Panama,2007,sn,5564,20,30,50
Panama,2007,sn,65,11,25,36
Panama,2007,sp,014,7,7,14
Panama,2007,sp,1524,56,106,162
Panama,2007,sp,2534,74,139,213
Panama,2007,sp,3544,59,116,175
Panama,2007,sp,4554,33,81,114
Panama,2007,sp,5564,21,50,71
Panama,2007,sp,65,23,61,84
Panama,2008,ep,014,15,18,33
Panama,2008,ep,1524,18,19,37
Panama,2008,ep,2534,17,37,54
Panama,2008,ep,3544,16,40,56
Panama,2008,ep,4554,7,23,30
Panama,2008,ep,5564,7,9,16
Panama,2008,ep,65,16,20,36
Panama,2008,sn,014,36,42,78
Panama,2008,sn,1524,15,35,50
Panama,2008,sn,2534,26,45,71
Panama,2008,sn,3544,14,48,62
Panama,2008,sn,4554,11,39,50
Panama,2008,sn,5564,18,26,44
Panama,2008,sn,65,7,33,40
Panama,2008,sp,014,10,9,19
Panama,2008,sp,1524,59,102,161
Panama,2008,sp,2534,76,123,199
Panama,2008,sp,3544,58,99,157
Panama,2008,sp,4554,48,114,162
Panama,2008,sp,5564,30,63,93
Panama,2008,sp,65,27,65,92
Panama,2009,ep,014,19,14,33
Panama,2009,ep,1524,19,34,53
Panama,2009,ep,2534,21,43,64
Panama,2009,ep,3544,15,33,48
Panama,2009,ep,4554,11,16,27
Panama,2009,ep,5564,6,24,30
Panama,2009,ep,65,8,24,32
Panama,2009,sn,014,55,56,111
Panama,2009,sn,1524,18,31,49
Panama,2009,sn,2534,28,52,80
Panama,2009,sn,3544,26,49,75
Panama,2009,sn,4554,10,34,44
Panama,2009,sn,5564,12,21,33
Panama,2009,sn,65,19,25,44
Panama,2009,sp,014,6,10,16
Panama,2009,sp,1524,59,58,117
Panama,2009,sp,2534,68,101,169
Panama,2009,sp,3544,68,110,178
Panama,2009,sp,4554,43,69,112
Panama,2009,sp,5564,24,57,81
Panama,2009,sp,65,32,63,95
Panama,2010,ep,014,25,22,47
Panama,2010,ep,1524,15,29,44
Panama,2010,ep,2534,18,51,69
Panama,2010,ep,3544,14,54,68
Panama,2010,ep,4554,8,18,26
Panama,2010,ep,5564,6,19,25
Panama,2010,ep,65,8,15,23
Panama,2010,sn,014,50,65,115
Panama,2010,sn,1524,17,43,60
Panama,2010,sn,2534,21,48,69
Panama,2010,sn,3544,15,41,56
Panama,2010,sn,4554,24,32,56
Panama,2010,sn,5564,6,32,38
Panama,2010,sn,65,14,37,51
Panama,2010,sp,014,6,6,12
Panama,2010,sp,1524,55,70,125
Panama,2010,sp,2534,55,123,178
Panama,2010,sp,3544,46,81,127
Panama,2010,sp,4554,43,65,108
Panama,2010,sp,5564,24,61,85
Panama,2010,sp,65,31,51,82
Panama,2011,ep,014,13,13,26
Panama,2011,ep,1524,19,18,37
Panama,2011,ep,2534,14,33,47
Panama,2011,ep,3544,5,39,44
Panama,2011,ep,4554,9,19,28
Panama,2011,ep,5564,7,19,26
Panama,2011,ep,65,13,13,26
Panama,2011,sn,014,46,48,94
Panama,2011,sn,1524,20,28,48
Panama,2011,sn,2534,25,54,79
Panama,2011,sn,3544,22,62,84
Panama,2011,sn,4554,9,33,42
Panama,2011,sn,5564,8,28,36
Panama,2011,sn,65,30,27,57
Panama,2011,sp,014,10,10,20
Panama,2011,sp,1524,57,100,157
Panama,2011,sp,2534,65,108,173
Panama,2011,sp,3544,63,94,157
Panama,2011,sp,4554,46,105,151
Panama,2011,sp,5564,43,62,105
Panama,2011,sp,65,50,48,98
Panama,2012,ep,014,8,21,29
Panama,2012,ep,1524,11,35,46
Panama,2012,ep,2534,13,50,63
Panama,2012,ep,3544,12,29,41
Panama,2012,ep,4554,7,17,24
Panama,2012,ep,5564,6,14,20
Panama,2012,ep,65,10,15,25
Panama,2012,sn,014,35,72,107
Panama,2012,sn,1524,20,39,59
Panama,2012,sn,2534,23,57,80
Panama,2012,sn,3544,27,32,59
Panama,2012,sn,4554,16,35,51
Panama,2012,sn,5564,13,28,41
Panama,2012,sn,65,14,23,37
Panama,2012,sp,014,9,19,28
Panama,2012,sp,1524,62,88,150
Panama,2012,sp,2534,57,103,160
Panama,2012,sp,3544,45,104,149
Panama,2012,sp,4554,46,67,113
Panama,2012,sp,5564,22,51,73
Panama,2012,sp,65,44,61,105
Panama,2013,rel,014,59,54,113
Panama,2013,rel,1524,89,142,231
Panama,2013,rel,2534,103,217,320
Panama,2013,rel,3544,80,161,241
Panama,2013,rel,4554,64,150,214
Panama,2013,rel,5564,47,74,121
Panama,2013,rel,65,70,114,184
Papua New Guinea,1996,sp,014,11,11,22
Papua New Guinea,1996,sp,1524,41,31,72
Papua New Guinea,1996,sp,2534,30,25,55
Papua New Guinea,1996,sp,3544,11,18,29
Papua New Guinea,1996,sp,4554,10,4,14
Papua New Guinea,1996,sp,5564,6,3,9
Papua New Guinea,1996,sp,65,2,2,4
Papua New Guinea,1997,sp,014,1,2,3
Papua New Guinea,1997,sp,1524,11,9,20
Papua New Guinea,1997,sp,2534,5,8,13
Papua New Guinea,1997,sp,3544,3,5,8
Papua New Guinea,1997,sp,4554,1,2,3
Papua New Guinea,1997,sp,5564,0,2,2
Papua New Guinea,1997,sp,65,0,0,0
Papua New Guinea,1998,sp,014,11,9,20
Papua New Guinea,1998,sp,1524,94,69,163
Papua New Guinea,1998,sp,2534,51,57,108
Papua New Guinea,1998,sp,3544,27,30,57
Papua New Guinea,1998,sp,4554,21,25,46
Papua New Guinea,1998,sp,5564,3,14,17
Papua New Guinea,1998,sp,65,1,4,5
Papua New Guinea,1999,sp,014,0,1,1
Papua New Guinea,1999,sp,1524,32,33,65
Papua New Guinea,1999,sp,2534,20,25,45
Papua New Guinea,1999,sp,3544,13,9,22
Papua New Guinea,1999,sp,4554,6,8,14
Papua New Guinea,1999,sp,5564,0,3,3
Papua New Guinea,1999,sp,65,1,0,1
Papua New Guinea,2000,sp,014,6,8,14
Papua New Guinea,2000,sp,1524,77,87,164
Papua New Guinea,2000,sp,2534,45,70,115
Papua New Guinea,2000,sp,3544,21,30,51
Papua New Guinea,2000,sp,4554,15,21,36
Papua New Guinea,2000,sp,5564,5,12,17
Papua New Guinea,2000,sp,65,1,5,6
Papua New Guinea,2001,sp,014,7,4,11
Papua New Guinea,2001,sp,1524,91,101,192
Papua New Guinea,2001,sp,2534,64,72,136
Papua New Guinea,2001,sp,3544,32,29,61
Papua New Guinea,2001,sp,4554,17,26,43
Papua New Guinea,2001,sp,5564,5,9,14
Papua New Guinea,2001,sp,65,1,4,5
Papua New Guinea,2002,sp,014,22,18,40
Papua New Guinea,2002,sp,1524,160,139,299
Papua New Guinea,2002,sp,2534,149,133,282
Papua New Guinea,2002,sp,3544,60,74,134
Papua New Guinea,2002,sp,4554,47,62,109
Papua New Guinea,2002,sp,5564,18,37,55
Papua New Guinea,2002,sp,65,1,6,7
Papua New Guinea,2003,sp,014,28,17,45
Papua New Guinea,2003,sp,1524,193,190,383
Papua New Guinea,2003,sp,2534,171,153,324
Papua New Guinea,2003,sp,3544,59,96,155
Papua New Guinea,2003,sp,4554,29,65,94
Papua New Guinea,2003,sp,5564,20,32,52
Papua New Guinea,2003,sp,65,7,7,14
Papua New Guinea,2004,sp,014,30,28,58
Papua New Guinea,2004,sp,1524,164,153,317
Papua New Guinea,2004,sp,2534,161,138,299
Papua New Guinea,2004,sp,3544,66,90,156
Papua New Guinea,2004,sp,4554,38,61,99
Papua New Guinea,2004,sp,5564,18,43,61
Papua New Guinea,2004,sp,65,3,6,9
Papua New Guinea,2005,sp,014,38,28,66
Papua New Guinea,2005,sp,1524,200,183,383
Papua New Guinea,2005,sp,2534,204,205,409
Papua New Guinea,2005,sp,3544,124,108,232
Papua New Guinea,2005,sp,4554,65,94,159
Papua New Guinea,2005,sp,5564,35,48,83
Papua New Guinea,2005,sp,65,2,12,14
Papua New Guinea,2006,sp,014,41,32,73
Papua New Guinea,2006,sp,1524,226,221,447
Papua New Guinea,2006,sp,2534,215,220,435
Papua New Guinea,2006,sp,3544,142,122,264
Papua New Guinea,2006,sp,4554,75,84,159
Papua New Guinea,2006,sp,5564,24,48,72
Papua New Guinea,2006,sp,65,3,3,6
Papua New Guinea,2007,sp,014,32,16,48
Papua New Guinea,2007,sp,1524,148,178,326
Papua New Guinea,2007,sp,2534,153,171,324
Papua New Guinea,2007,sp,3544,84,112,196
Papua New Guinea,2007,sp,4554,36,67,103
Papua New Guinea,2007,sp,5564,15,50,65
Papua New Guinea,2007,sp,65,3,6,9
Papua New Guinea,2008,sp,014,71,65,136
Papua New Guinea,2008,sp,1524,261,250,511
Papua New Guinea,2008,sp,2534,230,207,437
Papua New Guinea,2008,sp,3544,113,160,273
Papua New Guinea,2008,sp,4554,75,95,170
Papua New Guinea,2008,sp,5564,48,58,106
Papua New Guinea,2008,sp,65,10,12,22
Papua New Guinea,2010,sp,014,64,37,101
Papua New Guinea,2010,sp,1524,313,279,592
Papua New Guinea,2010,sp,2534,292,260,552
Papua New Guinea,2010,sp,3544,191,196,387
Papua New Guinea,2010,sp,4554,97,135,232
Papua New Guinea,2010,sp,5564,52,87,139
Papua New Guinea,2010,sp,65,9,27,36
Papua New Guinea,2011,sp,014,53,50,103
Papua New Guinea,2011,sp,1524,302,278,580
Papua New Guinea,2011,sp,2534,272,265,537
Papua New Guinea,2011,sp,3544,146,152,298
Papua New Guinea,2011,sp,4554,97,122,219
Papua New Guinea,2011,sp,5564,55,71,126
Papua New Guinea,2011,sp,65,15,18,33
Papua New Guinea,2012,sp,014,55,54,109
Papua New Guinea,2012,sp,1524,398,415,813
Papua New Guinea,2012,sp,2534,395,387,782
Papua New Guinea,2012,sp,3544,208,250,458
Papua New Guinea,2012,sp,4554,156,182,338
Papua New Guinea,2012,sp,5564,95,121,216
Papua New Guinea,2012,sp,65,29,37,66
Paraguay,1995,sp,014,13,18,31
Paraguay,1995,sp,1524,65,64,129
Paraguay,1995,sp,2534,49,71,120
Paraguay,1995,sp,3544,46,96,142
Paraguay,1995,sp,4554,35,74,109
Paraguay,1995,sp,5564,34,57,91
Paraguay,1995,sp,65,53,61,114
Paraguay,1996,sp,014,16,17,33
Paraguay,1996,sp,1524,80,84,164
Paraguay,1996,sp,2534,91,100,191
Paraguay,1996,sp,3544,50,79,129
Paraguay,1996,sp,4554,50,91,141
Paraguay,1996,sp,5564,48,63,111
Paraguay,1996,sp,65,59,49,108
Paraguay,1997,sp,014,27,25,52
Paraguay,1997,sp,1524,91,100,191
Paraguay,1997,sp,2534,72,82,154
Paraguay,1997,sp,3544,58,75,133
Paraguay,1997,sp,4554,48,76,124
Paraguay,1997,sp,5564,50,58,108
Paraguay,1997,sp,65,42,74,116
Paraguay,1998,sp,014,17,14,31
Paraguay,1998,sp,1524,87,100,187
Paraguay,1998,sp,2534,55,101,156
Paraguay,1998,sp,3544,37,96,133
Paraguay,1998,sp,4554,36,82,118
Paraguay,1998,sp,5564,34,66,100
Paraguay,1998,sp,65,38,85,123
Paraguay,1999,sp,014,22,19,41
Paraguay,1999,sp,1524,84,113,197
Paraguay,1999,sp,2534,72,157,229
Paraguay,1999,sp,3544,56,111,167
Paraguay,1999,sp,4554,43,114,157
Paraguay,1999,sp,5564,48,69,117
Paraguay,1999,sp,65,60,67,127
Paraguay,2000,sp,014,12,16,28
Paraguay,2000,sp,1524,69,112,181
Paraguay,2000,sp,2534,86,103,189
Paraguay,2000,sp,3544,41,105,146
Paraguay,2000,sp,4554,41,86,127
Paraguay,2000,sp,5564,30,80,110
Paraguay,2000,sp,65,46,71,117
Paraguay,2001,sp,014,22,18,40
Paraguay,2001,sp,1524,91,114,205
Paraguay,2001,sp,2534,71,106,177
Paraguay,2001,sp,3544,46,85,131
Paraguay,2001,sp,4554,51,89,140
Paraguay,2001,sp,5564,31,74,105
Paraguay,2001,sp,65,41,73,114
Paraguay,2002,sp,014,12,20,32
Paraguay,2002,sp,1524,88,119,207
Paraguay,2002,sp,2534,83,127,210
Paraguay,2002,sp,3544,50,112,162
Paraguay,2002,sp,4554,36,105,141
Paraguay,2002,sp,5564,55,78,133
Paraguay,2002,sp,65,39,78,117
Paraguay,2003,sp,014,28,11,39
Paraguay,2003,sp,1524,87,163,250
Paraguay,2003,sp,2534,71,174,245
Paraguay,2003,sp,3544,77,109,186
Paraguay,2003,sp,4554,50,123,173
Paraguay,2003,sp,5564,40,81,121
Paraguay,2003,sp,65,61,91,152
Paraguay,2004,sp,014,21,18,39
Paraguay,2004,sp,1524,106,160,266
Paraguay,2004,sp,2534,87,132,219
Paraguay,2004,sp,3544,69,120,189
Paraguay,2004,sp,4554,63,107,170
Paraguay,2004,sp,5564,50,103,153
Paraguay,2004,sp,65,43,121,164
Paraguay,2005,sp,014,31,23,54
Paraguay,2005,sp,1524,89,168,257
Paraguay,2005,sp,2534,98,185,283
Paraguay,2005,sp,3544,69,136,205
Paraguay,2005,sp,4554,52,117,169
Paraguay,2005,sp,5564,29,87,116
Paraguay,2005,sp,65,71,99,170
Paraguay,2006,ep,014,14,21,35
Paraguay,2006,ep,1524,11,13,24
Paraguay,2006,ep,2534,11,18,29
Paraguay,2006,ep,3544,7,24,31
Paraguay,2006,ep,4554,9,7,16
Paraguay,2006,ep,5564,1,14,15
Paraguay,2006,ep,65,9,15,24
Paraguay,2006,sn,014,149,131,280
Paraguay,2006,sn,1524,36,40,76
Paraguay,2006,sn,2534,30,46,76
Paraguay,2006,sn,3544,25,35,60
Paraguay,2006,sn,4554,33,45,78
Paraguay,2006,sn,5564,20,51,71
Paraguay,2006,sn,65,41,59,100
Paraguay,2006,sp,014,16,20,36
Paraguay,2006,sp,1524,130,188,318
Paraguay,2006,sp,2534,79,221,300
Paraguay,2006,sp,3544,73,143,216
Paraguay,2006,sp,4554,55,150,205
Paraguay,2006,sp,5564,63,124,187
Paraguay,2006,sp,65,66,116,182
Paraguay,2007,ep,014,16,16,32
Paraguay,2007,ep,1524,12,28,40
Paraguay,2007,ep,2534,13,19,32
Paraguay,2007,ep,3544,13,20,33
Paraguay,2007,ep,4554,6,24,30
Paraguay,2007,ep,5564,4,10,14
Paraguay,2007,ep,65,11,22,33
Paraguay,2007,sn,014,126,153,279
Paraguay,2007,sn,1524,20,36,56
Paraguay,2007,sn,2534,27,47,74
Paraguay,2007,sn,3544,23,43,66
Paraguay,2007,sn,4554,16,49,65
Paraguay,2007,sn,5564,27,41,68
Paraguay,2007,sn,65,24,51,75
Paraguay,2007,sp,014,15,14,29
Paraguay,2007,sp,1524,100,171,271
Paraguay,2007,sp,2534,98,221,319
Paraguay,2007,sp,3544,46,152,198
Paraguay,2007,sp,4554,46,135,181
Paraguay,2007,sp,5564,34,94,128
Paraguay,2007,sp,65,47,100,147
Paraguay,2008,ep,014,20,15,35
Paraguay,2008,ep,1524,12,22,34
Paraguay,2008,ep,2534,15,29,44
Paraguay,2008,ep,3544,6,31,37
Paraguay,2008,ep,4554,11,22,33
Paraguay,2008,ep,5564,5,18,23
Paraguay,2008,ep,65,12,22,34
Paraguay,2008,sn,014,63,77,140
Paraguay,2008,sn,1524,33,44,77
Paraguay,2008,sn,2534,28,37,65
Paraguay,2008,sn,3544,12,45,57
Paraguay,2008,sn,4554,14,45,59
Paraguay,2008,sn,5564,13,42,55
Paraguay,2008,sn,65,33,66,99
Paraguay,2008,sp,014,10,11,21
Paraguay,2008,sp,1524,92,238,330
Paraguay,2008,sp,2534,87,227,314
Paraguay,2008,sp,3544,60,138,198
Paraguay,2008,sp,4554,61,138,199
Paraguay,2008,sp,5564,42,91,133
Paraguay,2008,sp,65,56,90,146
Paraguay,2009,ep,014,14,18,32
Paraguay,2009,ep,1524,21,32,53
Paraguay,2009,ep,2534,23,34,57
Paraguay,2009,ep,3544,13,28,41
Paraguay,2009,ep,4554,13,28,41
Paraguay,2009,ep,5564,7,13,20
Paraguay,2009,ep,65,9,30,39
Paraguay,2009,sn,014,87,74,161
Paraguay,2009,sn,1524,19,20,39
Paraguay,2009,sn,2534,14,37,51
Paraguay,2009,sn,3544,11,29,40
Paraguay,2009,sn,4554,14,37,51
Paraguay,2009,sn,5564,10,23,33
Paraguay,2009,sn,65,23,27,50
Paraguay,2009,sp,014,15,15,30
Paraguay,2009,sp,1524,121,203,324
Paraguay,2009,sp,2534,101,263,364
Paraguay,2009,sp,3544,53,173,226
Paraguay,2009,sp,4554,62,155,217
Paraguay,2009,sp,5564,41,120,161
Paraguay,2009,sp,65,57,102,159
Paraguay,2010,ep,014,16,14,30
Paraguay,2010,ep,1524,11,23,34
Paraguay,2010,ep,2534,20,41,61
Paraguay,2010,ep,3544,12,26,38
Paraguay,2010,ep,4554,10,22,32
Paraguay,2010,ep,5564,9,22,31
Paraguay,2010,ep,65,14,25,39
Paraguay,2010,sn,014,73,80,153
Paraguay,2010,sn,1524,23,28,51
Paraguay,2010,sn,2534,24,28,52
Paraguay,2010,sn,3544,8,32,40
Paraguay,2010,sn,4554,27,29,56
Paraguay,2010,sn,5564,13,36,49
Paraguay,2010,sn,65,33,55,88
Paraguay,2010,sp,014,18,18,36
Paraguay,2010,sp,1524,106,163,269
Paraguay,2010,sp,2534,99,244,343
Paraguay,2010,sp,3544,39,129,168
Paraguay,2010,sp,4554,50,143,193
Paraguay,2010,sp,5564,46,103,149
Paraguay,2010,sp,65,45,99,144
Paraguay,2011,ep,014,13,16,29
Paraguay,2011,ep,1524,17,26,43
Paraguay,2011,ep,2534,21,39,60
Paraguay,2011,ep,3544,15,35,50
Paraguay,2011,ep,4554,2,18,20
Paraguay,2011,ep,5564,7,19,26
Paraguay,2011,ep,65,8,13,21
Paraguay,2011,sn,014,68,114,182
Paraguay,2011,sn,1524,30,26,56
Paraguay,2011,sn,2534,19,39,58
Paraguay,2011,sn,3544,17,36,53
Paraguay,2011,sn,4554,24,31,55
Paraguay,2011,sn,5564,14,38,52
Paraguay,2011,sn,65,17,33,50
Paraguay,2011,sp,014,14,9,23
Paraguay,2011,sp,1524,110,182,292
Paraguay,2011,sp,2534,103,238,341
Paraguay,2011,sp,3544,55,135,190
Paraguay,2011,sp,4554,39,151,190
Paraguay,2011,sp,5564,36,124,160
Paraguay,2011,sp,65,62,103,165
Paraguay,2012,ep,014,10,15,25
Paraguay,2012,ep,1524,15,20,35
Paraguay,2012,ep,2534,20,29,49
Paraguay,2012,ep,3544,10,23,33
Paraguay,2012,ep,4554,6,23,29
Paraguay,2012,ep,5564,9,13,22
Paraguay,2012,ep,65,7,21,28
Paraguay,2012,sn,014,83,108,191
Paraguay,2012,sn,1524,23,27,50
Paraguay,2012,sn,2534,27,34,61
Paraguay,2012,sn,3544,7,30,37
Paraguay,2012,sn,4554,25,31,56
Paraguay,2012,sn,5564,11,32,43
Paraguay,2012,sn,65,17,36,53
Paraguay,2012,sp,014,16,4,20
Paraguay,2012,sp,1524,95,180,275
Paraguay,2012,sp,2534,98,230,328
Paraguay,2012,sp,3544,60,158,218
Paraguay,2012,sp,4554,55,143,198
Paraguay,2012,sp,5564,38,116,154
Paraguay,2012,sp,65,60,129,189
Paraguay,2013,rel,014,84,99,183
Paraguay,2013,rel,1524,152,266,418
Paraguay,2013,rel,2534,141,380,521
Paraguay,2013,rel,3544,91,226,317
Paraguay,2013,rel,4554,85,237,322
Paraguay,2013,rel,5564,52,168,220
Paraguay,2013,rel,65,78,184,262
Peru,1995,sp,014,149,147,296
Peru,1995,sp,1524,1005,1311,2316
Peru,1995,sp,2534,660,849,1509
Peru,1995,sp,3544,373,454,827
Peru,1995,sp,4554,259,322,581
Peru,1995,sp,5564,162,200,362
Peru,1995,sp,65,152,216,368
Peru,1996,sp,014,169,151,320
Peru,1996,sp,1524,896,1351,2247
Peru,1996,sp,2534,561,789,1350
Peru,1996,sp,3544,290,420,710
Peru,1996,sp,4554,171,261,432
Peru,1996,sp,5564,132,190,322
Peru,1996,sp,65,144,167,311
Peru,1997,sp,014,864,745,1609
Peru,1997,sp,1524,4560,6913,11473
Peru,1997,sp,2534,2784,3853,6637
Peru,1997,sp,3544,1224,1971,3195
Peru,1997,sp,4554,734,1174,1908
Peru,1997,sp,5564,590,842,1432
Peru,1997,sp,65,496,748,1244
Peru,1998,sp,014,862,704,1566
Peru,1998,sp,1524,4560,6271,10831
Peru,1998,sp,2534,2894,3987,6881
Peru,1998,sp,3544,1431,2095,3526
Peru,1998,sp,4554,686,1337,2023
Peru,1998,sp,5564,537,831,1368
Peru,1998,sp,65,623,889,1512
Peru,1999,sp,014,700,712,1412
Peru,1999,sp,1524,4783,4861,9644
Peru,1999,sp,2534,2958,3007,5965
Peru,1999,sp,3544,1560,1586,3146
Peru,1999,sp,4554,838,852,1690
Peru,1999,sp,5564,613,624,1237
Peru,1999,sp,65,703,714,1417
Peru,2000,sp,014,633,552,1185
Peru,2000,sp,1524,3686,5290,8976
Peru,2000,sp,2534,2472,2875,5347
Peru,2000,sp,3544,1156,1546,2702
Peru,2000,sp,4554,609,1041,1650
Peru,2000,sp,5564,499,801,1300
Peru,2000,sp,65,624,796,1420
Peru,2001,sp,014,11,11,22
Peru,2001,sp,1524,4015,5591,9606
Peru,2001,sp,2534,2382,2887,5269
Peru,2001,sp,3544,1117,1550,2667
Peru,2001,sp,4554,626,979,1605
Peru,2001,sp,5564,480,843,1323
Peru,2001,sp,65,497,696,1193
Peru,2002,sp,014,62,65,127
Peru,2002,sp,1524,688,983,1671
Peru,2002,sp,2534,496,622,1118
Peru,2002,sp,3544,251,298,549
Peru,2002,sp,4554,129,194,323
Peru,2002,sp,5564,96,164,260
Peru,2002,sp,65,100,138,238
Peru,2003,sp,014,107,101,208
Peru,2003,sp,1524,659,758,1417
Peru,2003,sp,2534,380,506,886
Peru,2003,sp,3544,228,355,583
Peru,2003,sp,4554,138,206,344
Peru,2003,sp,5564,106,139,245
Peru,2003,sp,65,98,165,263
Peru,2004,sp,014,410,385,795
Peru,2004,sp,1524,3258,3860,7118
Peru,2004,sp,2534,1935,2085,4020
Peru,2004,sp,3544,1094,1357,2451
Peru,2004,sp,4554,678,894,1572
Peru,2004,sp,5564,440,747,1187
Peru,2004,sp,65,471,675,1146
Peru,2005,sp,014,375,371,746
Peru,2005,sp,1524,2674,3802,6476
Peru,2005,sp,2534,2111,2670,4781
Peru,2005,sp,3544,1046,1513,2559
Peru,2005,sp,4554,699,1075,1774
Peru,2005,sp,5564,333,641,974
Peru,2005,sp,65,472,708,1180
Peru,2006,sp,014,435,400,835
Peru,2006,sp,1524,2713,4071,6784
Peru,2006,sp,2534,1852,2470,4322
Peru,2006,sp,3544,1082,1494,2576
Peru,2006,sp,4554,762,1106,1868
Peru,2006,sp,5564,557,884,1441
Peru,2006,sp,65,556,869,1425
Peru,2007,sp,014,335,395,730
Peru,2007,sp,1524,2684,3436,6120
Peru,2007,sp,2534,1603,2239,3842
Peru,2007,sp,3544,1127,1585,2712
Peru,2007,sp,4554,813,1152,1965
Peru,2007,sp,5564,402,654,1056
Peru,2007,sp,65,669,702,1371
Peru,2008,ep,014,0,0,0
Peru,2008,ep,1524,0,0,0
Peru,2008,ep,2534,0,0,0
Peru,2008,ep,3544,0,0,0
Peru,2008,ep,4554,0,0,0
Peru,2008,ep,5564,0,0,0
Peru,2008,ep,65,0,0,0
Peru,2008,sn,014,0,0,0
Peru,2008,sn,1524,0,0,0
Peru,2008,sn,2534,0,0,0
Peru,2008,sn,3544,0,0,0
Peru,2008,sn,4554,0,0,0
Peru,2008,sn,5564,0,0,0
Peru,2008,sn,65,0,0,0
Peru,2008,sp,014,52,84,136
Peru,2008,sp,1524,2644,3406,6050
Peru,2008,sp,2534,1599,2233,3832
Peru,2008,sp,3544,1112,1564,2676
Peru,2008,sp,4554,791,1121,1912
Peru,2008,sp,5564,373,608,981
Peru,2008,sp,65,899,921,1820
Peru,2013,rel,014,854,960,1814
Peru,2013,rel,1524,2945,5129,8074
Peru,2013,rel,2534,2219,3521,5740
Peru,2013,rel,3544,1387,2319,3706
Peru,2013,rel,4554,1372,1655,3027
Peru,2013,rel,5564,860,1443,2303
Peru,2013,rel,65,1102,1738,2840
Philippines,1995,sp,014,1,2,3
Philippines,1995,sp,1524,20,43,63
Philippines,1995,sp,2534,32,56,88
Philippines,1995,sp,3544,26,61,87
Philippines,1995,sp,4554,20,46,66
Philippines,1995,sp,5564,19,47,66
Philippines,1995,sp,65,11,26,37
Philippines,1996,sp,014,1,1,2
Philippines,1996,sp,1524,11,26,37
Philippines,1996,sp,2534,20,47,67
Philippines,1996,sp,3544,19,58,77
Philippines,1996,sp,4554,15,50,65
Philippines,1996,sp,5564,5,28,33
Philippines,1996,sp,65,9,28,37
Philippines,1997,sp,014,6,5,11
Philippines,1997,sp,1524,80,136,216
Philippines,1997,sp,2534,111,273,384
Philippines,1997,sp,3544,131,303,434
Philippines,1997,sp,4554,110,262,372
Philippines,1997,sp,5564,98,238,336
Philippines,1997,sp,65,70,129,199
Philippines,1998,sp,014,4,2,6
Philippines,1998,sp,1524,76,157,233
Philippines,1998,sp,2534,109,292,401
Philippines,1998,sp,3544,119,356,475
Philippines,1998,sp,4554,106,256,362
Philippines,1998,sp,5564,69,206,275
Philippines,1998,sp,65,56,81,137
Philippines,2003,sp,014,300,356,656
Philippines,2003,sp,1524,3218,6360,9578
Philippines,2003,sp,2534,4551,9302,13853
Philippines,2003,sp,3544,4761,11458,16219
Philippines,2003,sp,4554,4000,10713,14713
Philippines,2003,sp,5564,2858,6445,9303
Philippines,2003,sp,65,2018,3648,5666
Philippines,2004,sp,014,291,312,603
Philippines,2004,sp,1524,3507,6792,10299
Philippines,2004,sp,2534,5090,10328,15418
Philippines,2004,sp,3544,5008,12229,17237
Philippines,2004,sp,4554,4327,11413,15740
Philippines,2004,sp,5564,3210,7526,10736
Philippines,2004,sp,65,2183,4289,6472
Philippines,2005,sp,014,374,482,856
Philippines,2005,sp,1524,3710,7358,11068
Philippines,2005,sp,2534,5268,11275,16543
Philippines,2005,sp,3544,5565,13253,18818
Philippines,2005,sp,4554,4603,12531,17134
Philippines,2005,sp,5564,3274,7646,10920
Philippines,2005,sp,65,2029,4279,6308
Philippines,2006,sp,014,379,419,798
Philippines,2006,sp,1524,4337,7878,12215
Philippines,2006,sp,2534,5746,11697,17443
Philippines,2006,sp,3544,5630,13478,19108
Philippines,2006,sp,4554,5007,12733,17740
Philippines,2006,sp,5564,3485,8074,11559
Philippines,2006,sp,65,2237,4640,6877
Philippines,2007,sp,014,380,466,846
Philippines,2007,sp,1524,4389,8524,12913
Philippines,2007,sp,2534,5594,11781,17375
Philippines,2007,sp,3544,5291,13810,19101
Philippines,2007,sp,4554,4612,12846,17458
Philippines,2007,sp,5564,3313,8481,11794
Philippines,2007,sp,65,2217,4862,7079
Philippines,2008,sp,014,341,369,710
Philippines,2008,sp,1524,4529,8735,13264
Philippines,2008,sp,2534,5452,11741,17193
Philippines,2008,sp,3544,5123,13529,18652
Philippines,2008,sp,4554,4527,12808,17335
Philippines,2008,sp,5564,3086,8249,11335
Philippines,2008,sp,65,2188,4348,6536
Philippines,2009,sp,014,412,487,899
Philippines,2009,sp,1524,4895,9348,14243
Philippines,2009,sp,2534,5724,12430,18154
Philippines,2009,sp,3544,5516,13712,19228
Philippines,2009,sp,4554,4628,13111,17739
Philippines,2009,sp,5564,3203,8585,11788
Philippines,2009,sp,65,2138,4617,6755
Philippines,2010,sp,014,454,511,965
Philippines,2010,sp,1524,4825,9320,14145
Philippines,2010,sp,2534,5489,12224,17713
Philippines,2010,sp,3544,5301,13716,19017
Philippines,2010,sp,4554,4643,13651,18294
Philippines,2010,sp,5564,3329,8923,12252
Philippines,2010,sp,65,2070,4742,6812
Philippines,2011,sp,014,448,573,1021
Philippines,2011,sp,1524,5155,9725,14880
Philippines,2011,sp,2534,5848,12804,18652
Philippines,2011,sp,3544,5521,14474,19995
Philippines,2011,sp,4554,4880,14002,18882
Philippines,2011,sp,5564,3501,9568,13069
Philippines,2011,sp,65,2236,4845,7081
Philippines,2012,sp,014,466,583,1049
Philippines,2012,sp,1524,5104,9754,14858
Philippines,2012,sp,2534,5954,12576,18530
Philippines,2012,sp,3544,5584,14140,19724
Philippines,2012,sp,4554,5068,13996,19064
Philippines,2012,sp,5564,3605,9676,13281
Philippines,2012,sp,65,2380,5097,7477
Philippines,2013,rel,014,858,1207,2065
Philippines,2013,rel,1524,5466,10305,15771
Philippines,2013,rel,2534,5798,12591,18389
Philippines,2013,rel,3544,5555,14203,19758
Philippines,2013,rel,4554,5127,14282,19409
Philippines,2013,rel,5564,3835,9871,13706
Philippines,2013,rel,65,2562,5561,8123
Poland,1995,sp,014,4,3,7
Poland,1995,sp,1524,129,122,251
Poland,1995,sp,2534,163,295,458
Poland,1995,sp,3544,225,795,1020
Poland,1995,sp,4554,111,565,676
Poland,1995,sp,5564,107,369,476
Poland,1995,sp,65,414,377,791
Poland,1996,sp,014,9,10,19
Poland,1996,sp,1524,180,248,428
Poland,1996,sp,2534,324,545,869
Poland,1996,sp,3544,415,1365,1780
Poland,1996,sp,4554,202,1128,1330
Poland,1996,sp,5564,159,687,846
Poland,1996,sp,65,823,724,1547
Poland,1997,sp,014,7,3,10
Poland,1997,sp,1524,91,104,195
Poland,1997,sp,2534,155,278,433
Poland,1997,sp,3544,205,781,986
Poland,1997,sp,4554,96,594,690
Poland,1997,sp,5564,94,374,468
Poland,1997,sp,65,345,359,704
Poland,1998,sp,014,5,4,9
Poland,1998,sp,1524,102,99,201
Poland,1998,sp,2534,161,266,427
Poland,1998,sp,3544,219,752,971
Poland,1998,sp,4554,127,647,774
Poland,1998,sp,5564,81,311,392
Poland,1998,sp,65,361,367,728
Poland,1999,sp,014,10,0,10
Poland,1999,sp,1524,95,84,179
Poland,1999,sp,2534,113,219,332
Poland,1999,sp,3544,178,681,859
Poland,1999,sp,4554,129,654,783
Poland,1999,sp,5564,81,305,386
Poland,1999,sp,65,322,306,628
Poland,2000,sp,014,1,1,2
Poland,2000,sp,1524,99,99,198
Poland,2000,sp,2534,158,303,461
Poland,2000,sp,3544,211,812,1023
Poland,2000,sp,4554,170,782,952
Poland,2000,sp,5564,82,361,443
Poland,2000,sp,65,421,434,855
Poland,2001,sp,014,4,5,9
Poland,2001,sp,1524,99,78,177
Poland,2001,sp,2534,148,242,390
Poland,2001,sp,3544,170,603,773
Poland,2001,sp,4554,124,662,786
Poland,2001,sp,5564,63,275,338
Poland,2001,sp,65,360,322,682
Poland,2002,sp,014,7,4,11
Poland,2002,sp,1524,90,100,190
Poland,2002,sp,2534,135,206,341
Poland,2002,sp,3544,157,515,672
Poland,2002,sp,4554,148,687,835
Poland,2002,sp,5564,70,264,334
Poland,2002,sp,65,368,309,677
Poland,2003,sp,014,3,2,5
Poland,2003,sp,1524,91,93,184
Poland,2003,sp,2534,108,234,342
Poland,2003,sp,3544,152,436,588
Poland,2003,sp,4554,132,653,785
Poland,2003,sp,5564,65,305,370
Poland,2003,sp,65,358,349,707
Poland,2004,sp,014,2,1,3
Poland,2004,sp,1524,92,85,177
Poland,2004,sp,2534,136,225,361
Poland,2004,sp,3544,126,425,551
Poland,2004,sp,4554,118,664,782
Poland,2004,sp,5564,79,243,322
Poland,2004,sp,65,285,292,577
Poland,2005,sp,014,3,3,6
Poland,2005,sp,1524,95,109,204
Poland,2005,sp,2534,142,199,341
Poland,2005,sp,3544,112,389,501
Poland,2005,sp,4554,151,639,790
Poland,2005,sp,5564,63,292,355
Poland,2005,sp,65,316,310,626
Poland,2006,ep,014,20,23,43
Poland,2006,ep,1524,22,27,49
Poland,2006,ep,2534,32,36,68
Poland,2006,ep,3544,44,42,86
Poland,2006,ep,4554,43,74,117
Poland,2006,ep,5564,52,58,110
Poland,2006,ep,65,124,93,217
Poland,2006,sn,014,10,14,24
Poland,2006,sn,1524,115,122,237
Poland,2006,sn,2534,200,210,410
Poland,2006,sn,3544,197,387,584
Poland,2006,sn,4554,283,710,993
Poland,2006,sn,5564,185,514,699
Poland,2006,sn,65,500,655,1155
Poland,2006,sp,014,1,1,2
Poland,2006,sp,1524,83,92,175
Poland,2006,sp,2534,142,215,357
Poland,2006,sp,3544,112,390,502
Poland,2006,sp,4554,118,649,767
Poland,2006,sp,5564,72,357,429
Poland,2006,sp,65,318,285,603
Poland,2007,ep,014,17,21,38
Poland,2007,ep,1524,10,24,34
Poland,2007,ep,2534,25,27,52
Poland,2007,ep,3544,35,50,85
Poland,2007,ep,4554,39,72,111
Poland,2007,ep,5564,53,48,101
Poland,2007,ep,65,97,74,171
Poland,2007,sn,014,14,13,27
Poland,2007,sn,1524,122,127,249
Poland,2007,sn,2534,211,238,449
Poland,2007,sn,3544,219,344,563
Poland,2007,sn,4554,250,759,1009
Poland,2007,sn,5564,191,548,739
Poland,2007,sn,65,479,635,1114
Poland,2007,sp,014,4,2,6
Poland,2007,sp,1524,65,85,150
Poland,2007,sp,2534,149,213,362
Poland,2007,sp,3544,120,395,515
Poland,2007,sp,4554,132,677,809
Poland,2007,sp,5564,79,344,423
Poland,2007,sp,65,277,285,562
Poland,2008,ep,014,21,14,35
Poland,2008,ep,1524,20,19,39
Poland,2008,ep,2534,31,40,71
Poland,2008,ep,3544,25,29,54
Poland,2008,ep,4554,40,63,103
Poland,2008,ep,5564,46,59,105
Poland,2008,ep,65,83,86,169
Poland,2008,sn,014,13,19,32
Poland,2008,sn,1524,78,104,182
Poland,2008,sn,2534,168,240,408
Poland,2008,sn,3544,155,331,486
Poland,2008,sn,4554,235,620,855
Poland,2008,sn,5564,228,575,803
Poland,2008,sn,65,465,604,1069
Poland,2008,sp,014,3,6,9
Poland,2008,sp,1524,65,66,131
Poland,2008,sp,2534,106,175,281
Poland,2008,sp,3544,112,397,509
Poland,2008,sp,4554,132,653,785
Poland,2008,sp,5564,77,355,432
Poland,2008,sp,65,264,239,503
Poland,2009,ep,014,38,25,63
Poland,2009,ep,1524,11,21,32
Poland,2009,ep,2534,22,32,54
Poland,2009,ep,3544,23,50,73
Poland,2009,ep,4554,37,54,91
Poland,2009,ep,5564,46,57,103
Poland,2009,ep,65,83,64,147
Poland,2009,sn,014,13,16,29
Poland,2009,sn,1524,102,103,205
Poland,2009,sn,2534,181,195,376
Poland,2009,sn,3544,181,348,529
Poland,2009,sn,4554,261,682,943
Poland,2009,sn,5564,228,585,813
Poland,2009,sn,65,484,668,1152
Poland,2009,sp,014,5,2,7
Poland,2009,sp,1524,60,84,144
Poland,2009,sp,2534,129,207,336
Poland,2009,sp,3544,86,340,426
Poland,2009,sp,4554,136,594,730
Poland,2009,sp,5564,76,410,486
Poland,2009,sp,65,273,256,529
Poland,2010,ep,014,22,17,39
Poland,2010,ep,1524,15,11,26
Poland,2010,ep,2534,16,29,45
Poland,2010,ep,3544,22,33,55
Poland,2010,ep,4554,36,59,95
Poland,2010,ep,5564,40,65,105
Poland,2010,ep,65,63,73,136
Poland,2010,sn,014,9,8,17
Poland,2010,sn,1524,104,81,185
Poland,2010,sn,2534,165,212,377
Poland,2010,sn,3544,171,312,483
Poland,2010,sn,4554,163,571,734
Poland,2010,sn,5564,222,608,830
Poland,2010,sn,65,425,574,999
Poland,2010,sp,014,2,3,5
Poland,2010,sp,1524,59,70,129
Poland,2010,sp,2534,118,205,323
Poland,2010,sp,3544,82,310,392
Poland,2010,sp,4554,104,574,678
Poland,2010,sp,5564,82,393,475
Poland,2010,sp,65,245,237,482
Poland,2011,ep,014,22,29,51
Poland,2011,ep,1524,16,20,36
Poland,2011,ep,2534,24,25,49
Poland,2011,ep,3544,27,32,59
Poland,2011,ep,4554,21,57,78
Poland,2011,ep,5564,46,73,119
Poland,2011,ep,65,108,84,192
Poland,2011,sn,014,27,27,54
Poland,2011,sn,1524,99,111,210
Poland,2011,sn,2534,208,230,438
Poland,2011,sn,3544,167,324,491
Poland,2011,sn,4554,245,653,898
Poland,2011,sn,5564,288,728,1016
Poland,2011,sn,65,506,731,1237
Poland,2011,sp,014,1,5,6
Poland,2011,sp,1524,67,69,136
Poland,2011,sp,2534,96,187,283
Poland,2011,sp,3544,90,314,404
Poland,2011,sp,4554,130,560,690
Poland,2011,sp,5564,99,439,538
Poland,2011,sp,65,255,275,530
Poland,2012,ep,014,21,22,43
Poland,2012,ep,1524,17,20,37
Poland,2012,ep,2534,12,23,35
Poland,2012,ep,3544,28,27,55
Poland,2012,ep,4554,25,36,61
Poland,2012,ep,5564,42,64,106
Poland,2012,ep,65,93,73,166
Poland,2012,sn,014,29,20,49
Poland,2012,sn,1524,102,121,223
Poland,2012,sn,2534,128,200,328
Poland,2012,sn,3544,140,301,441
Poland,2012,sn,4554,211,554,765
Poland,2012,sn,5564,233,632,865
Poland,2012,sn,65,472,586,1058
Poland,2012,sp,014,1,1,2
Poland,2012,sp,1524,54,82,136
Poland,2012,sp,2534,96,183,279
Poland,2012,sp,3544,106,306,412
Poland,2012,sp,4554,102,471,573
Poland,2012,sp,5564,100,438,538
Poland,2012,sp,65,226,267,493
Poland,2013,rel,014,65,51,116
Poland,2013,rel,1524,145,182,327
Poland,2013,rel,2534,246,441,687
Poland,2013,rel,3544,284,669,953
Poland,2013,rel,4554,333,1119,1452
Poland,2013,rel,5564,372,1297,1669
Poland,2013,rel,65,778,1061,1839
Portugal,1995,sp,014,7,11,18
Portugal,1995,sp,1524,139,215,354
Portugal,1995,sp,2534,172,363,535
Portugal,1995,sp,3544,87,328,415
Portugal,1995,sp,4554,33,200,233
Portugal,1995,sp,5564,42,173,215
Portugal,1995,sp,65,85,164,249
Portugal,1996,sp,014,6,12,18
Portugal,1996,sp,1524,114,176,290
Portugal,1996,sp,2534,177,359,536
Portugal,1996,sp,3544,76,331,407
Portugal,1996,sp,4554,31,192,223
Portugal,1996,sp,5564,37,158,195
Portugal,1996,sp,65,66,203,269
Portugal,1997,sp,014,4,8,12
Portugal,1997,sp,1524,105,135,240
Portugal,1997,sp,2534,141,313,454
Portugal,1997,sp,3544,77,303,380
Portugal,1997,sp,4554,27,217,244
Portugal,1997,sp,5564,23,130,153
Portugal,1997,sp,65,61,84,145
Portugal,1998,sp,014,5,8,13
Portugal,1998,sp,1524,132,154,286
Portugal,1998,sp,2534,160,367,527
Portugal,1998,sp,3544,123,362,485
Portugal,1998,sp,4554,44,232,276
Portugal,1998,sp,5564,33,141,174
Portugal,1998,sp,65,82,173,255
Portugal,1999,sp,014,9,13,22
Portugal,1999,sp,1524,98,113,211
Portugal,1999,sp,2534,134,288,422
Portugal,1999,sp,3544,86,378,464
Portugal,1999,sp,4554,30,232,262
Portugal,1999,sp,5564,28,146,174
Portugal,1999,sp,65,57,189,246
Portugal,2000,sp,014,5,8,13
Portugal,2000,sp,1524,114,147,261
Portugal,2000,sp,2534,154,375,529
Portugal,2000,sp,3544,87,349,436
Portugal,2000,sp,4554,41,208,249
Portugal,2000,sp,5564,25,140,165
Portugal,2000,sp,65,64,140,204
Portugal,2001,sp,014,13,9,22
Portugal,2001,sp,1524,110,156,266
Portugal,2001,sp,2534,160,329,489
Portugal,2001,sp,3544,83,356,439
Portugal,2001,sp,4554,36,218,254
Portugal,2001,sp,5564,30,109,139
Portugal,2001,sp,65,63,140,203
Portugal,2002,sp,014,5,12,17
Portugal,2002,sp,1524,99,156,255
Portugal,2002,sp,2534,141,342,483
Portugal,2002,sp,3544,87,411,498
Portugal,2002,sp,4554,33,272,305
Portugal,2002,sp,5564,29,129,158
Portugal,2002,sp,65,73,171,244
Portugal,2003,sp,014,7,11,18
Portugal,2003,sp,1524,99,134,233
Portugal,2003,sp,2534,163,297,460
Portugal,2003,sp,3544,82,333,415
Portugal,2003,sp,4554,39,227,266
Portugal,2003,sp,5564,27,99,126
Portugal,2003,sp,65,47,148,195
Portugal,2004,sp,014,3,4,7
Portugal,2004,sp,1524,89,97,186
Portugal,2004,sp,2534,122,258,380
Portugal,2004,sp,3544,65,336,401
Portugal,2004,sp,4554,22,216,238
Portugal,2004,sp,5564,16,98,114
Portugal,2004,sp,65,50,115,165
Portugal,2005,sp,014,7,5,12
Portugal,2005,sp,1524,67,85,152
Portugal,2005,sp,2534,109,227,336
Portugal,2005,sp,3544,66,284,350
Portugal,2005,sp,4554,29,181,210
Portugal,2005,sp,5564,11,90,101
Portugal,2005,sp,65,42,93,135
Portugal,2006,ep,014,23,17,40
Portugal,2006,ep,1524,25,32,57
Portugal,2006,ep,2534,61,98,159
Portugal,2006,ep,3544,48,116,164
Portugal,2006,ep,4554,40,69,109
Portugal,2006,ep,5564,43,43,86
Portugal,2006,ep,65,92,105,197
Portugal,2006,sn,014,15,28,43
Portugal,2006,sn,1524,36,46,82
Portugal,2006,sn,2534,87,115,202
Portugal,2006,sn,3544,67,134,201
Portugal,2006,sn,4554,34,100,134
Portugal,2006,sn,5564,32,57,89
Portugal,2006,sn,65,74,129,203
Portugal,2006,sp,014,4,7,11
Portugal,2006,sp,1524,56,80,136
Portugal,2006,sp,2534,107,211,318
Portugal,2006,sp,3544,85,259,344
Portugal,2006,sp,4554,33,190,223
Portugal,2006,sp,5564,22,94,116
Portugal,2006,sp,65,41,108,149
Portugal,2007,ep,014,12,14,26
Portugal,2007,ep,1524,19,31,50
Portugal,2007,ep,2534,52,88,140
Portugal,2007,ep,3544,65,104,169
Portugal,2007,ep,4554,41,47,88
Portugal,2007,ep,5564,41,41,82
Portugal,2007,ep,65,85,95,180
Portugal,2007,sn,014,17,20,37
Portugal,2007,sn,1524,44,51,95
Portugal,2007,sn,2534,72,113,185
Portugal,2007,sn,3544,67,148,215
Portugal,2007,sn,4554,32,104,136
Portugal,2007,sn,5564,15,64,79
Portugal,2007,sn,65,55,106,161
Portugal,2007,sp,014,2,4,6
Portugal,2007,sp,1524,49,69,118
Portugal,2007,sp,2534,95,178,273
Portugal,2007,sp,3544,61,268,329
Portugal,2007,sp,4554,27,188,215
Portugal,2007,sp,5564,12,82,94
Portugal,2007,sp,65,26,112,138
Portugal,2008,ep,014,10,12,22
Portugal,2008,ep,1524,18,38,56
Portugal,2008,ep,2534,40,61,101
Portugal,2008,ep,3544,39,75,114
Portugal,2008,ep,4554,35,52,87
Portugal,2008,ep,5564,33,45,78
Portugal,2008,ep,65,80,93,173
Portugal,2008,sn,014,18,13,31
Portugal,2008,sn,1524,47,41,88
Portugal,2008,sn,2534,88,89,177
Portugal,2008,sn,3544,56,143,199
Portugal,2008,sn,4554,40,112,152
Portugal,2008,sn,5564,24,76,100
Portugal,2008,sn,65,80,126,206
Portugal,2008,sp,014,3,2,5
Portugal,2008,sp,1524,54,51,105
Portugal,2008,sp,2534,86,155,241
Portugal,2008,sp,3544,55,212,267
Portugal,2008,sp,4554,38,179,217
Portugal,2008,sp,5564,15,80,95
Portugal,2008,sp,65,39,84,123
Portugal,2009,ep,014,14,14,28
Portugal,2009,ep,1524,31,24,55
Portugal,2009,ep,2534,60,71,131
Portugal,2009,ep,3544,58,80,138
Portugal,2009,ep,4554,41,56,97
Portugal,2009,ep,5564,38,42,80
Portugal,2009,ep,65,83,103,186
Portugal,2009,sn,014,24,17,41
Portugal,2009,sn,1524,33,33,66
Portugal,2009,sn,2534,75,76,151
Portugal,2009,sn,3544,51,115,166
Portugal,2009,sn,4554,39,88,127
Portugal,2009,sn,5564,24,79,103
Portugal,2009,sn,65,58,115,173
Portugal,2009,sp,014,2,2,4
Portugal,2009,sp,1524,56,74,130
Portugal,2009,sp,2534,91,141,232
Portugal,2009,sp,3544,55,204,259
Portugal,2009,sp,4554,26,184,210
Portugal,2009,sp,5564,15,81,96
Portugal,2009,sp,65,39,89,128
Portugal,2010,ep,014,14,15,29
Portugal,2010,ep,1524,19,36,55
Portugal,2010,ep,2534,44,68,112
Portugal,2010,ep,3544,47,68,115
Portugal,2010,ep,4554,51,60,111
Portugal,2010,ep,5564,32,59,91
Portugal,2010,ep,65,100,94,194
Portugal,2010,sn,014,11,11,22
Portugal,2010,sn,1524,42,28,70
Portugal,2010,sn,2534,52,77,129
Portugal,2010,sn,3544,46,116,162
Portugal,2010,sn,4554,41,96,137
Portugal,2010,sn,5564,25,70,95
Portugal,2010,sn,65,53,124,177
Portugal,2010,sp,014,3,4,7
Portugal,2010,sp,1524,55,53,108
Portugal,2010,sp,2534,64,120,184
Portugal,2010,sp,3544,57,221,278
Portugal,2010,sp,4554,38,172,210
Portugal,2010,sp,5564,12,81,93
Portugal,2010,sp,65,31,81,112
Portugal,2011,ep,014,3,13,16
Portugal,2011,ep,1524,28,27,55
Portugal,2011,ep,2534,29,50,79
Portugal,2011,ep,3544,46,68,114
Portugal,2011,ep,4554,39,77,116
Portugal,2011,ep,5564,51,48,99
Portugal,2011,ep,65,87,84,171
Portugal,2011,sn,014,17,10,27
Portugal,2011,sn,1524,27,52,79
Portugal,2011,sn,2534,53,55,108
Portugal,2011,sn,3544,52,114,166
Portugal,2011,sn,4554,30,125,155
Portugal,2011,sn,5564,24,89,113
Portugal,2011,sn,65,60,109,169
Portugal,2011,sp,014,4,2,6
Portugal,2011,sp,1524,43,60,103
Portugal,2011,sp,2534,59,91,150
Portugal,2011,sp,3544,59,187,246
Portugal,2011,sp,4554,31,188,219
Portugal,2011,sp,5564,12,82,94
Portugal,2011,sp,65,28,78,106
Portugal,2012,ep,014,15,10,25
Portugal,2012,ep,1524,29,26,55
Portugal,2012,ep,2534,41,44,85
Portugal,2012,ep,3544,48,61,109
Portugal,2012,ep,4554,42,67,109
Portugal,2012,ep,5564,36,40,76
Portugal,2012,ep,65,98,112,210
Portugal,2012,sn,014,15,23,38
Portugal,2012,sn,1524,39,39,78
Portugal,2012,sn,2534,67,62,129
Portugal,2012,sn,3544,42,101,143
Portugal,2012,sn,4554,49,114,163
Portugal,2012,sn,5564,16,81,97
Portugal,2012,sn,65,45,111,156
Portugal,2012,sp,014,6,1,7
Portugal,2012,sp,1524,52,56,108
Portugal,2012,sp,2534,62,103,165
Portugal,2012,sp,3544,66,187,253
Portugal,2012,sp,4554,28,153,181
Portugal,2012,sp,5564,19,79,98
Portugal,2012,sp,65,32,75,107
Portugal,2013,rel,014,26,22,48
Portugal,2013,rel,1524,84,128,212
Portugal,2013,rel,2534,131,186,317
Portugal,2013,rel,3544,178,310,488
Portugal,2013,rel,4554,122,346,468
Portugal,2013,rel,5564,98,211,309
Portugal,2013,rel,65,203,290,493
Puerto Rico,1995,sp,014,1,4,5
Puerto Rico,1995,sp,1524,2,3,5
Puerto Rico,1995,sp,2534,6,12,18
Puerto Rico,1995,sp,3544,5,20,25
Puerto Rico,1995,sp,4554,7,15,22
Puerto Rico,1995,sp,5564,4,9,13
Puerto Rico,1995,sp,65,9,19,28
Puerto Rico,1996,sp,014,0,2,2
Puerto Rico,1996,sp,1524,5,1,6
Puerto Rico,1996,sp,2534,5,20,25
Puerto Rico,1996,sp,3544,5,18,23
Puerto Rico,1996,sp,4554,6,15,21
Puerto Rico,1996,sp,5564,2,10,12
Puerto Rico,1996,sp,65,4,16,20
Puerto Rico,1997,sp,014,0,1,1
Puerto Rico,1997,sp,1524,3,4,7
Puerto Rico,1997,sp,2534,6,13,19
Puerto Rico,1997,sp,3544,3,18,21
Puerto Rico,1997,sp,4554,5,19,24
Puerto Rico,1997,sp,5564,14,13,27
Puerto Rico,1997,sp,65,8,18,26
Puerto Rico,1998,sp,014,1,1,2
Puerto Rico,1998,sp,1524,0,9,9
Puerto Rico,1998,sp,2534,5,11,16
Puerto Rico,1998,sp,3544,6,16,22
Puerto Rico,1998,sp,4554,4,12,16
Puerto Rico,1998,sp,5564,9,14,23
Puerto Rico,1998,sp,65,6,12,18
Puerto Rico,1999,sp,014,1,0,1
Puerto Rico,1999,sp,1524,4,5,9
Puerto Rico,1999,sp,2534,5,9,14
Puerto Rico,1999,sp,3544,3,22,25
Puerto Rico,1999,sp,4554,6,9,15
Puerto Rico,1999,sp,5564,5,11,16
Puerto Rico,1999,sp,65,6,20,26
Puerto Rico,2000,sp,014,1,0,1
Puerto Rico,2000,sp,1524,4,1,5
Puerto Rico,2000,sp,2534,5,4,9
Puerto Rico,2000,sp,3544,3,19,22
Puerto Rico,2000,sp,4554,7,9,16
Puerto Rico,2000,sp,5564,1,10,11
Puerto Rico,2000,sp,65,3,14,17
Puerto Rico,2001,sp,014,0,0,0
Puerto Rico,2001,sp,1524,3,5,8
Puerto Rico,2001,sp,2534,1,4,5
Puerto Rico,2001,sp,3544,4,11,15
Puerto Rico,2001,sp,4554,9,12,21
Puerto Rico,2001,sp,5564,2,6,8
Puerto Rico,2001,sp,65,6,11,17
Puerto Rico,2002,sp,014,0,2,2
Puerto Rico,2002,sp,1524,1,4,5
Puerto Rico,2002,sp,2534,5,7,12
Puerto Rico,2002,sp,3544,9,12,21
Puerto Rico,2002,sp,4554,2,10,12
Puerto Rico,2002,sp,5564,5,9,14
Puerto Rico,2002,sp,65,5,7,12
Puerto Rico,2003,sp,014,0,0,0
Puerto Rico,2003,sp,1524,3,3,6
Puerto Rico,2003,sp,2534,2,5,7
Puerto Rico,2003,sp,3544,3,8,11
Puerto Rico,2003,sp,4554,1,10,11
Puerto Rico,2003,sp,5564,3,12,15
Puerto Rico,2003,sp,65,3,9,12
Puerto Rico,2004,sp,014,0,0,0
Puerto Rico,2004,sp,1524,2,2,4
Puerto Rico,2004,sp,2534,3,7,10
Puerto Rico,2004,sp,3544,4,8,12
Puerto Rico,2004,sp,4554,6,7,13
Puerto Rico,2004,sp,5564,2,12,14
Puerto Rico,2004,sp,65,5,7,12
Puerto Rico,2005,sp,014,0,0,0
Puerto Rico,2005,sp,1524,3,4,7
Puerto Rico,2005,sp,2534,2,4,6
Puerto Rico,2005,sp,3544,5,7,12
Puerto Rico,2005,sp,4554,4,9,13
Puerto Rico,2005,sp,5564,1,7,8
Puerto Rico,2005,sp,65,7,7,14
Puerto Rico,2006,ep,014,1,0,1
Puerto Rico,2006,ep,1524,0,0,0
Puerto Rico,2006,ep,2534,0,0,0
Puerto Rico,2006,ep,3544,0,0,0
Puerto Rico,2006,ep,4554,0,0,0
Puerto Rico,2006,ep,5564,0,3,3
Puerto Rico,2006,ep,65,1,2,3
Puerto Rico,2006,sn,014,5,0,5
Puerto Rico,2006,sn,1524,0,0,0
Puerto Rico,2006,sn,2534,1,2,3
Puerto Rico,2006,sn,3544,1,5,6
Puerto Rico,2006,sn,4554,1,1,2
Puerto Rico,2006,sn,5564,2,7,9
Puerto Rico,2006,sn,65,2,9,11
Puerto Rico,2006,sp,014,1,1,2
Puerto Rico,2006,sp,1524,4,4,8
Puerto Rico,2006,sp,2534,3,7,10
Puerto Rico,2006,sp,3544,6,6,12
Puerto Rico,2006,sp,4554,3,13,16
Puerto Rico,2006,sp,5564,2,9,11
Puerto Rico,2006,sp,65,3,7,10
Puerto Rico,2007,ep,014,0,0,0
Puerto Rico,2007,ep,1524,1,0,1
Puerto Rico,2007,ep,2534,0,0,0
Puerto Rico,2007,ep,3544,1,3,4
Puerto Rico,2007,ep,4554,1,1,2
Puerto Rico,2007,ep,5564,0,2,2
Puerto Rico,2007,ep,65,4,0,4
Puerto Rico,2007,sn,014,2,2,4
Puerto Rico,2007,sn,1524,0,0,0
Puerto Rico,2007,sn,2534,1,3,4
Puerto Rico,2007,sn,3544,0,0,0
Puerto Rico,2007,sn,4554,1,4,5
Puerto Rico,2007,sn,5564,2,1,3
Puerto Rico,2007,sn,65,5,8,13
Puerto Rico,2007,sp,014,0,0,0
Puerto Rico,2007,sp,1524,0,6,6
Puerto Rico,2007,sp,2534,2,2,4
Puerto Rico,2007,sp,3544,4,9,13
Puerto Rico,2007,sp,4554,7,8,15
Puerto Rico,2007,sp,5564,1,10,11
Puerto Rico,2007,sp,65,1,6,7
Puerto Rico,2008,ep,014,0,0,0
Puerto Rico,2008,ep,1524,0,0,0
Puerto Rico,2008,ep,2534,0,2,2
Puerto Rico,2008,ep,3544,0,1,1
Puerto Rico,2008,ep,4554,1,2,3
Puerto Rico,2008,ep,5564,2,0,2
Puerto Rico,2008,ep,65,4,1,5
Puerto Rico,2008,sn,014,2,0,2
Puerto Rico,2008,sn,1524,1,0,1
Puerto Rico,2008,sn,2534,2,1,3
Puerto Rico,2008,sn,3544,0,4,4
Puerto Rico,2008,sn,4554,2,4,6
Puerto Rico,2008,sn,5564,1,2,3
Puerto Rico,2008,sn,65,5,6,11
Puerto Rico,2008,sp,014,0,0,0
Puerto Rico,2008,sp,1524,1,2,3
Puerto Rico,2008,sp,2534,4,4,8
Puerto Rico,2008,sp,3544,3,3,6
Puerto Rico,2008,sp,4554,2,13,15
Puerto Rico,2008,sp,5564,3,11,14
Puerto Rico,2008,sp,65,0,6,6
Puerto Rico,2009,ep,014,0,1,1
Puerto Rico,2009,ep,1524,0,1,1
Puerto Rico,2009,ep,2534,0,1,1
Puerto Rico,2009,ep,3544,1,0,1
Puerto Rico,2009,ep,4554,0,1,1
Puerto Rico,2009,ep,5564,0,0,0
Puerto Rico,2009,ep,65,1,2,3
Puerto Rico,2009,sn,014,1,0,1
Puerto Rico,2009,sn,1524,0,0,0
Puerto Rico,2009,sn,2534,1,1,2
Puerto Rico,2009,sn,3544,2,3,5
Puerto Rico,2009,sn,4554,0,2,2
Puerto Rico,2009,sn,5564,0,6,6
Puerto Rico,2009,sn,65,2,7,9
Puerto Rico,2009,sp,014,0,0,0
Puerto Rico,2009,sp,1524,2,0,2
Puerto Rico,2009,sp,2534,3,0,3
Puerto Rico,2009,sp,3544,1,7,8
Puerto Rico,2009,sp,4554,2,6,8
Puerto Rico,2009,sp,5564,1,3,4
Puerto Rico,2009,sp,65,3,2,5
Puerto Rico,2010,ep,014,0,0,0
Puerto Rico,2010,ep,1524,0,0,0
Puerto Rico,2010,ep,2534,1,0,1
Puerto Rico,2010,ep,3544,0,0,0
Puerto Rico,2010,ep,4554,0,2,2
Puerto Rico,2010,ep,5564,0,0,0
Puerto Rico,2010,ep,65,0,1,1
Puerto Rico,2010,sn,014,1,1,2
Puerto Rico,2010,sn,1524,1,0,1
Puerto Rico,2010,sn,2534,2,2,4
Puerto Rico,2010,sn,3544,3,2,5
Puerto Rico,2010,sn,4554,2,5,7
Puerto Rico,2010,sn,5564,1,2,3
Puerto Rico,2010,sn,65,1,12,13
Puerto Rico,2010,sp,014,0,0,0
Puerto Rico,2010,sp,1524,1,0,1
Puerto Rico,2010,sp,2534,0,3,3
Puerto Rico,2010,sp,3544,2,2,4
Puerto Rico,2010,sp,4554,6,4,10
Puerto Rico,2010,sp,5564,2,5,7
Puerto Rico,2010,sp,65,4,8,12
Puerto Rico,2011,ep,014,0,1,1
Puerto Rico,2011,ep,1524,0,0,0
Puerto Rico,2011,ep,2534,0,0,0
Puerto Rico,2011,ep,3544,1,1,2
Puerto Rico,2011,ep,4554,0,2,2
Puerto Rico,2011,ep,5564,1,1,2
Puerto Rico,2011,ep,65,0,1,1
Puerto Rico,2011,sn,014,0,0,0
Puerto Rico,2011,sn,1524,0,0,0
Puerto Rico,2011,sn,2534,3,1,4
Puerto Rico,2011,sn,3544,0,0,0
Puerto Rico,2011,sn,4554,0,1,1
Puerto Rico,2011,sn,5564,0,1,1
Puerto Rico,2011,sn,65,3,4,7
Puerto Rico,2011,sp,014,0,0,0
Puerto Rico,2011,sp,1524,1,1,2
Puerto Rico,2011,sp,2534,1,4,5
Puerto Rico,2011,sp,3544,1,3,4
Puerto Rico,2011,sp,4554,0,6,6
Puerto Rico,2011,sp,5564,3,6,9
Puerto Rico,2011,sp,65,1,2,3
Puerto Rico,2012,ep,014,0,0,0
Puerto Rico,2012,ep,1524,0,0,0
Puerto Rico,2012,ep,2534,0,1,1
Puerto Rico,2012,ep,3544,1,2,3
Puerto Rico,2012,ep,4554,0,2,2
Puerto Rico,2012,ep,5564,0,1,1
Puerto Rico,2012,ep,65,1,2,3
Puerto Rico,2012,sn,014,1,0,1
Puerto Rico,2012,sn,1524,1,0,1
Puerto Rico,2012,sn,2534,0,3,3
Puerto Rico,2012,sn,3544,0,0,0
Puerto Rico,2012,sn,4554,1,1,2
Puerto Rico,2012,sn,5564,0,1,1
Puerto Rico,2012,sn,65,2,7,9
Puerto Rico,2012,sp,014,0,0,0
Puerto Rico,2012,sp,1524,0,1,1
Puerto Rico,2012,sp,2534,3,5,8
Puerto Rico,2012,sp,3544,1,1,2
Puerto Rico,2012,sp,4554,2,6,8
Puerto Rico,2012,sp,5564,3,8,11
Puerto Rico,2012,sp,65,1,10,11
Puerto Rico,2013,rel,014,0,0,0
Puerto Rico,2013,rel,1524,2,2,4
Puerto Rico,2013,rel,2534,1,2,3
Puerto Rico,2013,rel,3544,3,5,8
Puerto Rico,2013,rel,4554,1,13,14
Puerto Rico,2013,rel,5564,3,7,10
Puerto Rico,2013,rel,65,3,8,11
Qatar,1995,sp,014,1,0,1
Qatar,1995,sp,1524,2,8,10
Qatar,1995,sp,2534,3,12,15
Qatar,1995,sp,3544,1,11,12
Qatar,1995,sp,4554,0,13,13
Qatar,1995,sp,5564,0,4,4
Qatar,1995,sp,65,1,4,5
Qatar,1996,sp,014,0,0,0
Qatar,1996,sp,1524,0,2,2
Qatar,1996,sp,2534,1,7,8
Qatar,1996,sp,3544,0,16,16
Qatar,1996,sp,4554,2,10,12
Qatar,1996,sp,5564,1,3,4
Qatar,1996,sp,65,0,1,1
Qatar,1997,sp,014,0,0,0
Qatar,1997,sp,1524,2,8,10
Qatar,1997,sp,2534,1,11,12
Qatar,1997,sp,3544,0,7,7
Qatar,1997,sp,4554,1,3,4
Qatar,1997,sp,5564,1,4,5
Qatar,1997,sp,65,1,0,1
Qatar,1998,sp,014,1,0,1
Qatar,1998,sp,1524,4,10,14
Qatar,1998,sp,2534,2,17,19
Qatar,1998,sp,3544,3,8,11
Qatar,1998,sp,4554,2,10,12
Qatar,1998,sp,5564,3,4,7
Qatar,1998,sp,65,2,2,4
Qatar,1999,sp,014,0,0,0
Qatar,1999,sp,1524,2,5,7
Qatar,1999,sp,2534,3,15,18
Qatar,1999,sp,3544,3,12,15
Qatar,1999,sp,4554,1,12,13
Qatar,1999,sp,5564,0,3,3
Qatar,1999,sp,65,0,2,2
Qatar,2000,sp,014,0,0,0
Qatar,2000,sp,1524,0,7,7
Qatar,2000,sp,2534,4,19,23
Qatar,2000,sp,3544,3,9,12
Qatar,2000,sp,4554,1,7,8
Qatar,2000,sp,5564,0,2,2
Qatar,2000,sp,65,0,1,1
Qatar,2001,sp,014,0,1,1
Qatar,2001,sp,1524,1,2,3
Qatar,2001,sp,2534,0,0,0
Qatar,2001,sp,3544,0,3,3
Qatar,2001,sp,4554,1,4,5
Qatar,2001,sp,5564,1,0,1
Qatar,2001,sp,65,1,3,4
Qatar,2002,sp,1524,6,8,14
Qatar,2002,sp,2534,13,12,25
Qatar,2002,sp,3544,1,9,10
Qatar,2002,sp,4554,3,8,11
Qatar,2002,sp,5564,NA,1,NA
Qatar,2002,sp,65,NA,3,NA
Qatar,2003,sp,014,0,1,1
Qatar,2003,sp,1524,4,10,14
Qatar,2003,sp,2534,6,27,33
Qatar,2003,sp,3544,0,17,17
Qatar,2003,sp,4554,2,16,18
Qatar,2003,sp,5564,0,5,5
Qatar,2003,sp,65,2,5,7
Qatar,2004,sp,014,0,0,0
Qatar,2004,sp,1524,6,9,15
Qatar,2004,sp,2534,5,13,18
Qatar,2004,sp,3544,4,13,17
Qatar,2004,sp,4554,2,8,10
Qatar,2004,sp,5564,2,10,12
Qatar,2004,sp,65,0,1,1
Qatar,2005,sp,1524,5,19,24
Qatar,2005,sp,2534,10,15,25
Qatar,2005,sp,3544,2,17,19
Qatar,2005,sp,4554,1,19,20
Qatar,2005,sp,5564,2,5,7
Qatar,2005,sp,65,0,1,1
Qatar,2006,sn,014,5,6,11
Qatar,2006,sn,1524,14,32,46
Qatar,2006,sn,2534,22,69,91
Qatar,2006,sn,3544,13,33,46
Qatar,2006,sn,4554,3,14,17
Qatar,2006,sn,5564,3,5,8
Qatar,2006,sn,65,2,3,5
Qatar,2006,sp,014,0,0,0
Qatar,2006,sp,1524,6,22,28
Qatar,2006,sp,2534,11,21,32
Qatar,2006,sp,3544,7,17,24
Qatar,2006,sp,4554,1,22,23
Qatar,2006,sp,5564,0,6,6
Qatar,2006,sp,65,1,1,2
Qatar,2007,ep,014,0,0,0
Qatar,2007,ep,1524,11,45,56
Qatar,2007,ep,2534,21,69,90
Qatar,2007,ep,3544,7,23,30
Qatar,2007,ep,4554,5,16,21
Qatar,2007,ep,5564,1,2,3
Qatar,2007,ep,65,0,3,3
Qatar,2007,sp,014,1,0,1
Qatar,2007,sp,1524,4,26,30
Qatar,2007,sp,2534,6,38,44
Qatar,2007,sp,3544,5,19,24
Qatar,2007,sp,4554,3,10,13
Qatar,2007,sp,5564,0,4,4
Qatar,2007,sp,65,0,0,0
Qatar,2008,ep,014,4,2,6
Qatar,2008,ep,1524,9,56,65
Qatar,2008,ep,2534,8,109,117
Qatar,2008,ep,3544,8,41,49
Qatar,2008,ep,4554,3,5,8
Qatar,2008,ep,5564,2,3,5
Qatar,2008,ep,65,3,1,4
Qatar,2008,sn,014,0,2,2
Qatar,2008,sn,1524,10,21,31
Qatar,2008,sn,2534,13,31,44
Qatar,2008,sn,3544,2,16,18
Qatar,2008,sn,4554,2,6,8
Qatar,2008,sn,5564,0,4,4
Qatar,2008,sn,65,2,3,5
Qatar,2008,sp,014,0,1,1
Qatar,2008,sp,1524,4,47,51
Qatar,2008,sp,2534,14,67,81
Qatar,2008,sp,3544,6,26,32
Qatar,2008,sp,4554,2,18,20
Qatar,2008,sp,5564,0,10,10
Qatar,2008,sp,65,2,2,4
Qatar,2009,ep,014,0,0,0
Qatar,2009,ep,1524,12,65,77
Qatar,2009,ep,2534,28,111,139
Qatar,2009,ep,3544,10,48,58
Qatar,2009,ep,4554,4,9,13
Qatar,2009,ep,5564,2,5,7
Qatar,2009,ep,65,1,2,3
Qatar,2009,sn,014,0,0,0
Qatar,2009,sn,1524,7,26,33
Qatar,2009,sn,2534,13,32,45
Qatar,2009,sn,3544,3,11,14
Qatar,2009,sn,4554,2,7,9
Qatar,2009,sn,5564,0,1,1
Qatar,2009,sn,65,0,0,0
Qatar,2009,sp,014,2,0,2
Qatar,2009,sp,1524,9,41,50
Qatar,2009,sp,2534,18,83,101
Qatar,2009,sp,3544,7,32,39
Qatar,2009,sp,4554,2,16,18
Qatar,2009,sp,5564,1,6,7
Qatar,2009,sp,65,1,2,3
Qatar,2010,ep,014,0,0,0
Qatar,2010,ep,1524,13,49,62
Qatar,2010,ep,2534,27,101,128
Qatar,2010,ep,3544,12,33,45
Qatar,2010,ep,4554,4,7,11
Qatar,2010,ep,5564,3,4,7
Qatar,2010,ep,65,0,3,3
Qatar,2010,sn,014,0,2,2
Qatar,2010,sn,1524,8,27,35
Qatar,2010,sn,2534,8,32,40
Qatar,2010,sn,3544,1,17,18
Qatar,2010,sn,4554,1,3,4
Qatar,2010,sn,5564,1,0,1
Qatar,2010,sn,65,0,1,1
Qatar,2010,sp,014,0,0,0
Qatar,2010,sp,1524,7,59,66
Qatar,2010,sp,2534,16,72,88
Qatar,2010,sp,3544,2,38,40
Qatar,2010,sp,4554,1,22,23
Qatar,2010,sp,5564,1,5,6
Qatar,2010,sp,65,0,0,0
Qatar,2011,ep,014,0,4,4
Qatar,2011,ep,1524,4,39,43
Qatar,2011,ep,2534,25,93,118
Qatar,2011,ep,3544,8,39,47
Qatar,2011,ep,4554,2,14,16
Qatar,2011,ep,5564,1,5,6
Qatar,2011,ep,65,0,2,2
Qatar,2011,sn,014,1,1,2
Qatar,2011,sn,1524,6,24,30
Qatar,2011,sn,2534,14,44,58
Qatar,2011,sn,3544,6,13,19
Qatar,2011,sn,4554,0,8,8
Qatar,2011,sn,5564,0,0,0
Qatar,2011,sn,65,2,2,4
Qatar,2011,sp,014,0,0,0
Qatar,2011,sp,1524,9,36,45
Qatar,2011,sp,2534,15,64,79
Qatar,2011,sp,3544,6,36,42
Qatar,2011,sp,4554,1,14,15
Qatar,2011,sp,5564,2,10,12
Qatar,2011,sp,65,1,3,4
Qatar,2012,ep,014,3,1,4
Qatar,2012,ep,1524,4,34,38
Qatar,2012,ep,2534,22,82,104
Qatar,2012,ep,3544,11,39,50
Qatar,2012,ep,4554,3,12,15
Qatar,2012,ep,5564,2,3,5
Qatar,2012,ep,65,1,0,1
Qatar,2012,sn,014,1,3,4
Qatar,2012,sn,1524,9,30,39
Qatar,2012,sn,2534,9,39,48
Qatar,2012,sn,3544,5,16,21
Qatar,2012,sn,4554,2,5,7
Qatar,2012,sn,5564,0,3,3
Qatar,2012,sn,65,0,0,0
Qatar,2012,sp,014,2,0,2
Qatar,2012,sp,1524,6,34,40
Qatar,2012,sp,2534,9,52,61
Qatar,2012,sp,3544,1,45,46
Qatar,2012,sp,4554,1,21,22
Qatar,2012,sp,5564,0,8,8
Qatar,2012,sp,65,1,0,1
Republic of Korea,1995,sp,014,46,27,73
Republic of Korea,1995,sp,1524,908,1131,2039
Republic of Korea,1995,sp,2534,863,1613,2476
Republic of Korea,1995,sp,3544,431,1425,1856
Republic of Korea,1995,sp,4554,296,1207,1503
Republic of Korea,1995,sp,5564,408,1307,1715
Republic of Korea,1995,sp,65,867,1225,2092
Republic of Korea,1996,sp,014,32,31,63
Republic of Korea,1996,sp,1524,950,1150,2100
Republic of Korea,1996,sp,2534,827,1587,2414
Republic of Korea,1996,sp,3544,460,1457,1917
Republic of Korea,1996,sp,4554,297,1118,1415
Republic of Korea,1996,sp,5564,340,1216,1556
Republic of Korea,1996,sp,65,839,1116,1955
Republic of Korea,1997,sp,014,31,24,55
Republic of Korea,1997,sp,1524,790,935,1725
Republic of Korea,1997,sp,2534,685,1276,1961
Republic of Korea,1997,sp,3544,445,1221,1666
Republic of Korea,1997,sp,4554,234,982,1216
Republic of Korea,1997,sp,5564,359,1069,1428
Republic of Korea,1997,sp,65,807,1099,1906
Republic of Korea,1998,sp,014,37,19,56
Republic of Korea,1998,sp,1524,765,977,1742
Republic of Korea,1998,sp,2534,708,1334,2042
Republic of Korea,1998,sp,3544,455,1329,1784
Republic of Korea,1998,sp,4554,238,999,1237
Republic of Korea,1998,sp,5564,393,1074,1467
Republic of Korea,1998,sp,65,912,1119,2031
Republic of Korea,1999,sp,014,40,27,67
Republic of Korea,1999,sp,1524,704,884,1588
Republic of Korea,1999,sp,2534,653,1205,1858
Republic of Korea,1999,sp,3544,402,1180,1582
Republic of Korea,1999,sp,4554,256,871,1127
Republic of Korea,1999,sp,5564,306,962,1268
Republic of Korea,1999,sp,65,933,1136,2069
Republic of Korea,2000,sp,014,25,19,44
Republic of Korea,2000,sp,1524,546,821,1367
Republic of Korea,2000,sp,2534,544,1085,1629
Republic of Korea,2000,sp,3544,393,988,1381
Republic of Korea,2000,sp,4554,220,853,1073
Republic of Korea,2000,sp,5564,295,731,1026
Republic of Korea,2000,sp,65,795,901,1696
Republic of Korea,2001,sp,014,45,23,68
Republic of Korea,2001,sp,1524,839,942,1781
Republic of Korea,2001,sp,2534,890,1415,2305
Republic of Korea,2001,sp,3544,489,1419,1908
Republic of Korea,2001,sp,4554,326,1293,1619
Republic of Korea,2001,sp,5564,390,1103,1493
Republic of Korea,2001,sp,65,1270,1361,2631
Republic of Korea,2002,sp,014,19,20,39
Republic of Korea,2002,sp,1524,759,806,1565
Republic of Korea,2002,sp,2534,854,1333,2187
Republic of Korea,2002,sp,3544,456,1374,1830
Republic of Korea,2002,sp,4554,334,1265,1599
Republic of Korea,2002,sp,5564,377,1029,1406
Republic of Korea,2002,sp,65,1329,1390,2719
Republic of Korea,2003,sp,014,32,22,54
Republic of Korea,2003,sp,1524,681,732,1413
Republic of Korea,2003,sp,2534,793,1208,2001
Republic of Korea,2003,sp,3544,501,1265,1766
Republic of Korea,2003,sp,4554,365,1207,1572
Republic of Korea,2003,sp,5564,381,992,1373
Republic of Korea,2003,sp,65,1325,1472,2797
Republic of Korea,2004,sp,014,26,18,44
Republic of Korea,2004,sp,1524,659,709,1368
Republic of Korea,2004,sp,2534,847,1276,2123
Republic of Korea,2004,sp,3544,496,1364,1860
Republic of Korea,2004,sp,4554,340,1248,1588
Republic of Korea,2004,sp,5564,360,1017,1377
Republic of Korea,2004,sp,65,1516,1595,3111
Republic of Korea,2005,sp,014,27,22,49
Republic of Korea,2005,sp,1524,590,687,1277
Republic of Korea,2005,sp,2534,842,1171,2013
Republic of Korea,2005,sp,3544,491,1326,1817
Republic of Korea,2005,sp,4554,370,1336,1706
Republic of Korea,2005,sp,5564,373,1005,1378
Republic of Korea,2005,sp,65,1729,1669,3398
Republic of Korea,2006,ep,014,51,54,105
Republic of Korea,2006,ep,1524,299,354,653
Republic of Korea,2006,ep,2534,476,503,979
Republic of Korea,2006,ep,3544,370,443,813
Republic of Korea,2006,ep,4554,363,397,760
Republic of Korea,2006,ep,5564,271,281,552
Republic of Korea,2006,ep,65,594,588,1182
Republic of Korea,2006,sn,014,114,119,233
Republic of Korea,2006,sn,1524,1459,1746,3205
Republic of Korea,2006,sn,2534,1649,2130,3779
Republic of Korea,2006,sn,3544,943,1656,2599
Republic of Korea,2006,sn,4554,806,1783,2589
Republic of Korea,2006,sn,5564,693,1460,2153
Republic of Korea,2006,sn,65,1904,2342,4246
Republic of Korea,2006,sp,014,27,19,46
Republic of Korea,2006,sp,1524,579,652,1231
Republic of Korea,2006,sp,2534,859,1109,1968
Republic of Korea,2006,sp,3544,507,1223,1730
Republic of Korea,2006,sp,4554,403,1406,1809
Republic of Korea,2006,sp,5564,371,955,1326
Republic of Korea,2006,sp,65,1705,1698,3403
Republic of Korea,2007,ep,014,47,50,97
Republic of Korea,2007,ep,1524,309,309,618
Republic of Korea,2007,ep,2534,455,456,911
Republic of Korea,2007,ep,3544,365,387,752
Republic of Korea,2007,ep,4554,363,473,836
Republic of Korea,2007,ep,5564,302,289,591
Republic of Korea,2007,ep,65,643,557,1200
Republic of Korea,2007,sn,014,108,119,227
Republic of Korea,2007,sn,1524,1429,1722,3151
Republic of Korea,2007,sn,2534,1636,1956,3592
Republic of Korea,2007,sn,3544,1002,1721,2723
Republic of Korea,2007,sn,4554,853,1833,2686
Republic of Korea,2007,sn,5564,679,1437,2116
Republic of Korea,2007,sn,65,1915,2368,4283
Republic of Korea,2007,sp,014,34,16,50
Republic of Korea,2007,sp,1524,570,589,1159
Republic of Korea,2007,sp,2534,807,953,1760
Republic of Korea,2007,sp,3544,466,1144,1610
Republic of Korea,2007,sp,4554,387,1308,1695
Republic of Korea,2007,sp,5564,347,906,1253
Republic of Korea,2007,sp,65,1716,1684,3400
Republic of Korea,2008,ep,014,44,52,96
Republic of Korea,2008,ep,1524,324,372,696
Republic of Korea,2008,ep,2534,489,524,1013
Republic of Korea,2008,ep,3544,406,495,901
Republic of Korea,2008,ep,4554,467,487,954
Republic of Korea,2008,ep,5564,317,344,661
Republic of Korea,2008,ep,65,812,680,1492
Republic of Korea,2008,sn,014,83,89,172
Republic of Korea,2008,sn,1524,1239,1472,2711
Republic of Korea,2008,sn,2534,1470,1800,3270
Republic of Korea,2008,sn,3544,940,1586,2526
Republic of Korea,2008,sn,4554,779,1711,2490
Republic of Korea,2008,sn,5564,612,1333,1945
Republic of Korea,2008,sn,65,1926,2252,4178
Republic of Korea,2008,sp,014,32,21,53
Republic of Korea,2008,sp,1524,483,492,975
Republic of Korea,2008,sp,2534,722,865,1587
Republic of Korea,2008,sp,3544,483,1093,1576
Republic of Korea,2008,sp,4554,402,1400,1802
Republic of Korea,2008,sp,5564,360,958,1318
Republic of Korea,2008,sp,65,1889,1848,3737
Republic of Korea,2009,ep,014,48,46,94
Republic of Korea,2009,ep,1524,390,415,805
Republic of Korea,2009,ep,2534,556,602,1158
Republic of Korea,2009,ep,3544,525,579,1104
Republic of Korea,2009,ep,4554,508,606,1114
Republic of Korea,2009,ep,5564,420,441,861
Republic of Korea,2009,ep,65,1014,773,1787
Republic of Korea,2009,sn,014,102,101,203
Republic of Korea,2009,sn,1524,1183,1528,2711
Republic of Korea,2009,sn,2534,1524,1693,3217
Republic of Korea,2009,sn,3544,969,1610,2579
Republic of Korea,2009,sn,4554,814,1722,2536
Republic of Korea,2009,sn,5564,634,1303,1937
Republic of Korea,2009,sn,65,2092,2359,4451
Republic of Korea,2009,sp,014,26,25,51
Republic of Korea,2009,sp,1524,506,567,1073
Republic of Korea,2009,sp,2534,685,803,1488
Republic of Korea,2009,sp,3544,525,1059,1584
Republic of Korea,2009,sp,4554,441,1417,1858
Republic of Korea,2009,sp,5564,360,992,1352
Republic of Korea,2009,sp,65,1975,1904,3879
Republic of Korea,2010,ep,014,56,62,118
Republic of Korea,2010,ep,1524,439,511,950
Republic of Korea,2010,ep,2534,685,646,1331
Republic of Korea,2010,ep,3544,644,690,1334
Republic of Korea,2010,ep,4554,780,687,1467
Republic of Korea,2010,ep,5564,584,571,1155
Republic of Korea,2010,ep,65,1352,1088,2440
Republic of Korea,2010,sn,014,104,104,208
Republic of Korea,2010,sn,1524,1125,1575,2700
Republic of Korea,2010,sn,2534,1409,1731,3140
Republic of Korea,2010,sn,3544,1005,1570,2575
Republic of Korea,2010,sn,4554,904,1904,2808
Republic of Korea,2010,sn,5564,769,1589,2358
Republic of Korea,2010,sn,65,2243,2628,4871
Republic of Korea,2010,sp,014,23,22,45
Republic of Korea,2010,sp,1524,472,537,1009
Republic of Korea,2010,sp,2534,686,705,1391
Republic of Korea,2010,sp,3544,509,1049,1558
Republic of Korea,2010,sp,4554,487,1496,1983
Republic of Korea,2010,sp,5564,368,1029,1397
Republic of Korea,2010,sp,65,2216,1997,4213
Republic of Korea,2011,ep,014,62,59,121
Republic of Korea,2011,ep,1524,416,575,991
Republic of Korea,2011,ep,2534,727,779,1506
Republic of Korea,2011,ep,3544,721,686,1407
Republic of Korea,2011,ep,4554,802,787,1589
Republic of Korea,2011,ep,5564,628,618,1246
Republic of Korea,2011,ep,65,1434,1163,2597
Republic of Korea,2011,sn,014,117,114,231
Republic of Korea,2011,sn,1524,1138,1460,2598
Republic of Korea,2011,sn,2534,1459,1614,3073
Republic of Korea,2011,sn,3544,942,1544,2486
Republic of Korea,2011,sn,4554,908,1892,2800
Republic of Korea,2011,sn,5564,743,1569,2312
Republic of Korea,2011,sn,65,2301,2585,4886
Republic of Korea,2011,sp,014,37,13,50
Republic of Korea,2011,sp,1524,446,491,937
Republic of Korea,2011,sp,2534,688,712,1400
Republic of Korea,2011,sp,3544,520,1019,1539
Republic of Korea,2011,sp,4554,432,1414,1846
Republic of Korea,2011,sp,5564,421,1145,1566
Republic of Korea,2011,sp,65,2244,2132,4376
Republic of Korea,2012,ep,014,37,60,97
Republic of Korea,2012,ep,1524,369,450,819
Republic of Korea,2012,ep,2534,574,643,1217
Republic of Korea,2012,ep,3544,632,601,1233
Republic of Korea,2012,ep,4554,728,693,1421
Republic of Korea,2012,ep,5564,620,578,1198
Republic of Korea,2012,ep,65,1371,1105,2476
Republic of Korea,2012,sn,014,87,83,170
Republic of Korea,2012,sn,1524,951,1289,2240
Republic of Korea,2012,sn,2534,1387,1587,2974
Republic of Korea,2012,sn,3544,946,1628,2574
Republic of Korea,2012,sn,4554,846,2025,2871
Republic of Korea,2012,sn,5564,805,1790,2595
Republic of Korea,2012,sn,65,2567,2931,5498
Republic of Korea,2012,sp,014,22,11,33
Republic of Korea,2012,sp,1524,436,500,936
Republic of Korea,2012,sp,2534,664,699,1363
Republic of Korea,2012,sp,3544,444,956,1400
Republic of Korea,2012,sp,4554,377,1562,1939
Republic of Korea,2012,sp,5564,397,1238,1635
Republic of Korea,2012,sp,65,2569,2255,4824
Republic of Korea,2013,rel,014,120,106,226
Republic of Korea,2013,rel,1524,1570,2003,3573
Republic of Korea,2013,rel,2534,2554,2836,5390
Republic of Korea,2013,rel,3544,2156,3250,5406
Republic of Korea,2013,rel,4554,2196,4664,6860
Republic of Korea,2013,rel,5564,1883,4116,5999
Republic of Korea,2013,rel,65,6649,7470,14119
Republic of Moldova,1995,sp,014,2,0,2
Republic of Moldova,1995,sp,1524,42,55,97
Republic of Moldova,1995,sp,2534,38,115,153
Republic of Moldova,1995,sp,3544,31,166,197
Republic of Moldova,1995,sp,4554,19,95,114
Republic of Moldova,1995,sp,5564,10,65,75
Republic of Moldova,1995,sp,65,12,15,27
Republic of Moldova,1996,sp,014,2,0,2
Republic of Moldova,1996,sp,1524,10,26,36
Republic of Moldova,1996,sp,2534,14,33,47
Republic of Moldova,1996,sp,3544,18,55,73
Republic of Moldova,1996,sp,4554,4,34,38
Republic of Moldova,1996,sp,5564,3,9,12
Republic of Moldova,1996,sp,65,6,5,11
Republic of Moldova,1997,sp,014,0,0,0
Republic of Moldova,1997,sp,1524,24,51,75
Republic of Moldova,1997,sp,2534,32,65,97
Republic of Moldova,1997,sp,3544,16,86,102
Republic of Moldova,1997,sp,4554,14,47,61
Republic of Moldova,1997,sp,5564,6,35,41
Republic of Moldova,1997,sp,65,8,13,21
Republic of Moldova,1998,sp,014,2,2,4
Republic of Moldova,1998,sp,1524,34,72,106
Republic of Moldova,1998,sp,2534,20,67,87
Republic of Moldova,1998,sp,3544,34,116,150
Republic of Moldova,1998,sp,4554,10,56,66
Republic of Moldova,1998,sp,5564,5,36,41
Republic of Moldova,1998,sp,65,7,16,23
Republic of Moldova,1999,sp,014,3,1,4
Republic of Moldova,1999,sp,1524,31,89,120
Republic of Moldova,1999,sp,2534,32,123,155
Republic of Moldova,1999,sp,3544,27,144,171
Republic of Moldova,1999,sp,4554,19,84,103
Republic of Moldova,1999,sp,5564,7,29,36
Republic of Moldova,1999,sp,65,6,14,20
Republic of Moldova,2000,sp,014,1,2,3
Republic of Moldova,2000,sp,1524,16,52,68
Republic of Moldova,2000,sp,2534,32,31,63
Republic of Moldova,2000,sp,3544,45,36,81
Republic of Moldova,2000,sp,4554,23,13,36
Republic of Moldova,2000,sp,5564,14,13,27
Republic of Moldova,2000,sp,65,6,6,12
Republic of Moldova,2001,sp,014,6,1,7
Republic of Moldova,2001,sp,1524,58,152,210
Republic of Moldova,2001,sp,2534,61,197,258
Republic of Moldova,2001,sp,3544,46,230,276
Republic of Moldova,2001,sp,4554,33,158,191
Republic of Moldova,2001,sp,5564,14,62,76
Republic of Moldova,2001,sp,65,10,32,42
Republic of Moldova,2002,sp,014,11,5,16
Republic of Moldova,2002,sp,1524,71,159,230
Republic of Moldova,2002,sp,2534,76,220,296
Republic of Moldova,2002,sp,3544,41,237,278
Republic of Moldova,2002,sp,4554,32,181,213
Republic of Moldova,2002,sp,5564,23,49,72
Republic of Moldova,2002,sp,65,8,33,41
Republic of Moldova,2003,sp,014,1,1,2
Republic of Moldova,2003,sp,1524,101,152,253
Republic of Moldova,2003,sp,2534,71,201,272
Republic of Moldova,2003,sp,3544,64,252,316
Republic of Moldova,2003,sp,4554,40,206,246
Republic of Moldova,2003,sp,5564,16,62,78
Republic of Moldova,2003,sp,65,22,25,47
Republic of Moldova,2004,sp,014,11,8,19
Republic of Moldova,2004,sp,1524,91,210,301
Republic of Moldova,2004,sp,2534,97,277,374
Republic of Moldova,2004,sp,3544,57,284,341
Republic of Moldova,2004,sp,4554,53,267,320
Republic of Moldova,2004,sp,5564,28,89,117
Republic of Moldova,2004,sp,65,22,42,64
Republic of Moldova,2005,sp,014,3,2,5
Republic of Moldova,2005,sp,1524,97,211,308
Republic of Moldova,2005,sp,2534,92,337,429
Republic of Moldova,2005,sp,3544,57,345,402
Republic of Moldova,2005,sp,4554,61,313,374
Republic of Moldova,2005,sp,5564,23,106,129
Republic of Moldova,2005,sp,65,18,31,49
Republic of Moldova,2006,sp,014,7,2,9
Republic of Moldova,2006,sp,1524,91,175,266
Republic of Moldova,2006,sp,2534,108,302,410
Republic of Moldova,2006,sp,3544,72,349,421
Republic of Moldova,2006,sp,4554,67,312,379
Republic of Moldova,2006,sp,5564,25,106,131
Republic of Moldova,2006,sp,65,31,32,63
Republic of Moldova,2007,ep,014,63,83,146
Republic of Moldova,2007,ep,1524,38,55,93
Republic of Moldova,2007,ep,2534,33,45,78
Republic of Moldova,2007,ep,3544,26,45,71
Republic of Moldova,2007,ep,4554,24,31,55
Republic of Moldova,2007,ep,5564,26,24,50
Republic of Moldova,2007,ep,65,12,8,20
Republic of Moldova,2007,sn,014,13,15,28
Republic of Moldova,2007,sn,1524,169,222,391
Republic of Moldova,2007,sn,2534,140,286,426
Republic of Moldova,2007,sn,3544,113,315,428
Republic of Moldova,2007,sn,4554,93,331,424
Republic of Moldova,2007,sn,5564,67,154,221
Republic of Moldova,2007,sn,65,39,86,125
Republic of Moldova,2007,sp,014,2,0,2
Republic of Moldova,2007,sp,1524,97,181,278
Republic of Moldova,2007,sp,2534,85,281,366
Republic of Moldova,2007,sp,3544,57,343,400
Republic of Moldova,2007,sp,4554,58,314,372
Republic of Moldova,2007,sp,5564,25,107,132
Republic of Moldova,2007,sp,65,25,35,60
Republic of Moldova,2008,ep,014,52,85,137
Republic of Moldova,2008,ep,1524,31,43,74
Republic of Moldova,2008,ep,2534,30,33,63
Republic of Moldova,2008,ep,3544,31,40,71
Republic of Moldova,2008,ep,4554,33,31,64
Republic of Moldova,2008,ep,5564,25,26,51
Republic of Moldova,2008,ep,65,9,7,16
Republic of Moldova,2008,sn,014,9,9,18
Republic of Moldova,2008,sn,1524,174,196,370
Republic of Moldova,2008,sn,2534,163,330,493
Republic of Moldova,2008,sn,3544,97,268,365
Republic of Moldova,2008,sn,4554,95,296,391
Republic of Moldova,2008,sn,5564,49,145,194
Republic of Moldova,2008,sn,65,39,72,111
Republic of Moldova,2008,sp,014,4,1,5
Republic of Moldova,2008,sp,1524,85,167,252
Republic of Moldova,2008,sp,2534,81,271,352
Republic of Moldova,2008,sp,3544,57,314,371
Republic of Moldova,2008,sp,4554,52,317,369
Republic of Moldova,2008,sp,5564,22,105,127
Republic of Moldova,2008,sp,65,25,32,57
Republic of Moldova,2009,ep,014,56,68,124
Republic of Moldova,2009,ep,1524,36,40,76
Republic of Moldova,2009,ep,2534,31,45,76
Republic of Moldova,2009,ep,3544,30,42,72
Republic of Moldova,2009,ep,4554,33,37,70
Republic of Moldova,2009,ep,5564,13,16,29
Republic of Moldova,2009,ep,65,12,12,24
Republic of Moldova,2009,sn,014,19,13,32
Republic of Moldova,2009,sn,1524,159,205,364
Republic of Moldova,2009,sn,2534,143,298,441
Republic of Moldova,2009,sn,3544,100,263,363
Republic of Moldova,2009,sn,4554,111,340,451
Republic of Moldova,2009,sn,5564,73,169,242
Republic of Moldova,2009,sn,65,37,85,122
Republic of Moldova,2009,sp,014,2,3,5
Republic of Moldova,2009,sp,1524,69,155,224
Republic of Moldova,2009,sp,2534,85,220,305
Republic of Moldova,2009,sp,3544,61,255,316
Republic of Moldova,2009,sp,4554,55,256,311
Republic of Moldova,2009,sp,5564,21,91,112
Republic of Moldova,2009,sp,65,15,30,45
Republic of Moldova,2010,ep,014,48,58,106
Republic of Moldova,2010,ep,1524,30,42,72
Republic of Moldova,2010,ep,2534,34,32,66
Republic of Moldova,2010,ep,3544,24,25,49
Republic of Moldova,2010,ep,4554,21,33,54
Republic of Moldova,2010,ep,5564,17,19,36
Republic of Moldova,2010,ep,65,13,9,22
Republic of Moldova,2010,sn,014,15,10,25
Republic of Moldova,2010,sn,1524,153,194,347
Republic of Moldova,2010,sn,2534,163,344,507
Republic of Moldova,2010,sn,3544,106,320,426
Republic of Moldova,2010,sn,4554,101,323,424
Republic of Moldova,2010,sn,5564,57,179,236
Republic of Moldova,2010,sn,65,42,66,108
Republic of Moldova,2010,sp,014,6,0,6
Republic of Moldova,2010,sp,1524,47,119,166
Republic of Moldova,2010,sp,2534,90,243,333
Republic of Moldova,2010,sp,3544,46,244,290
Republic of Moldova,2010,sp,4554,47,248,295
Republic of Moldova,2010,sp,5564,23,113,136
Republic of Moldova,2010,sp,65,20,21,41
Republic of Moldova,2011,ep,014,52,67,119
Republic of Moldova,2011,ep,1524,26,29,55
Republic of Moldova,2011,ep,2534,22,41,63
Republic of Moldova,2011,ep,3544,25,49,74
Republic of Moldova,2011,ep,4554,19,28,47
Republic of Moldova,2011,ep,5564,17,26,43
Republic of Moldova,2011,ep,65,13,10,23
Republic of Moldova,2011,sn,014,19,16,35
Republic of Moldova,2011,sn,1524,144,187,331
Republic of Moldova,2011,sn,2534,201,340,541
Republic of Moldova,2011,sn,3544,115,283,398
Republic of Moldova,2011,sn,4554,97,348,445
Republic of Moldova,2011,sn,5564,70,207,277
Republic of Moldova,2011,sn,65,47,66,113
Republic of Moldova,2011,sp,014,3,2,5
Republic of Moldova,2011,sp,1524,66,94,160
Republic of Moldova,2011,sp,2534,79,257,336
Republic of Moldova,2011,sp,3544,51,250,301
Republic of Moldova,2011,sp,4554,41,267,308
Republic of Moldova,2011,sp,5564,20,107,127
Republic of Moldova,2011,sp,65,14,21,35
Republic of Moldova,2012,ep,014,62,63,125
Republic of Moldova,2012,ep,1524,23,35,58
Republic of Moldova,2012,ep,2534,24,36,60
Republic of Moldova,2012,ep,3544,19,29,48
Republic of Moldova,2012,ep,4554,14,32,46
Republic of Moldova,2012,ep,5564,15,15,30
Republic of Moldova,2012,ep,65,13,16,29
Republic of Moldova,2012,sn,014,13,4,17
Republic of Moldova,2012,sn,1524,122,159,281
Republic of Moldova,2012,sn,2534,181,295,476
Republic of Moldova,2012,sn,3544,126,311,437
Republic of Moldova,2012,sn,4554,109,316,425
Republic of Moldova,2012,sn,5564,77,234,311
Republic of Moldova,2012,sn,65,42,73,115
Republic of Moldova,2012,sp,014,3,0,3
Republic of Moldova,2012,sp,1524,58,99,157
Republic of Moldova,2012,sp,2534,95,234,329
Republic of Moldova,2012,sp,3544,48,256,304
Republic of Moldova,2012,sp,4554,56,284,340
Republic of Moldova,2012,sp,5564,26,131,157
Republic of Moldova,2012,sp,65,25,31,56
Republic of Moldova,2013,rel,014,63,71,134
Republic of Moldova,2013,rel,1524,194,250,444
Republic of Moldova,2013,rel,2534,310,679,989
Republic of Moldova,2013,rel,3544,234,773,1007
Republic of Moldova,2013,rel,4554,182,787,969
Republic of Moldova,2013,rel,5564,166,528,694
Republic of Moldova,2013,rel,65,91,157,248
Romania,1995,sp,014,355,387,742
Romania,1995,sp,1524,1352,1662,3014
Romania,1995,sp,2534,1240,2322,3562
Romania,1995,sp,3544,871,3608,4479
Romania,1995,sp,4554,479,2587,3066
Romania,1995,sp,5564,396,1751,2147
Romania,1995,sp,65,417,784,1201
Romania,1996,sp,014,48,35,83
Romania,1996,sp,1524,749,851,1600
Romania,1996,sp,2534,630,1640,2270
Romania,1996,sp,3544,547,2606,3153
Romania,1996,sp,4554,302,1901,2203
Romania,1996,sp,5564,237,1236,1473
Romania,1996,sp,65,249,500,749
Romania,1997,sp,014,53,31,84
Romania,1997,sp,1524,735,1073,1808
Romania,1997,sp,2534,745,1618,2363
Romania,1997,sp,3544,545,2535,3080
Romania,1997,sp,4554,318,1990,2308
Romania,1997,sp,5564,200,1116,1316
Romania,1997,sp,65,245,461,706
Romania,1998,sp,014,43,21,64
Romania,1998,sp,1524,725,895,1620
Romania,1998,sp,2534,692,1624,2316
Romania,1998,sp,3544,448,2327,2775
Romania,1998,sp,4554,300,1762,2062
Romania,1998,sp,5564,219,1011,1230
Romania,1998,sp,65,232,522,754
Romania,1999,sp,014,48,34,82
Romania,1999,sp,1524,732,842,1574
Romania,1999,sp,2534,709,1524,2233
Romania,1999,sp,3544,496,2043,2539
Romania,1999,sp,4554,318,1653,1971
Romania,1999,sp,5564,198,918,1116
Romania,1999,sp,65,317,472,789
Romania,2000,sp,014,53,46,99
Romania,2000,sp,1524,701,832,1533
Romania,2000,sp,2534,766,1508,2274
Romania,2000,sp,3544,484,1799,2283
Romania,2000,sp,4554,341,1684,2025
Romania,2000,sp,5564,207,916,1123
Romania,2000,sp,65,321,533,854
Romania,2001,sp,014,70,60,130
Romania,2001,sp,1524,713,790,1503
Romania,2001,sp,2534,825,1670,2495
Romania,2001,sp,3544,497,1925,2422
Romania,2001,sp,4554,391,2000,2391
Romania,2001,sp,5564,228,975,1203
Romania,2001,sp,65,347,685,1032
Romania,2002,sp,014,74,102,176
Romania,2002,sp,1524,669,742,1411
Romania,2002,sp,2534,839,1682,2521
Romania,2002,sp,3544,435,1854,2289
Romania,2002,sp,4554,370,1914,2284
Romania,2002,sp,5564,202,854,1056
Romania,2002,sp,65,351,605,956
Romania,2003,sp,014,58,37,95
Romania,2003,sp,1524,667,750,1417
Romania,2003,sp,2534,770,1565,2335
Romania,2003,sp,3544,470,1695,2165
Romania,2003,sp,4554,412,1953,2365
Romania,2003,sp,5564,196,836,1032
Romania,2003,sp,65,404,594,998
Romania,2004,sp,014,59,31,90
Romania,2004,sp,1524,682,718,1400
Romania,2004,sp,2534,797,1582,2379
Romania,2004,sp,3544,546,1798,2344
Romania,2004,sp,4554,458,1999,2457
Romania,2004,sp,5564,230,917,1147
Romania,2004,sp,65,432,629,1061
Romania,2005,sp,014,55,36,91
Romania,2005,sp,1524,758,752,1510
Romania,2005,sp,2534,780,1511,2291
Romania,2005,sp,3544,493,1786,2279
Romania,2005,sp,4554,374,1999,2373
Romania,2005,sp,5564,219,952,1171
Romania,2005,sp,65,442,638,1080
Romania,2006,ep,014,231,278,509
Romania,2006,ep,1524,361,489,850
Romania,2006,ep,2534,264,299,563
Romania,2006,ep,3544,203,272,475
Romania,2006,ep,4554,210,285,495
Romania,2006,ep,5564,145,194,339
Romania,2006,ep,65,200,234,434
Romania,2006,sn,014,240,237,477
Romania,2006,sn,1524,632,633,1265
Romania,2006,sn,2534,604,752,1356
Romania,2006,sn,3544,417,762,1179
Romania,2006,sn,4554,292,946,1238
Romania,2006,sn,5564,209,575,784
Romania,2006,sn,65,364,591,955
Romania,2006,sp,014,37,30,67
Romania,2006,sp,1524,669,748,1417
Romania,2006,sp,2534,763,1306,2069
Romania,2006,sp,3544,448,1624,2072
Romania,2006,sp,4554,334,1738,2072
Romania,2006,sp,5564,224,847,1071
Romania,2006,sp,65,465,580,1045
Romania,2007,ep,014,205,280,485
Romania,2007,ep,1524,344,450,794
Romania,2007,ep,2534,220,254,474
Romania,2007,ep,3544,182,257,439
Romania,2007,ep,4554,173,253,426
Romania,2007,ep,5564,124,175,299
Romania,2007,ep,65,183,184,367
Romania,2007,sn,014,231,230,461
Romania,2007,sn,1524,567,505,1072
Romania,2007,sn,2534,518,593,1111
Romania,2007,sn,3544,328,737,1065
Romania,2007,sn,4554,297,840,1137
Romania,2007,sn,5564,171,564,735
Romania,2007,sn,65,386,577,963
Romania,2007,sp,014,34,25,59
Romania,2007,sp,1524,665,706,1371
Romania,2007,sp,2534,634,1149,1783
Romania,2007,sp,3544,439,1559,1998
Romania,2007,sp,4554,332,1704,2036
Romania,2007,sp,5564,230,889,1119
Romania,2007,sp,65,448,611,1059
Romania,2008,ep,014,222,224,446
Romania,2008,ep,1524,324,468,792
Romania,2008,ep,2534,183,254,437
Romania,2008,ep,3544,177,240,417
Romania,2008,ep,4554,164,229,393
Romania,2008,ep,5564,121,200,321
Romania,2008,ep,65,156,208,364
Romania,2008,sn,014,214,197,411
Romania,2008,sn,1524,489,485,974
Romania,2008,sn,2534,480,574,1054
Romania,2008,sn,3544,336,645,981
Romania,2008,sn,4554,273,805,1078
Romania,2008,sn,5564,161,570,731
Romania,2008,sn,65,354,510,864
Romania,2008,sp,014,37,22,59
Romania,2008,sp,1524,557,671,1228
Romania,2008,sp,2534,567,1124,1691
Romania,2008,sp,3544,518,1656,2174
Romania,2008,sp,4554,320,1713,2033
Romania,2008,sp,5564,225,977,1202
Romania,2008,sp,65,499,625,1124
Romania,2009,ep,014,252,328,580
Romania,2009,ep,1524,328,415,743
Romania,2009,ep,2534,189,185,374
Romania,2009,ep,3544,174,221,395
Romania,2009,ep,4554,151,242,393
Romania,2009,ep,5564,117,185,302
Romania,2009,ep,65,165,219,384
Romania,2009,sn,014,168,153,321
Romania,2009,sn,1524,440,447,887
Romania,2009,sn,2534,398,465,863
Romania,2009,sn,3544,290,613,903
Romania,2009,sn,4554,227,709,936
Romania,2009,sn,5564,168,590,758
Romania,2009,sn,65,323,499,822
Romania,2009,sp,014,28,24,52
Romania,2009,sp,1524,575,726,1301
Romania,2009,sp,2534,564,969,1533
Romania,2009,sp,3544,421,1592,2013
Romania,2009,sp,4554,290,1599,1889
Romania,2009,sp,5564,216,1016,1232
Romania,2009,sp,65,455,637,1092
Romania,2010,ep,014,228,256,484
Romania,2010,ep,1524,309,378,687
Romania,2010,ep,2534,167,191,358
Romania,2010,ep,3544,148,259,407
Romania,2010,ep,4554,127,204,331
Romania,2010,ep,5564,113,193,306
Romania,2010,ep,65,137,178,315
Romania,2010,sn,014,131,135,266
Romania,2010,sn,1524,434,403,837
Romania,2010,sn,2534,377,438,815
Romania,2010,sn,3544,268,608,876
Romania,2010,sn,4554,198,585,783
Romania,2010,sn,5564,149,517,666
Romania,2010,sn,65,318,475,793
Romania,2010,sp,014,40,21,61
Romania,2010,sp,1524,509,673,1182
Romania,2010,sp,2534,481,873,1354
Romania,2010,sp,3544,407,1343,1750
Romania,2010,sp,4554,277,1310,1587
Romania,2010,sp,5564,173,896,1069
Romania,2010,sp,65,442,571,1013
Romania,2011,ep,014,208,239,447
Romania,2011,ep,1524,240,347,587
Romania,2011,ep,2534,145,203,348
Romania,2011,ep,3544,155,190,345
Romania,2011,ep,4554,102,152,254
Romania,2011,ep,5564,107,170,277
Romania,2011,ep,65,173,196,369
Romania,2011,sn,014,117,151,268
Romania,2011,sn,1524,401,368,769
Romania,2011,sn,2534,331,410,741
Romania,2011,sn,3544,283,492,775
Romania,2011,sn,4554,169,436,605
Romania,2011,sn,5564,164,461,625
Romania,2011,sn,65,286,447,733
Romania,2011,sp,014,25,19,44
Romania,2011,sp,1524,475,624,1099
Romania,2011,sp,2534,514,813,1327
Romania,2011,sp,3544,408,1194,1602
Romania,2011,sp,4554,215,1103,1318
Romania,2011,sp,5564,197,839,1036
Romania,2011,sp,65,427,542,969
Romania,2012,ep,014,239,233,472
Romania,2012,ep,1524,222,347,569
Romania,2012,ep,2534,131,173,304
Romania,2012,ep,3544,124,172,296
Romania,2012,ep,4554,86,137,223
Romania,2012,ep,5564,123,179,302
Romania,2012,ep,65,142,164,306
Romania,2012,sn,014,106,99,205
Romania,2012,sn,1524,345,377,722
Romania,2012,sn,2534,338,368,706
Romania,2012,sn,3544,250,452,702
Romania,2012,sn,4554,171,472,643
Romania,2012,sn,5564,143,484,627
Romania,2012,sn,65,321,503,824
Romania,2012,sp,014,22,14,36
Romania,2012,sp,1524,428,545,973
Romania,2012,sp,2534,426,757,1183
Romania,2012,sp,3544,365,1282,1647
Romania,2012,sp,4554,186,1035,1221
Romania,2012,sp,5564,182,823,1005
Romania,2012,sp,65,435,487,922
Romania,2013,rel,014,340,355,695
Romania,2013,rel,1524,1010,1143,2153
Romania,2013,rel,2534,940,1372,2312
Romania,2013,rel,3544,827,2035,2862
Romania,2013,rel,4554,515,2175,2690
Romania,2013,rel,5564,542,1998,2540
Romania,2013,rel,65,973,1298,2271
Russian Federation,1996,sp,014,0,0,0
Russian Federation,1996,sp,1524,8,12,20
Russian Federation,1996,sp,2534,6,46,52
Russian Federation,1996,sp,3544,9,69,78
Russian Federation,1996,sp,4554,9,55,64
Russian Federation,1996,sp,5564,4,36,40
Russian Federation,1996,sp,65,12,17,29
Russian Federation,1997,sp,014,0,0,0
Russian Federation,1997,sp,1524,20,38,58
Russian Federation,1997,sp,2534,30,100,130
Russian Federation,1997,sp,3544,30,150,180
Russian Federation,1997,sp,4554,20,114,134
Russian Federation,1997,sp,5564,13,77,90
Russian Federation,1997,sp,65,29,39,68
Russian Federation,1998,sp,014,2,0,2
Russian Federation,1998,sp,1524,24,45,69
Russian Federation,1998,sp,2534,24,89,113
Russian Federation,1998,sp,3544,33,161,194
Russian Federation,1998,sp,4554,20,131,151
Russian Federation,1998,sp,5564,15,81,96
Russian Federation,1998,sp,65,24,34,58
Russian Federation,1999,sp,014,33,17,50
Russian Federation,1999,sp,1524,761,1858,2619
Russian Federation,1999,sp,2534,1022,4138,5160
Russian Federation,1999,sp,3544,989,5037,6026
Russian Federation,1999,sp,4554,600,3992,4592
Russian Federation,1999,sp,5564,313,1618,1931
Russian Federation,1999,sp,65,507,859,1366
Russian Federation,2000,sp,014,1,1,2
Russian Federation,2000,sp,1524,43,295,338
Russian Federation,2000,sp,2534,73,526,599
Russian Federation,2000,sp,3544,74,596,670
Russian Federation,2000,sp,4554,38,402,440
Russian Federation,2000,sp,5564,31,151,182
Russian Federation,2000,sp,65,44,54,98
Russian Federation,2001,sp,014,37,26,63
Russian Federation,2001,sp,1524,1019,2124,3143
Russian Federation,2001,sp,2534,1315,4317,5632
Russian Federation,2001,sp,3544,1374,5912,7286
Russian Federation,2001,sp,4554,1040,5435,6475
Russian Federation,2001,sp,5564,442,2026,2468
Russian Federation,2001,sp,65,598,941,1539
Russian Federation,2002,sp,014,0,0,0
Russian Federation,2002,sp,1524,1120,2081,3201
Russian Federation,2002,sp,2534,1496,4497,5993
Russian Federation,2002,sp,3544,1492,6003,7495
Russian Federation,2002,sp,4554,1100,5810,6910
Russian Federation,2002,sp,5564,452,2074,2526
Russian Federation,2002,sp,65,632,1061,1693
Russian Federation,2003,sp,014,0,0,0
Russian Federation,2003,sp,1524,1156,2128,3284
Russian Federation,2003,sp,2534,1753,4812,6565
Russian Federation,2003,sp,3544,1537,5979,7516
Russian Federation,2003,sp,4554,1281,5924,7205
Russian Federation,2003,sp,5564,462,2014,2476
Russian Federation,2003,sp,65,698,1058,1756
Russian Federation,2004,sp,014,45,18,63
Russian Federation,2004,sp,1524,1399,2355,3754
Russian Federation,2004,sp,2534,2051,5079,7130
Russian Federation,2004,sp,3544,1695,6165,7860
Russian Federation,2004,sp,4554,1415,6053,7468
Russian Federation,2004,sp,5564,528,2167,2695
Russian Federation,2004,sp,65,736,1184,1920
Russian Federation,2006,sp,014,40,18,58
Russian Federation,2006,sp,1524,1514,2445,3959
Russian Federation,2006,sp,2534,2207,5774,7981
Russian Federation,2006,sp,3544,1703,5923,7626
Russian Federation,2006,sp,4554,1492,6342,7834
Russian Federation,2006,sp,5564,560,2440,3000
Russian Federation,2006,sp,65,757,1120,1877
Russian Federation,2007,ep,014,1393,1430,2823
Russian Federation,2007,ep,1524,713,1031,1744
Russian Federation,2007,ep,2534,918,1537,2455
Russian Federation,2007,ep,3544,610,928,1538
Russian Federation,2007,ep,4554,574,828,1402
Russian Federation,2007,ep,5564,397,415,812
Russian Federation,2007,ep,65,593,337,930
Russian Federation,2007,sn,014,308,231,539
Russian Federation,2007,sn,1524,4925,7272,12197
Russian Federation,2007,sn,2534,6230,14334,20564
Russian Federation,2007,sn,3544,4014,10846,14860
Russian Federation,2007,sn,4554,3421,10714,14135
Russian Federation,2007,sn,5564,1505,7884,9389
Russian Federation,2007,sn,65,1624,2797,4421
Russian Federation,2007,sp,014,40,20,60
Russian Federation,2007,sp,1524,1444,2492,3936
Russian Federation,2007,sp,2534,2418,6008,8426
Russian Federation,2007,sp,3544,1684,5874,7558
Russian Federation,2007,sp,4554,1454,6363,7817
Russian Federation,2007,sp,5564,653,2491,3144
Russian Federation,2007,sp,65,871,1291,2162
Russian Federation,2008,ep,014,1316,1316,2632
Russian Federation,2008,ep,1524,654,841,1495
Russian Federation,2008,ep,2534,960,1455,2415
Russian Federation,2008,ep,3544,591,787,1378
Russian Federation,2008,ep,4554,593,797,1390
Russian Federation,2008,ep,5564,420,468,888
Russian Federation,2008,ep,65,555,358,913
Russian Federation,2008,sn,014,302,224,526
Russian Federation,2008,sn,1524,4716,7841,12557
Russian Federation,2008,sn,2534,6743,15551,22294
Russian Federation,2008,sn,3544,4114,11311,15425
Russian Federation,2008,sn,4554,3327,10958,14285
Russian Federation,2008,sn,5564,1539,5032,6571
Russian Federation,2008,sn,65,1576,2541,4117
Russian Federation,2008,sp,014,33,12,45
Russian Federation,2008,sp,1524,1467,2495,3962
Russian Federation,2008,sp,2534,2569,6475,9044
Russian Federation,2008,sp,3544,1707,6005,7712
Russian Federation,2008,sp,4554,1530,6300,7830
Russian Federation,2008,sp,5564,687,2687,3374
Russian Federation,2008,sp,65,835,1147,1982
Russian Federation,2009,ep,014,1284,1320,2604
Russian Federation,2009,ep,1524,657,756,1413
Russian Federation,2009,ep,2534,891,1582,2473
Russian Federation,2009,ep,3544,549,860,1409
Russian Federation,2009,ep,4554,530,793,1323
Russian Federation,2009,ep,5564,435,462,897
Russian Federation,2009,ep,65,512,314,826
Russian Federation,2009,sn,014,260,192,452
Russian Federation,2009,sn,1524,4641,7371,12012
Russian Federation,2009,sn,2534,6746,14965,21711
Russian Federation,2009,sn,3544,4064,10885,14949
Russian Federation,2009,sn,4554,3222,9969,13191
Russian Federation,2009,sn,5564,1688,5180,6868
Russian Federation,2009,sn,65,1507,2241,3748
Russian Federation,2009,sp,014,33,22,55
Russian Federation,2009,sp,1524,1464,2510,3974
Russian Federation,2009,sp,2534,2602,6544,9146
Russian Federation,2009,sp,3544,1739,5722,7461
Russian Federation,2009,sp,4554,1390,5952,7342
Russian Federation,2009,sp,5564,713,2822,3535
Russian Federation,2009,sp,65,824,1014,1838
Russian Federation,2010,ep,014,137,134,271
Russian Federation,2010,ep,1524,171,158,329
Russian Federation,2010,ep,2534,406,367,773
Russian Federation,2010,ep,3544,231,268,499
Russian Federation,2010,ep,4554,271,286,557
Russian Federation,2010,ep,5564,307,268,575
Russian Federation,2010,ep,65,300,209,509
Russian Federation,2010,sn,014,295,229,524
Russian Federation,2010,sn,1524,4094,6571,10665
Russian Federation,2010,sn,2534,6399,14047,20446
Russian Federation,2010,sn,3544,3841,10430,14271
Russian Federation,2010,sn,4554,2942,8885,11827
Russian Federation,2010,sn,5564,1698,5056,6754
Russian Federation,2010,sn,65,1372,2035,3407
Russian Federation,2010,sp,014,28,8,36
Russian Federation,2010,sp,1524,1247,2228,3475
Russian Federation,2010,sp,2534,2554,6276,8830
Russian Federation,2010,sp,3544,1719,5571,7290
Russian Federation,2010,sp,4554,1182,5361,6543
Russian Federation,2010,sp,5564,745,2787,3532
Russian Federation,2010,sp,65,790,920,1710
Russian Federation,2011,ep,014,1395,1506,2901
Russian Federation,2011,ep,1524,434,588,1022
Russian Federation,2011,ep,2534,880,1315,2195
Russian Federation,2011,ep,3544,507,933,1440
Russian Federation,2011,ep,4554,405,581,986
Russian Federation,2011,ep,5564,386,433,819
Russian Federation,2011,ep,65,424,236,660
Russian Federation,2011,sn,014,333,260,593
Russian Federation,2011,sn,1524,3850,5545,9395
Russian Federation,2011,sn,2534,6410,13832,20242
Russian Federation,2011,sn,3544,3869,10353,14222
Russian Federation,2011,sn,4554,2646,8372,11018
Russian Federation,2011,sn,5564,1765,4780,6545
Russian Federation,2011,sn,65,1318,1773,3091
Russian Federation,2011,sp,014,36,15,51
Russian Federation,2011,sp,1524,1139,1826,2965
Russian Federation,2011,sp,2534,2394,5726,8120
Russian Federation,2011,sp,3544,1643,5338,6981
Russian Federation,2011,sp,4554,1166,4928,6094
Russian Federation,2011,sp,5564,719,2664,3383
Russian Federation,2011,sp,65,752,845,1597
Russian Federation,2012,ep,014,1465,1445,2910
Russian Federation,2012,ep,1524,421,593,1014
Russian Federation,2012,ep,2534,870,1465,2335
Russian Federation,2012,ep,3544,534,930,1464
Russian Federation,2012,ep,4554,376,525,901
Russian Federation,2012,ep,5564,388,363,751
Russian Federation,2012,ep,65,393,249,642
Russian Federation,2012,sn,014,399,331,730
Russian Federation,2012,sn,1524,3154,4711,7865
Russian Federation,2012,sn,2534,6253,13041,19294
Russian Federation,2012,sn,3544,3727,9560,13287
Russian Federation,2012,sn,4554,2383,7328,9711
Russian Federation,2012,sn,5564,1560,4586,6146
Russian Federation,2012,sn,65,1270,1755,3025
Russian Federation,2012,sp,014,31,17,48
Russian Federation,2012,sp,1524,997,1568,2565
Russian Federation,2012,sp,2534,2292,5472,7764
Russian Federation,2012,sp,3544,1595,5115,6710
Russian Federation,2012,sp,4554,1081,4446,5527
Russian Federation,2012,sp,5564,637,2629,3266
Russian Federation,2012,sp,65,748,839,1587
Russian Federation,2013,rel,014,1672,1626,3298
Russian Federation,2013,rel,1524,3740,5827,9567
Russian Federation,2013,rel,2534,8705,18096,26801
Russian Federation,2013,rel,3544,5501,15635,21136
Russian Federation,2013,rel,4554,3630,11218,14848
Russian Federation,2013,rel,5564,2589,7255,9844
Russian Federation,2013,rel,65,2256,2677,4933
Rwanda,1996,sp,014,45,48,93
Rwanda,1996,sp,1524,229,222,451
Rwanda,1996,sp,2534,278,398,676
Rwanda,1996,sp,3544,161,325,486
Rwanda,1996,sp,4554,47,124,171
Rwanda,1996,sp,5564,23,85,108
Rwanda,1996,sp,65,5,24,29
Rwanda,1997,sp,014,78,78,156
Rwanda,1997,sp,1524,274,284,558
Rwanda,1997,sp,2534,343,633,976
Rwanda,1997,sp,3544,175,537,712
Rwanda,1997,sp,4554,67,209,276
Rwanda,1997,sp,5564,37,87,124
Rwanda,1997,sp,65,10,40,50
Rwanda,1999,sp,014,59,93,152
Rwanda,1999,sp,1524,189,245,434
Rwanda,1999,sp,2534,262,530,792
Rwanda,1999,sp,3544,166,424,590
Rwanda,1999,sp,4554,49,224,273
Rwanda,1999,sp,5564,31,70,101
Rwanda,1999,sp,65,5,31,36
Rwanda,2000,sp,014,105,155,260
Rwanda,2000,sp,1524,396,466,862
Rwanda,2000,sp,2534,473,974,1447
Rwanda,2000,sp,3544,309,824,1133
Rwanda,2000,sp,4554,109,393,502
Rwanda,2000,sp,5564,52,129,181
Rwanda,2000,sp,65,14,56,70
Rwanda,2002,sp,014,15,13,28
Rwanda,2002,sp,1524,98,96,194
Rwanda,2002,sp,2534,113,167,280
Rwanda,2002,sp,3544,58,184,242
Rwanda,2002,sp,4554,22,79,101
Rwanda,2002,sp,5564,15,38,53
Rwanda,2002,sp,65,8,13,21
Rwanda,2003,sp,014,36,32,68
Rwanda,2003,sp,1524,312,364,676
Rwanda,2003,sp,2534,340,517,857
Rwanda,2003,sp,3544,161,424,585
Rwanda,2003,sp,4554,79,270,349
Rwanda,2003,sp,5564,41,83,124
Rwanda,2003,sp,65,17,48,65
Rwanda,2004,sp,014,73,52,125
Rwanda,2004,sp,1524,460,561,1021
Rwanda,2004,sp,2534,469,722,1191
Rwanda,2004,sp,3544,293,595,888
Rwanda,2004,sp,4554,150,353,503
Rwanda,2004,sp,5564,53,171,224
Rwanda,2004,sp,65,25,64,89
Rwanda,2005,sp,014,73,45,118
Rwanda,2005,sp,1524,483,494,977
Rwanda,2005,sp,2534,442,713,1155
Rwanda,2005,sp,3544,262,592,854
Rwanda,2005,sp,4554,157,408,565
Rwanda,2005,sp,5564,60,142,202
Rwanda,2005,sp,65,29,71,100
Rwanda,2006,sp,014,80,25,105
Rwanda,2006,sp,1524,494,598,1092
Rwanda,2006,sp,2534,467,769,1236
Rwanda,2006,sp,3544,259,591,850
Rwanda,2006,sp,4554,139,407,546
Rwanda,2006,sp,5564,72,182,254
Rwanda,2006,sp,65,37,100,137
Rwanda,2007,sp,014,81,51,132
Rwanda,2007,sp,1524,477,523,1000
Rwanda,2007,sp,2534,468,805,1273
Rwanda,2007,sp,3544,245,556,801
Rwanda,2007,sp,4554,131,352,483
Rwanda,2007,sp,5564,70,168,238
Rwanda,2007,sp,65,35,91,126
Rwanda,2008,sp,014,65,33,98
Rwanda,2008,sp,1524,439,528,967
Rwanda,2008,sp,2534,472,811,1283
Rwanda,2008,sp,3544,280,573,853
Rwanda,2008,sp,4554,161,373,534
Rwanda,2008,sp,5564,82,191,273
Rwanda,2008,sp,65,40,125,165
Rwanda,2009,sp,014,46,25,71
Rwanda,2009,sp,1524,388,519,907
Rwanda,2009,sp,2534,464,829,1293
Rwanda,2009,sp,3544,266,650,916
Rwanda,2009,sp,4554,184,390,574
Rwanda,2009,sp,5564,70,196,266
Rwanda,2009,sp,65,43,114,157
Rwanda,2010,sp,014,48,48,96
Rwanda,2010,sp,1524,399,430,829
Rwanda,2010,sp,2534,448,741,1189
Rwanda,2010,sp,3544,261,526,787
Rwanda,2010,sp,4554,128,325,453
Rwanda,2010,sp,5564,65,202,267
Rwanda,2010,sp,65,38,126,164
Rwanda,2011,sp,014,50,42,92
Rwanda,2011,sp,1524,358,423,781
Rwanda,2011,sp,2534,398,795,1193
Rwanda,2011,sp,3544,235,500,735
Rwanda,2011,sp,4554,146,376,522
Rwanda,2011,sp,5564,87,210,297
Rwanda,2011,sp,65,67,124,191
Rwanda,2012,sp,014,40,22,62
Rwanda,2012,sp,1524,327,375,702
Rwanda,2012,sp,2534,393,768,1161
Rwanda,2012,sp,3544,208,519,727
Rwanda,2012,sp,4554,116,341,457
Rwanda,2012,sp,5564,66,214,280
Rwanda,2012,sp,65,59,123,182
Rwanda,2013,rel,014,199,207,406
Rwanda,2013,rel,1524,433,498,931
Rwanda,2013,rel,2534,569,1017,1586
Rwanda,2013,rel,3544,364,684,1048
Rwanda,2013,rel,4554,261,533,794
Rwanda,2013,rel,5564,161,393,554
Rwanda,2013,rel,65,131,252,383
Saint Kitts and Nevis,1996,sp,014,NA,0,NA
Saint Kitts and Nevis,1996,sp,1524,NA,0,NA
Saint Kitts and Nevis,1996,sp,2534,NA,1,NA
Saint Kitts and Nevis,1996,sp,3544,NA,1,NA
Saint Kitts and Nevis,1996,sp,4554,NA,0,NA
Saint Kitts and Nevis,1996,sp,5564,NA,0,NA
Saint Kitts and Nevis,1996,sp,65,NA,0,NA
Saint Kitts and Nevis,1998,sp,014,NA,0,NA
Saint Kitts and Nevis,1998,sp,1524,NA,0,NA
Saint Kitts and Nevis,1998,sp,2534,NA,0,NA
Saint Kitts and Nevis,1998,sp,3544,NA,2,NA
Saint Kitts and Nevis,1998,sp,4554,NA,1,NA
Saint Kitts and Nevis,1998,sp,5564,NA,0,NA
Saint Kitts and Nevis,1998,sp,65,NA,0,NA
Saint Kitts and Nevis,2001,sp,5564,1,NA,NA
Saint Kitts and Nevis,2001,sp,65,1,NA,NA
Saint Kitts and Nevis,2002,sp,5564,1,NA,NA
Saint Kitts and Nevis,2006,sp,5564,NA,1,NA
Saint Kitts and Nevis,2007,ep,014,0,0,0
Saint Kitts and Nevis,2007,sn,014,0,0,0
Saint Kitts and Nevis,2007,sp,1524,NA,1,NA
Saint Kitts and Nevis,2007,sp,2534,NA,1,NA
Saint Kitts and Nevis,2007,sp,3544,NA,1,NA
Saint Kitts and Nevis,2007,sp,5564,1,NA,NA
Saint Kitts and Nevis,2008,ep,014,0,0,0
Saint Kitts and Nevis,2008,ep,1524,0,0,0
Saint Kitts and Nevis,2008,ep,2534,0,0,0
Saint Kitts and Nevis,2008,ep,3544,0,0,0
Saint Kitts and Nevis,2008,ep,4554,0,0,0
Saint Kitts and Nevis,2008,ep,5564,0,0,0
Saint Kitts and Nevis,2008,ep,65,0,0,0
Saint Kitts and Nevis,2008,sn,014,0,0,0
Saint Kitts and Nevis,2008,sn,1524,0,0,0
Saint Kitts and Nevis,2008,sn,2534,0,0,0
Saint Kitts and Nevis,2008,sn,3544,0,0,0
Saint Kitts and Nevis,2008,sn,4554,0,0,0
Saint Kitts and Nevis,2008,sn,5564,0,0,0
Saint Kitts and Nevis,2008,sn,65,0,0,0
Saint Kitts and Nevis,2008,sp,014,0,0,0
Saint Kitts and Nevis,2008,sp,1524,0,0,0
Saint Kitts and Nevis,2008,sp,2534,1,0,1
Saint Kitts and Nevis,2008,sp,3544,0,0,0
Saint Kitts and Nevis,2008,sp,4554,1,3,4
Saint Kitts and Nevis,2008,sp,5564,0,0,0
Saint Kitts and Nevis,2008,sp,65,0,0,0
Saint Kitts and Nevis,2009,ep,014,0,0,0
Saint Kitts and Nevis,2009,ep,1524,0,0,0
Saint Kitts and Nevis,2009,ep,2534,0,0,0
Saint Kitts and Nevis,2009,ep,3544,0,0,0
Saint Kitts and Nevis,2009,ep,4554,0,0,0
Saint Kitts and Nevis,2009,ep,5564,0,0,0
Saint Kitts and Nevis,2009,ep,65,0,0,0
Saint Kitts and Nevis,2009,sn,014,0,0,0
Saint Kitts and Nevis,2009,sn,1524,0,0,0
Saint Kitts and Nevis,2009,sn,2534,0,0,0
Saint Kitts and Nevis,2009,sn,3544,0,0,0
Saint Kitts and Nevis,2009,sn,4554,0,0,0
Saint Kitts and Nevis,2009,sn,5564,0,0,0
Saint Kitts and Nevis,2009,sn,65,0,0,0
Saint Kitts and Nevis,2009,sp,014,0,0,0
Saint Kitts and Nevis,2009,sp,1524,0,0,0
Saint Kitts and Nevis,2009,sp,2534,0,0,0
Saint Kitts and Nevis,2009,sp,3544,0,2,2
Saint Kitts and Nevis,2009,sp,4554,0,1,1
Saint Kitts and Nevis,2009,sp,5564,0,1,1
Saint Kitts and Nevis,2009,sp,65,0,0,0
Saint Kitts and Nevis,2010,ep,014,0,0,0
Saint Kitts and Nevis,2010,ep,1524,0,0,0
Saint Kitts and Nevis,2010,ep,2534,0,0,0
Saint Kitts and Nevis,2010,ep,3544,0,0,0
Saint Kitts and Nevis,2010,ep,4554,0,0,0
Saint Kitts and Nevis,2010,ep,5564,0,0,0
Saint Kitts and Nevis,2010,ep,65,0,0,0
Saint Kitts and Nevis,2010,sn,014,0,0,0
Saint Kitts and Nevis,2010,sn,1524,0,0,0
Saint Kitts and Nevis,2010,sn,2534,0,0,0
Saint Kitts and Nevis,2010,sn,3544,0,0,0
Saint Kitts and Nevis,2010,sn,4554,0,0,0
Saint Kitts and Nevis,2010,sn,5564,0,0,0
Saint Kitts and Nevis,2010,sn,65,0,0,0
Saint Kitts and Nevis,2010,sp,014,0,0,0
Saint Kitts and Nevis,2010,sp,1524,0,0,0
Saint Kitts and Nevis,2010,sp,2534,0,0,0
Saint Kitts and Nevis,2010,sp,3544,1,0,1
Saint Kitts and Nevis,2010,sp,4554,0,1,1
Saint Kitts and Nevis,2010,sp,5564,0,0,0
Saint Kitts and Nevis,2010,sp,65,0,0,0
Saint Kitts and Nevis,2011,ep,014,0,0,0
Saint Kitts and Nevis,2011,ep,1524,0,0,0
Saint Kitts and Nevis,2011,ep,2534,0,0,0
Saint Kitts and Nevis,2011,ep,3544,0,0,0
Saint Kitts and Nevis,2011,ep,4554,0,0,0
Saint Kitts and Nevis,2011,ep,5564,0,0,0
Saint Kitts and Nevis,2011,ep,65,0,0,0
Saint Kitts and Nevis,2011,sn,014,0,0,0
Saint Kitts and Nevis,2011,sn,1524,0,0,0
Saint Kitts and Nevis,2011,sn,2534,0,0,0
Saint Kitts and Nevis,2011,sn,3544,0,0,0
Saint Kitts and Nevis,2011,sn,4554,0,0,0
Saint Kitts and Nevis,2011,sn,5564,0,0,0
Saint Kitts and Nevis,2011,sn,65,0,0,0
Saint Kitts and Nevis,2011,sp,014,0,0,0
Saint Kitts and Nevis,2011,sp,1524,0,0,0
Saint Kitts and Nevis,2011,sp,2534,0,0,0
Saint Kitts and Nevis,2011,sp,3544,0,0,0
Saint Kitts and Nevis,2011,sp,4554,0,0,0
Saint Kitts and Nevis,2011,sp,5564,0,1,1
Saint Kitts and Nevis,2011,sp,65,0,0,0
Saint Kitts and Nevis,2012,ep,014,0,0,0
Saint Kitts and Nevis,2012,ep,1524,0,0,0
Saint Kitts and Nevis,2012,ep,2534,0,0,0
Saint Kitts and Nevis,2012,ep,3544,0,0,0
Saint Kitts and Nevis,2012,ep,4554,0,0,0
Saint Kitts and Nevis,2012,ep,5564,0,0,0
Saint Kitts and Nevis,2012,ep,65,0,0,0
Saint Kitts and Nevis,2012,sn,014,0,0,0
Saint Kitts and Nevis,2012,sn,1524,0,0,0
Saint Kitts and Nevis,2012,sn,2534,0,0,0
Saint Kitts and Nevis,2012,sn,3544,0,0,0
Saint Kitts and Nevis,2012,sn,4554,0,0,0
Saint Kitts and Nevis,2012,sn,5564,0,0,0
Saint Kitts and Nevis,2012,sn,65,0,0,0
Saint Kitts and Nevis,2012,sp,014,0,0,0
Saint Kitts and Nevis,2012,sp,1524,0,0,0
Saint Kitts and Nevis,2012,sp,2534,1,0,1
Saint Kitts and Nevis,2012,sp,3544,0,0,0
Saint Kitts and Nevis,2012,sp,4554,0,0,0
Saint Kitts and Nevis,2012,sp,5564,0,0,0
Saint Kitts and Nevis,2012,sp,65,0,1,1
Saint Kitts and Nevis,2013,rel,014,0,0,0
Saint Kitts and Nevis,2013,rel,1524,0,0,0
Saint Kitts and Nevis,2013,rel,2534,0,0,0
Saint Kitts and Nevis,2013,rel,3544,0,0,0
Saint Kitts and Nevis,2013,rel,4554,0,0,0
Saint Kitts and Nevis,2013,rel,5564,0,0,0
Saint Kitts and Nevis,2013,rel,65,0,0,0
Saint Lucia,1997,sp,014,1,0,1
Saint Lucia,1997,sp,1524,1,0,1
Saint Lucia,1997,sp,2534,3,1,4
Saint Lucia,1997,sp,3544,0,2,2
Saint Lucia,1997,sp,4554,0,0,0
Saint Lucia,1997,sp,5564,0,1,1
Saint Lucia,1997,sp,65,1,1,2
Saint Lucia,1998,sp,014,0,0,0
Saint Lucia,1998,sp,1524,3,2,5
Saint Lucia,1998,sp,2534,2,1,3
Saint Lucia,1998,sp,3544,0,1,1
Saint Lucia,1998,sp,4554,0,0,0
Saint Lucia,1998,sp,5564,1,0,1
Saint Lucia,1998,sp,65,1,1,2
Saint Lucia,1999,sp,1524,1,1,2
Saint Lucia,1999,sp,2534,1,NA,NA
Saint Lucia,1999,sp,4554,NA,3,NA
Saint Lucia,1999,sp,5564,NA,3,NA
Saint Lucia,2000,sp,014,0,0,0
Saint Lucia,2000,sp,1524,1,0,1
Saint Lucia,2000,sp,2534,0,0,0
Saint Lucia,2000,sp,3544,1,1,2
Saint Lucia,2000,sp,4554,0,0,0
Saint Lucia,2000,sp,5564,1,1,2
Saint Lucia,2000,sp,65,0,2,2
Saint Lucia,2001,sp,014,NA,0,NA
Saint Lucia,2001,sp,1524,NA,1,NA
Saint Lucia,2001,sp,2534,NA,1,NA
Saint Lucia,2001,sp,3544,NA,0,NA
Saint Lucia,2001,sp,4554,NA,1,NA
Saint Lucia,2001,sp,5564,NA,3,NA
Saint Lucia,2001,sp,65,NA,0,NA
Saint Lucia,2002,sp,2534,NA,1,NA
Saint Lucia,2002,sp,3544,NA,1,NA
Saint Lucia,2002,sp,4554,1,1,2
Saint Lucia,2002,sp,5564,1,2,3
Saint Lucia,2002,sp,65,NA,1,NA
Saint Lucia,2003,sp,014,0,0,0
Saint Lucia,2003,sp,1524,1,0,1
Saint Lucia,2003,sp,2534,1,0,1
Saint Lucia,2003,sp,3544,0,1,1
Saint Lucia,2003,sp,4554,3,2,5
Saint Lucia,2003,sp,5564,2,2,4
Saint Lucia,2003,sp,65,1,2,3
Saint Lucia,2004,sp,014,0,0,0
Saint Lucia,2004,sp,1524,2,0,2
Saint Lucia,2004,sp,2534,3,0,3
Saint Lucia,2004,sp,3544,0,1,1
Saint Lucia,2004,sp,4554,0,2,2
Saint Lucia,2004,sp,5564,0,2,2
Saint Lucia,2004,sp,65,3,2,5
Saint Lucia,2005,sp,014,1,0,1
Saint Lucia,2005,sp,1524,1,0,1
Saint Lucia,2005,sp,2534,0,0,0
Saint Lucia,2005,sp,3544,1,0,1
Saint Lucia,2005,sp,4554,1,2,3
Saint Lucia,2005,sp,5564,0,1,1
Saint Lucia,2005,sp,65,2,2,4
Saint Lucia,2006,sp,4554,NA,3,NA
Saint Lucia,2006,sp,5564,1,5,6
Saint Lucia,2006,sp,65,1,5,6
Saint Lucia,2007,sp,2534,NA,3,NA
Saint Lucia,2007,sp,3544,NA,3,NA
Saint Lucia,2007,sp,4554,1,2,3
Saint Lucia,2007,sp,5564,NA,4,NA
Saint Lucia,2007,sp,65,1,3,4
Saint Lucia,2008,ep,014,0,0,0
Saint Lucia,2008,ep,1524,0,0,0
Saint Lucia,2008,ep,2534,0,0,0
Saint Lucia,2008,ep,3544,0,0,0
Saint Lucia,2008,ep,4554,0,0,0
Saint Lucia,2008,ep,5564,1,0,1
Saint Lucia,2008,ep,65,0,0,0
Saint Lucia,2008,sn,014,0,0,0
Saint Lucia,2008,sn,1524,0,0,0
Saint Lucia,2008,sn,2534,0,0,0
Saint Lucia,2008,sn,3544,0,0,0
Saint Lucia,2008,sn,4554,0,1,1
Saint Lucia,2008,sn,5564,0,0,0
Saint Lucia,2008,sn,65,0,0,0
Saint Lucia,2008,sp,014,1,0,1
Saint Lucia,2008,sp,1524,0,2,2
Saint Lucia,2008,sp,2534,1,0,1
Saint Lucia,2008,sp,3544,3,2,5
Saint Lucia,2008,sp,4554,2,2,4
Saint Lucia,2008,sp,5564,1,2,3
Saint Lucia,2008,sp,65,2,1,3
Saint Lucia,2009,ep,014,0,0,0
Saint Lucia,2009,ep,1524,0,0,0
Saint Lucia,2009,ep,2534,0,0,0
Saint Lucia,2009,ep,3544,0,1,1
Saint Lucia,2009,ep,4554,0,0,0
Saint Lucia,2009,ep,5564,0,0,0
Saint Lucia,2009,ep,65,0,0,0
Saint Lucia,2009,sn,014,0,0,0
Saint Lucia,2009,sn,1524,0,0,0
Saint Lucia,2009,sn,2534,0,0,0
Saint Lucia,2009,sn,3544,0,1,1
Saint Lucia,2009,sn,4554,0,0,0
Saint Lucia,2009,sn,5564,0,0,0
Saint Lucia,2009,sn,65,0,0,0
Saint Lucia,2009,sp,014,0,0,0
Saint Lucia,2009,sp,1524,0,1,1
Saint Lucia,2009,sp,2534,0,0,0
Saint Lucia,2009,sp,3544,1,2,3
Saint Lucia,2009,sp,4554,0,1,1
Saint Lucia,2009,sp,5564,0,2,2
Saint Lucia,2009,sp,65,0,0,0
Saint Lucia,2010,ep,014,0,0,0
Saint Lucia,2010,ep,1524,0,0,0
Saint Lucia,2010,ep,2534,0,0,0
Saint Lucia,2010,ep,3544,0,0,0
Saint Lucia,2010,ep,4554,0,0,0
Saint Lucia,2010,ep,5564,0,0,0
Saint Lucia,2010,ep,65,0,0,0
Saint Lucia,2010,sn,014,0,0,0
Saint Lucia,2010,sn,1524,0,0,0
Saint Lucia,2010,sn,2534,0,0,0
Saint Lucia,2010,sn,3544,0,0,0
Saint Lucia,2010,sn,4554,0,0,0
Saint Lucia,2010,sn,5564,0,0,0
Saint Lucia,2010,sn,65,0,0,0
Saint Lucia,2010,sp,014,0,0,0
Saint Lucia,2010,sp,1524,0,0,0
Saint Lucia,2010,sp,2534,0,1,1
Saint Lucia,2010,sp,3544,1,2,3
Saint Lucia,2010,sp,4554,0,0,0
Saint Lucia,2010,sp,5564,1,1,2
Saint Lucia,2010,sp,65,1,2,3
Saint Lucia,2011,ep,014,0,0,0
Saint Lucia,2011,ep,1524,0,0,0
Saint Lucia,2011,ep,2534,0,0,0
Saint Lucia,2011,ep,3544,0,0,0
Saint Lucia,2011,ep,4554,0,0,0
Saint Lucia,2011,ep,5564,0,0,0
Saint Lucia,2011,ep,65,0,0,0
Saint Lucia,2011,sn,014,0,0,0
Saint Lucia,2011,sn,1524,0,0,0
Saint Lucia,2011,sn,2534,0,0,0
Saint Lucia,2011,sn,3544,0,0,0
Saint Lucia,2011,sn,4554,0,0,0
Saint Lucia,2011,sn,5564,0,0,0
Saint Lucia,2011,sn,65,0,0,0
Saint Lucia,2011,sp,014,0,0,0
Saint Lucia,2011,sp,1524,0,0,0
Saint Lucia,2011,sp,2534,0,1,1
Saint Lucia,2011,sp,3544,0,1,1
Saint Lucia,2011,sp,4554,0,0,0
Saint Lucia,2011,sp,5564,0,3,3
Saint Lucia,2011,sp,65,0,2,2
Saint Lucia,2012,ep,014,0,0,0
Saint Lucia,2012,ep,1524,0,0,0
Saint Lucia,2012,ep,2534,0,0,0
Saint Lucia,2012,ep,3544,0,0,0
Saint Lucia,2012,ep,4554,0,0,0
Saint Lucia,2012,ep,5564,0,0,0
Saint Lucia,2012,ep,65,0,0,0
Saint Lucia,2012,sn,014,0,0,0
Saint Lucia,2012,sn,1524,0,0,0
Saint Lucia,2012,sn,2534,0,0,0
Saint Lucia,2012,sn,3544,0,0,0
Saint Lucia,2012,sn,4554,0,0,0
Saint Lucia,2012,sn,5564,0,0,0
Saint Lucia,2012,sn,65,0,0,0
Saint Lucia,2012,sp,014,0,0,0
Saint Lucia,2012,sp,1524,1,2,3
Saint Lucia,2012,sp,2534,0,0,0
Saint Lucia,2012,sp,3544,0,1,1
Saint Lucia,2012,sp,4554,0,4,4
Saint Lucia,2012,sp,5564,1,0,1
Saint Lucia,2012,sp,65,0,2,2
Saint Lucia,2013,rel,014,0,1,1
Saint Lucia,2013,rel,1524,1,1,2
Saint Lucia,2013,rel,2534,1,0,1
Saint Lucia,2013,rel,3544,2,1,3
Saint Lucia,2013,rel,4554,1,0,1
Saint Lucia,2013,rel,5564,0,0,0
Saint Lucia,2013,rel,65,0,1,1
Saint Vincent and the Grenadines,1998,sp,014,NA,0,NA
Saint Vincent and the Grenadines,1998,sp,1524,NA,0,NA
Saint Vincent and the Grenadines,1998,sp,2534,NA,2,NA
Saint Vincent and the Grenadines,1998,sp,3544,NA,0,NA
Saint Vincent and the Grenadines,1998,sp,4554,NA,1,NA
Saint Vincent and the Grenadines,1998,sp,5564,NA,0,NA
Saint Vincent and the Grenadines,1998,sp,65,NA,0,NA
Saint Vincent and the Grenadines,2000,sp,014,1,0,1
Saint Vincent and the Grenadines,2000,sp,1524,0,1,1
Saint Vincent and the Grenadines,2000,sp,2534,0,0,0
Saint Vincent and the Grenadines,2000,sp,3544,0,4,4
Saint Vincent and the Grenadines,2000,sp,4554,0,2,2
Saint Vincent and the Grenadines,2000,sp,5564,0,0,0
Saint Vincent and the Grenadines,2000,sp,65,0,1,1
Saint Vincent and the Grenadines,2001,sp,3544,NA,1,NA
Saint Vincent and the Grenadines,2001,sp,4554,NA,2,NA
Saint Vincent and the Grenadines,2002,sp,2534,1,NA,NA
Saint Vincent and the Grenadines,2002,sp,3544,NA,1,NA
Saint Vincent and the Grenadines,2002,sp,4554,NA,1,NA
Saint Vincent and the Grenadines,2002,sp,5564,NA,2,NA
Saint Vincent and the Grenadines,2002,sp,65,1,2,3
Saint Vincent and the Grenadines,2003,sp,1524,1,NA,NA
Saint Vincent and the Grenadines,2003,sp,3544,1,2,3
Saint Vincent and the Grenadines,2003,sp,5564,NA,1,NA
Saint Vincent and the Grenadines,2003,sp,65,1,NA,NA
Saint Vincent and the Grenadines,2005,sp,014,0,0,0
Saint Vincent and the Grenadines,2005,sp,1524,0,0,0
Saint Vincent and the Grenadines,2005,sp,2534,1,0,1
Saint Vincent and the Grenadines,2005,sp,3544,0,2,2
Saint Vincent and the Grenadines,2005,sp,4554,1,1,2
Saint Vincent and the Grenadines,2005,sp,5564,0,0,0
Saint Vincent and the Grenadines,2005,sp,65,0,2,2
Saint Vincent and the Grenadines,2006,sp,5564,NA,4,NA
Saint Vincent and the Grenadines,2006,sp,65,2,2,4
Saint Vincent and the Grenadines,2007,ep,014,0,0,0
Saint Vincent and the Grenadines,2007,ep,1524,0,0,0
Saint Vincent and the Grenadines,2007,ep,2534,0,0,0
Saint Vincent and the Grenadines,2007,ep,3544,0,0,0
Saint Vincent and the Grenadines,2007,ep,4554,0,0,0
Saint Vincent and the Grenadines,2007,ep,5564,0,0,0
Saint Vincent and the Grenadines,2007,ep,65,0,0,0
Saint Vincent and the Grenadines,2007,sn,014,1,0,1
Saint Vincent and the Grenadines,2007,sn,1524,0,0,0
Saint Vincent and the Grenadines,2007,sn,2534,0,0,0
Saint Vincent and the Grenadines,2007,sn,3544,0,0,0
Saint Vincent and the Grenadines,2007,sn,4554,0,0,0
Saint Vincent and the Grenadines,2007,sn,5564,0,0,0
Saint Vincent and the Grenadines,2007,sn,65,2,1,3
Saint Vincent and the Grenadines,2007,sp,014,0,0,0
Saint Vincent and the Grenadines,2007,sp,1524,0,0,0
Saint Vincent and the Grenadines,2007,sp,2534,0,1,1
Saint Vincent and the Grenadines,2007,sp,3544,0,3,3
Saint Vincent and the Grenadines,2007,sp,4554,0,0,0
Saint Vincent and the Grenadines,2007,sp,5564,0,1,1
Saint Vincent and the Grenadines,2007,sp,65,0,0,0
Saint Vincent and the Grenadines,2008,ep,014,0,0,0
Saint Vincent and the Grenadines,2008,ep,1524,0,0,0
Saint Vincent and the Grenadines,2008,ep,2534,0,0,0
Saint Vincent and the Grenadines,2008,ep,3544,0,0,0
Saint Vincent and the Grenadines,2008,ep,4554,0,0,0
Saint Vincent and the Grenadines,2008,ep,5564,0,0,0
Saint Vincent and the Grenadines,2008,ep,65,0,0,0
Saint Vincent and the Grenadines,2008,sn,014,0,0,0
Saint Vincent and the Grenadines,2008,sn,1524,0,0,0
Saint Vincent and the Grenadines,2008,sn,2534,0,0,0
Saint Vincent and the Grenadines,2008,sn,3544,0,0,0
Saint Vincent and the Grenadines,2008,sn,4554,0,0,0
Saint Vincent and the Grenadines,2008,sn,5564,0,0,0
Saint Vincent and the Grenadines,2008,sn,65,0,0,0
Saint Vincent and the Grenadines,2009,sn,1524,NA,1,NA
Saint Vincent and the Grenadines,2009,sn,2534,NA,1,NA
Saint Vincent and the Grenadines,2009,sn,3544,NA,2,NA
Saint Vincent and the Grenadines,2009,sn,4554,NA,2,NA
Saint Vincent and the Grenadines,2009,sp,3544,NA,2,NA
Saint Vincent and the Grenadines,2009,sp,4554,NA,1,NA
Saint Vincent and the Grenadines,2010,ep,014,0,0,0
Saint Vincent and the Grenadines,2010,ep,1524,0,0,0
Saint Vincent and the Grenadines,2010,ep,2534,0,0,0
Saint Vincent and the Grenadines,2010,ep,3544,0,0,0
Saint Vincent and the Grenadines,2010,ep,4554,0,0,0
Saint Vincent and the Grenadines,2010,ep,5564,0,0,0
Saint Vincent and the Grenadines,2010,ep,65,0,0,0
Saint Vincent and the Grenadines,2010,sn,014,0,0,0
Saint Vincent and the Grenadines,2010,sn,1524,0,0,0
Saint Vincent and the Grenadines,2010,sn,2534,0,0,0
Saint Vincent and the Grenadines,2010,sn,3544,1,2,3
Saint Vincent and the Grenadines,2010,sn,4554,0,1,1
Saint Vincent and the Grenadines,2010,sn,5564,1,1,2
Saint Vincent and the Grenadines,2010,sn,65,0,1,1
Saint Vincent and the Grenadines,2010,sp,014,0,0,0
Saint Vincent and the Grenadines,2010,sp,1524,0,0,0
Saint Vincent and the Grenadines,2010,sp,2534,1,1,2
Saint Vincent and the Grenadines,2010,sp,3544,0,0,0
Saint Vincent and the Grenadines,2010,sp,4554,0,3,3
Saint Vincent and the Grenadines,2010,sp,5564,1,0,1
Saint Vincent and the Grenadines,2010,sp,65,0,2,2
Saint Vincent and the Grenadines,2011,ep,014,0,0,0
Saint Vincent and the Grenadines,2011,ep,1524,0,0,0
Saint Vincent and the Grenadines,2011,ep,2534,0,0,0
Saint Vincent and the Grenadines,2011,ep,3544,0,0,0
Saint Vincent and the Grenadines,2011,ep,4554,0,0,0
Saint Vincent and the Grenadines,2011,ep,5564,0,0,0
Saint Vincent and the Grenadines,2011,ep,65,0,0,0
Saint Vincent and the Grenadines,2011,sn,014,0,1,1
Saint Vincent and the Grenadines,2011,sn,1524,0,0,0
Saint Vincent and the Grenadines,2011,sn,2534,0,0,0
Saint Vincent and the Grenadines,2011,sn,3544,0,2,2
Saint Vincent and the Grenadines,2011,sn,4554,0,2,2
Saint Vincent and the Grenadines,2011,sn,5564,1,1,2
Saint Vincent and the Grenadines,2011,sn,65,0,2,2
Saint Vincent and the Grenadines,2011,sp,014,0,0,0
Saint Vincent and the Grenadines,2011,sp,1524,0,0,0
Saint Vincent and the Grenadines,2011,sp,2534,1,2,3
Saint Vincent and the Grenadines,2011,sp,3544,0,2,2
Saint Vincent and the Grenadines,2011,sp,4554,1,2,3
Saint Vincent and the Grenadines,2011,sp,5564,0,0,0
Saint Vincent and the Grenadines,2011,sp,65,0,0,0
Saint Vincent and the Grenadines,2012,ep,014,0,0,0
Saint Vincent and the Grenadines,2012,ep,1524,0,0,0
Saint Vincent and the Grenadines,2012,ep,2534,0,0,0
Saint Vincent and the Grenadines,2012,ep,3544,0,0,0
Saint Vincent and the Grenadines,2012,ep,4554,0,0,0
Saint Vincent and the Grenadines,2012,ep,5564,0,0,0
Saint Vincent and the Grenadines,2012,ep,65,0,0,0
Saint Vincent and the Grenadines,2012,sn,014,0,0,0
Saint Vincent and the Grenadines,2012,sn,1524,0,0,0
Saint Vincent and the Grenadines,2012,sn,2534,0,0,0
Saint Vincent and the Grenadines,2012,sn,3544,0,2,2
Saint Vincent and the Grenadines,2012,sn,4554,0,0,0
Saint Vincent and the Grenadines,2012,sn,5564,0,1,1
Saint Vincent and the Grenadines,2012,sn,65,0,0,0
Saint Vincent and the Grenadines,2012,sp,014,0,0,0
Saint Vincent and the Grenadines,2012,sp,1524,1,1,2
Saint Vincent and the Grenadines,2012,sp,2534,3,5,8
Saint Vincent and the Grenadines,2012,sp,3544,1,1,2
Saint Vincent and the Grenadines,2012,sp,4554,3,3,6
Saint Vincent and the Grenadines,2012,sp,5564,0,5,5
Saint Vincent and the Grenadines,2012,sp,65,0,4,4
Saint Vincent and the Grenadines,2013,rel,2534,NA,1,NA
Saint Vincent and the Grenadines,2013,rel,4554,NA,1,NA
Saint Vincent and the Grenadines,2013,rel,5564,NA,1,NA
Samoa,1995,sp,014,1,0,1
Samoa,1995,sp,1524,2,1,3
Samoa,1995,sp,2534,2,1,3
Samoa,1995,sp,3544,0,1,1
Samoa,1995,sp,4554,0,0,0
Samoa,1995,sp,5564,1,3,4
Samoa,1995,sp,65,1,2,3
Samoa,1996,sp,014,0,0,0
Samoa,1996,sp,1524,0,0,0
Samoa,1996,sp,2534,3,0,3
Samoa,1996,sp,3544,2,0,2
Samoa,1996,sp,4554,2,0,2
Samoa,1996,sp,5564,0,1,1
Samoa,1996,sp,65,0,2,2
Samoa,1997,sp,014,0,0,0
Samoa,1997,sp,1524,2,1,3
Samoa,1997,sp,2534,1,4,5
Samoa,1997,sp,3544,1,1,2
Samoa,1997,sp,4554,0,0,0
Samoa,1997,sp,5564,2,1,3
Samoa,1997,sp,65,0,1,1
Samoa,1998,sp,014,0,1,1
Samoa,1998,sp,1524,1,1,2
Samoa,1998,sp,2534,1,1,2
Samoa,1998,sp,3544,0,0,0
Samoa,1998,sp,4554,0,1,1
Samoa,1998,sp,5564,0,1,1
Samoa,1998,sp,65,0,0,0
Samoa,1999,sp,014,0,0,0
Samoa,1999,sp,1524,3,1,4
Samoa,1999,sp,2534,2,2,4
Samoa,1999,sp,3544,1,0,1
Samoa,1999,sp,4554,0,1,1
Samoa,1999,sp,5564,0,1,1
Samoa,1999,sp,65,2,4,6
Samoa,2000,sp,014,0,0,0
Samoa,2000,sp,1524,2,3,5
Samoa,2000,sp,2534,1,1,2
Samoa,2000,sp,3544,1,1,2
Samoa,2000,sp,4554,0,1,1
Samoa,2000,sp,5564,0,2,2
Samoa,2000,sp,65,0,1,1
Samoa,2001,sp,014,0,1,1
Samoa,2001,sp,1524,1,3,4
Samoa,2001,sp,2534,1,1,2
Samoa,2001,sp,3544,2,1,3
Samoa,2001,sp,4554,1,0,1
Samoa,2001,sp,5564,1,0,1
Samoa,2001,sp,65,1,1,2
Samoa,2002,sp,014,1,0,1
Samoa,2002,sp,1524,4,1,5
Samoa,2002,sp,2534,5,2,7
Samoa,2002,sp,3544,0,0,0
Samoa,2002,sp,4554,2,1,3
Samoa,2002,sp,5564,0,1,1
Samoa,2002,sp,65,0,1,1
Samoa,2003,sp,1524,2,2,4
Samoa,2003,sp,2534,2,NA,NA
Samoa,2003,sp,3544,2,NA,NA
Samoa,2003,sp,5564,2,1,3
Samoa,2003,sp,65,1,NA,NA
Samoa,2005,sp,014,0,0,0
Samoa,2005,sp,1524,2,4,6
Samoa,2005,sp,2534,0,0,0
Samoa,2005,sp,3544,2,1,3
Samoa,2005,sp,4554,0,1,1
Samoa,2005,sp,5564,1,0,1
Samoa,2005,sp,65,0,0,0
Samoa,2006,ep,3544,NA,1,NA
Samoa,2006,ep,5564,NA,1,NA
Samoa,2006,sn,3544,2,1,3
Samoa,2006,sn,4554,1,NA,NA
Samoa,2006,sn,65,1,NA,NA
Samoa,2006,sp,1524,3,3,6
Samoa,2006,sp,2534,NA,2,NA
Samoa,2006,sp,3544,NA,1,NA
Samoa,2006,sp,4554,1,1,2
Samoa,2006,sp,5564,NA,1,NA
Samoa,2006,sp,65,NA,2,NA
Samoa,2008,ep,014,0,0,0
Samoa,2008,ep,1524,0,0,0
Samoa,2008,ep,2534,0,0,0
Samoa,2008,ep,3544,0,1,1
Samoa,2008,ep,4554,0,0,0
Samoa,2008,ep,5564,0,1,1
Samoa,2008,ep,65,0,0,0
Samoa,2008,sn,014,0,0,0
Samoa,2008,sn,1524,0,0,0
Samoa,2008,sn,2534,0,1,1
Samoa,2008,sn,3544,1,0,1
Samoa,2008,sn,4554,0,1,1
Samoa,2008,sn,5564,0,1,1
Samoa,2008,sn,65,0,1,1
Samoa,2008,sp,014,0,0,0
Samoa,2008,sp,1524,1,1,2
Samoa,2008,sp,2534,1,0,1
Samoa,2008,sp,3544,1,0,1
Samoa,2008,sp,4554,0,0,0
Samoa,2008,sp,5564,0,1,1
Samoa,2008,sp,65,1,0,1
Samoa,2009,ep,014,0,0,0
Samoa,2009,ep,1524,1,0,1
Samoa,2009,ep,2534,0,0,0
Samoa,2009,ep,3544,0,0,0
Samoa,2009,ep,4554,0,0,0
Samoa,2009,ep,5564,0,1,1
Samoa,2009,ep,65,1,0,1
Samoa,2009,sn,014,0,0,0
Samoa,2009,sn,1524,1,0,1
Samoa,2009,sn,2534,0,0,0
Samoa,2009,sn,3544,0,0,0
Samoa,2009,sn,4554,0,0,0
Samoa,2009,sn,5564,1,0,1
Samoa,2009,sn,65,3,1,4
Samoa,2009,sp,3544,1,1,2
Samoa,2009,sp,4554,11,NA,NA
Samoa,2009,sp,5564,11,111,122
Samoa,2009,sp,65,1111,111,1222
Samoa,2010,ep,2534,1,NA,NA
Samoa,2010,ep,4554,1,NA,NA
Samoa,2010,ep,5564,NA,1,NA
Samoa,2010,sn,1524,NA,1,NA
Samoa,2010,sn,2534,NA,1,NA
Samoa,2010,sn,4554,2,NA,NA
Samoa,2010,sn,5564,1,NA,NA
Samoa,2010,sp,1524,NA,1,NA
Samoa,2010,sp,2534,NA,1,NA
Samoa,2010,sp,3544,2,NA,NA
Samoa,2010,sp,5564,1,1,2
Samoa,2011,ep,014,0,0,0
Samoa,2011,ep,1524,0,0,0
Samoa,2011,ep,2534,0,0,0
Samoa,2011,ep,3544,0,0,0
Samoa,2011,ep,4554,0,1,1
Samoa,2011,ep,5564,0,0,0
Samoa,2011,ep,65,0,1,1
Samoa,2011,sn,014,0,1,1
Samoa,2011,sn,1524,1,0,1
Samoa,2011,sn,2534,1,0,1
Samoa,2011,sn,3544,0,0,0
Samoa,2011,sn,4554,0,1,1
Samoa,2011,sn,5564,0,1,1
Samoa,2011,sn,65,0,5,5
Samoa,2011,sp,014,0,0,0
Samoa,2011,sp,1524,2,1,3
Samoa,2011,sp,2534,1,0,1
Samoa,2011,sp,3544,0,0,0
Samoa,2011,sp,4554,1,0,1
Samoa,2011,sp,5564,0,0,0
Samoa,2011,sp,65,1,0,1
Samoa,2012,ep,014,0,0,0
Samoa,2012,ep,1524,0,0,0
Samoa,2012,ep,2534,0,0,0
Samoa,2012,ep,3544,0,1,1
Samoa,2012,ep,4554,2,1,3
Samoa,2012,ep,5564,0,0,0
Samoa,2012,ep,65,0,0,0
Samoa,2012,sn,014,0,0,0
Samoa,2012,sn,1524,0,1,1
Samoa,2012,sn,2534,0,1,1
Samoa,2012,sn,3544,0,0,0
Samoa,2012,sn,4554,0,0,0
Samoa,2012,sn,5564,0,1,1
Samoa,2012,sn,65,0,0,0
Samoa,2012,sp,014,1,0,1
Samoa,2012,sp,1524,1,4,5
Samoa,2012,sp,2534,0,3,3
Samoa,2012,sp,3544,1,1,2
Samoa,2012,sp,4554,1,1,2
Samoa,2012,sp,5564,0,1,1
Samoa,2012,sp,65,1,0,1
Samoa,2013,rel,014,0,3,3
Samoa,2013,rel,1524,3,1,4
Samoa,2013,rel,2534,0,2,2
Samoa,2013,rel,3544,0,1,1
Samoa,2013,rel,4554,0,3,3
Samoa,2013,rel,5564,1,3,4
Samoa,2013,rel,65,2,3,5
San Marino,1997,sp,014,0,NA,NA
San Marino,1997,sp,1524,0,NA,NA
San Marino,1997,sp,2534,1,NA,NA
San Marino,1997,sp,3544,0,NA,NA
San Marino,1997,sp,4554,0,NA,NA
San Marino,1997,sp,5564,0,NA,NA
San Marino,1997,sp,65,0,NA,NA
San Marino,2000,sp,65,NA,1,NA
San Marino,2003,sp,014,0,0,0
San Marino,2003,sp,1524,0,0,0
San Marino,2003,sp,2534,0,0,0
San Marino,2003,sp,3544,0,0,0
San Marino,2003,sp,4554,0,0,0
San Marino,2003,sp,5564,0,0,0
San Marino,2003,sp,65,0,0,0
San Marino,2004,sp,014,0,0,0
San Marino,2004,sp,1524,0,0,0
San Marino,2004,sp,2534,0,0,0
San Marino,2004,sp,3544,0,0,0
San Marino,2004,sp,4554,0,0,0
San Marino,2004,sp,5564,0,0,0
San Marino,2004,sp,65,0,0,0
Sao Tome and Principe,2000,sp,014,3,1,4
Sao Tome and Principe,2000,sp,1524,7,5,12
Sao Tome and Principe,2000,sp,2534,15,11,26
Sao Tome and Principe,2000,sp,3544,5,4,9
Sao Tome and Principe,2000,sp,4554,7,7,14
Sao Tome and Principe,2000,sp,5564,4,3,7
Sao Tome and Principe,2000,sp,65,15,10,25
Sao Tome and Principe,2001,sp,014,1,0,1
Sao Tome and Principe,2001,sp,1524,4,7,11
Sao Tome and Principe,2001,sp,2534,10,14,24
Sao Tome and Principe,2001,sp,3544,4,6,10
Sao Tome and Principe,2001,sp,4554,8,6,14
Sao Tome and Principe,2001,sp,5564,6,5,11
Sao Tome and Principe,2001,sp,65,14,12,26
Sao Tome and Principe,2002,sp,014,0,1,1
Sao Tome and Principe,2002,sp,1524,6,7,13
Sao Tome and Principe,2002,sp,2534,5,6,11
Sao Tome and Principe,2002,sp,3544,2,2,4
Sao Tome and Principe,2002,sp,4554,3,2,5
Sao Tome and Principe,2002,sp,5564,2,2,4
Sao Tome and Principe,2002,sp,65,2,2,4
Sao Tome and Principe,2003,sp,014,0,1,1
Sao Tome and Principe,2003,sp,1524,3,2,5
Sao Tome and Principe,2003,sp,2534,7,4,11
Sao Tome and Principe,2003,sp,3544,8,5,13
Sao Tome and Principe,2003,sp,4554,1,3,4
Sao Tome and Principe,2003,sp,5564,0,0,0
Sao Tome and Principe,2003,sp,65,0,1,1
Sao Tome and Principe,2004,sp,014,1,3,4
Sao Tome and Principe,2004,sp,1524,4,5,9
Sao Tome and Principe,2004,sp,2534,5,7,12
Sao Tome and Principe,2004,sp,3544,5,6,11
Sao Tome and Principe,2004,sp,4554,2,5,7
Sao Tome and Principe,2004,sp,5564,1,2,3
Sao Tome and Principe,2004,sp,65,1,3,4
Sao Tome and Principe,2005,sp,014,1,2,3
Sao Tome and Principe,2005,sp,1524,4,5,9
Sao Tome and Principe,2005,sp,2534,5,7,12
Sao Tome and Principe,2005,sp,3544,3,6,9
Sao Tome and Principe,2005,sp,4554,2,4,6
Sao Tome and Principe,2005,sp,5564,3,5,8
Sao Tome and Principe,2005,sp,65,0,2,2
Sao Tome and Principe,2006,ep,014,0,0,0
Sao Tome and Principe,2006,ep,1524,0,0,0
Sao Tome and Principe,2006,ep,2534,0,0,0
Sao Tome and Principe,2006,ep,3544,1,0,1
Sao Tome and Principe,2006,ep,4554,0,0,0
Sao Tome and Principe,2006,ep,5564,0,0,0
Sao Tome and Principe,2006,ep,65,0,0,0
Sao Tome and Principe,2006,sn,014,2,3,5
Sao Tome and Principe,2006,sn,1524,8,10,18
Sao Tome and Principe,2006,sn,2534,15,25,40
Sao Tome and Principe,2006,sn,3544,11,16,27
Sao Tome and Principe,2006,sn,4554,6,8,14
Sao Tome and Principe,2006,sn,5564,4,5,9
Sao Tome and Principe,2006,sn,65,1,2,3
Sao Tome and Principe,2006,sp,014,1,0,1
Sao Tome and Principe,2006,sp,1524,4,5,9
Sao Tome and Principe,2006,sp,2534,7,8,15
Sao Tome and Principe,2006,sp,3544,0,4,4
Sao Tome and Principe,2006,sp,4554,0,2,2
Sao Tome and Principe,2006,sp,5564,1,1,2
Sao Tome and Principe,2006,sp,65,1,2,3
Sao Tome and Principe,2007,ep,014,0,0,0
Sao Tome and Principe,2007,ep,1524,0,0,0
Sao Tome and Principe,2007,ep,2534,0,0,0
Sao Tome and Principe,2007,ep,3544,1,0,1
Sao Tome and Principe,2007,ep,4554,0,0,0
Sao Tome and Principe,2007,ep,5564,1,0,1
Sao Tome and Principe,2007,ep,65,0,0,0
Sao Tome and Principe,2007,sn,014,0,0,0
Sao Tome and Principe,2007,sn,1524,3,1,4
Sao Tome and Principe,2007,sn,2534,1,2,3
Sao Tome and Principe,2007,sn,3544,5,3,8
Sao Tome and Principe,2007,sn,4554,3,3,6
Sao Tome and Principe,2007,sn,5564,0,4,4
Sao Tome and Principe,2007,sn,65,1,1,2
Sao Tome and Principe,2007,sp,014,0,0,0
Sao Tome and Principe,2007,sp,1524,9,4,13
Sao Tome and Principe,2007,sp,2534,6,12,18
Sao Tome and Principe,2007,sp,3544,3,8,11
Sao Tome and Principe,2007,sp,4554,3,4,7
Sao Tome and Principe,2007,sp,5564,5,4,9
Sao Tome and Principe,2007,sp,65,0,0,0
Sao Tome and Principe,2008,ep,014,0,0,0
Sao Tome and Principe,2008,ep,1524,0,0,0
Sao Tome and Principe,2008,ep,2534,0,0,0
Sao Tome and Principe,2008,ep,3544,0,0,0
Sao Tome and Principe,2008,ep,4554,0,0,0
Sao Tome and Principe,2008,ep,5564,0,0,0
Sao Tome and Principe,2008,ep,65,0,0,0
Sao Tome and Principe,2008,sn,014,1,0,1
Sao Tome and Principe,2008,sn,1524,1,0,1
Sao Tome and Principe,2008,sn,2534,1,4,5
Sao Tome and Principe,2008,sn,3544,1,1,2
Sao Tome and Principe,2008,sn,4554,1,1,2
Sao Tome and Principe,2008,sn,5564,0,0,0
Sao Tome and Principe,2008,sn,65,0,0,0
Sao Tome and Principe,2008,sp,014,2,1,3
Sao Tome and Principe,2008,sp,1524,5,5,10
Sao Tome and Principe,2008,sp,2534,6,13,19
Sao Tome and Principe,2008,sp,3544,6,5,11
Sao Tome and Principe,2008,sp,4554,2,6,8
Sao Tome and Principe,2008,sp,5564,0,1,1
Sao Tome and Principe,2008,sp,65,0,0,0
Sao Tome and Principe,2009,ep,014,0,0,0
Sao Tome and Principe,2009,ep,1524,0,1,1
Sao Tome and Principe,2009,ep,2534,2,1,3
Sao Tome and Principe,2009,ep,3544,0,0,0
Sao Tome and Principe,2009,ep,4554,0,0,0
Sao Tome and Principe,2009,ep,5564,0,0,0
Sao Tome and Principe,2009,ep,65,0,0,0
Sao Tome and Principe,2009,sn,014,0,2,2
Sao Tome and Principe,2009,sn,1524,1,0,1
Sao Tome and Principe,2009,sn,2534,2,2,4
Sao Tome and Principe,2009,sn,3544,3,1,4
Sao Tome and Principe,2009,sn,4554,2,3,5
Sao Tome and Principe,2009,sn,5564,2,1,3
Sao Tome and Principe,2009,sn,65,0,1,1
Sao Tome and Principe,2009,sp,014,1,0,1
Sao Tome and Principe,2009,sp,1524,4,2,6
Sao Tome and Principe,2009,sp,2534,10,10,20
Sao Tome and Principe,2009,sp,3544,4,8,12
Sao Tome and Principe,2009,sp,4554,2,4,6
Sao Tome and Principe,2009,sp,5564,1,6,7
Sao Tome and Principe,2009,sp,65,0,0,0
Sao Tome and Principe,2010,ep,014,1,1,2
Sao Tome and Principe,2010,ep,1524,3,1,4
Sao Tome and Principe,2010,ep,2534,0,2,2
Sao Tome and Principe,2010,ep,3544,1,0,1
Sao Tome and Principe,2010,ep,4554,0,1,1
Sao Tome and Principe,2010,ep,5564,0,0,0
Sao Tome and Principe,2010,ep,65,0,0,0
Sao Tome and Principe,2010,sn,014,2,6,8
Sao Tome and Principe,2010,sn,1524,5,3,8
Sao Tome and Principe,2010,sn,2534,10,11,21
Sao Tome and Principe,2010,sn,3544,3,6,9
Sao Tome and Principe,2010,sn,4554,2,7,9
Sao Tome and Principe,2010,sn,5564,0,2,2
Sao Tome and Principe,2010,sn,65,2,4,6
Sao Tome and Principe,2010,sp,014,0,0,0
Sao Tome and Principe,2010,sp,1524,5,10,15
Sao Tome and Principe,2010,sp,2534,4,14,18
Sao Tome and Principe,2010,sp,3544,3,7,10
Sao Tome and Principe,2010,sp,4554,2,1,3
Sao Tome and Principe,2010,sp,5564,0,0,0
Sao Tome and Principe,2010,sp,65,0,1,1
Sao Tome and Principe,2011,ep,014,1,2,3
Sao Tome and Principe,2011,ep,1524,2,2,4
Sao Tome and Principe,2011,ep,2534,4,4,8
Sao Tome and Principe,2011,ep,3544,0,3,3
Sao Tome and Principe,2011,ep,4554,3,1,4
Sao Tome and Principe,2011,ep,5564,4,0,4
Sao Tome and Principe,2011,ep,65,2,0,2
Sao Tome and Principe,2011,sn,014,0,2,2
Sao Tome and Principe,2011,sn,1524,3,4,7
Sao Tome and Principe,2011,sn,2534,5,2,7
Sao Tome and Principe,2011,sn,3544,5,5,10
Sao Tome and Principe,2011,sn,4554,4,4,8
Sao Tome and Principe,2011,sn,5564,3,2,5
Sao Tome and Principe,2011,sn,65,5,5,10
Sao Tome and Principe,2011,sp,014,2,0,2
Sao Tome and Principe,2011,sp,1524,2,5,7
Sao Tome and Principe,2011,sp,2534,10,9,19
Sao Tome and Principe,2011,sp,3544,4,8,12
Sao Tome and Principe,2011,sp,4554,1,7,8
Sao Tome and Principe,2011,sp,5564,0,1,1
Sao Tome and Principe,2011,sp,65,0,4,4
Sao Tome and Principe,2012,ep,014,2,4,6
Sao Tome and Principe,2012,ep,1524,1,1,2
Sao Tome and Principe,2012,ep,2534,1,2,3
Sao Tome and Principe,2012,ep,3544,0,0,0
Sao Tome and Principe,2012,ep,4554,1,1,2
Sao Tome and Principe,2012,ep,5564,1,0,1
Sao Tome and Principe,2012,ep,65,1,1,2
Sao Tome and Principe,2012,sn,014,4,4,8
Sao Tome and Principe,2012,sn,1524,0,3,3
Sao Tome and Principe,2012,sn,2534,4,4,8
Sao Tome and Principe,2012,sn,3544,4,8,12
Sao Tome and Principe,2012,sn,4554,2,1,3
Sao Tome and Principe,2012,sn,5564,0,1,1
Sao Tome and Principe,2012,sn,65,1,1,2
Sao Tome and Principe,2012,sp,014,0,1,1
Sao Tome and Principe,2012,sp,1524,6,6,12
Sao Tome and Principe,2012,sp,2534,10,11,21
Sao Tome and Principe,2012,sp,3544,6,8,14
Sao Tome and Principe,2012,sp,4554,0,8,8
Sao Tome and Principe,2012,sp,5564,0,2,2
Sao Tome and Principe,2012,sp,65,1,0,1
Sao Tome and Principe,2013,rel,014,9,9,18
Sao Tome and Principe,2013,rel,1524,10,12,22
Sao Tome and Principe,2013,rel,2534,9,14,23
Sao Tome and Principe,2013,rel,3544,15,16,31
Sao Tome and Principe,2013,rel,4554,9,17,26
Sao Tome and Principe,2013,rel,5564,9,4,13
Sao Tome and Principe,2013,rel,65,6,8,14
Saudi Arabia,1998,sp,014,16,2,18
Saudi Arabia,1998,sp,1524,82,76,158
Saudi Arabia,1998,sp,2534,86,140,226
Saudi Arabia,1998,sp,3544,32,96,128
Saudi Arabia,1998,sp,4554,27,65,92
Saudi Arabia,1998,sp,5564,28,45,73
Saudi Arabia,1998,sp,65,40,62,102
Saudi Arabia,1999,sp,014,39,5,44
Saudi Arabia,1999,sp,1524,182,155,337
Saudi Arabia,1999,sp,2534,201,314,515
Saudi Arabia,1999,sp,3544,94,245,339
Saudi Arabia,1999,sp,4554,74,152,226
Saudi Arabia,1999,sp,5564,73,103,176
Saudi Arabia,1999,sp,65,80,143,223
Saudi Arabia,2000,sp,014,28,0,28
Saudi Arabia,2000,sp,1524,172,131,303
Saudi Arabia,2000,sp,2534,182,268,450
Saudi Arabia,2000,sp,3544,79,213,292
Saudi Arabia,2000,sp,4554,51,158,209
Saudi Arabia,2000,sp,5564,50,86,136
Saudi Arabia,2000,sp,65,70,107,177
Saudi Arabia,2001,sp,014,28,7,35
Saudi Arabia,2001,sp,1524,161,141,302
Saudi Arabia,2001,sp,2534,163,221,384
Saudi Arabia,2001,sp,3544,88,163,251
Saudi Arabia,2001,sp,4554,44,135,179
Saudi Arabia,2001,sp,5564,39,62,101
Saudi Arabia,2001,sp,65,44,106,150
Saudi Arabia,2002,sp,014,28,11,39
Saudi Arabia,2002,sp,1524,186,148,334
Saudi Arabia,2002,sp,2534,194,309,503
Saudi Arabia,2002,sp,3544,72,211,283
Saudi Arabia,2002,sp,4554,60,138,198
Saudi Arabia,2002,sp,5564,51,104,155
Saudi Arabia,2002,sp,65,52,110,162
Saudi Arabia,2003,sp,014,18,5,23
Saudi Arabia,2003,sp,1524,210,150,360
Saudi Arabia,2003,sp,2534,181,285,466
Saudi Arabia,2003,sp,3544,75,200,275
Saudi Arabia,2003,sp,4554,58,145,203
Saudi Arabia,2003,sp,5564,51,102,153
Saudi Arabia,2003,sp,65,59,107,166
Saudi Arabia,2004,sp,014,24,4,28
Saudi Arabia,2004,sp,1524,204,202,406
Saudi Arabia,2004,sp,2534,171,289,460
Saudi Arabia,2004,sp,3544,80,217,297
Saudi Arabia,2004,sp,4554,53,163,216
Saudi Arabia,2004,sp,5564,47,89,136
Saudi Arabia,2004,sp,65,64,85,149
Saudi Arabia,2005,sp,014,31,8,39
Saudi Arabia,2005,sp,1524,205,182,387
Saudi Arabia,2005,sp,2534,184,276,460
Saudi Arabia,2005,sp,3544,98,201,299
Saudi Arabia,2005,sp,4554,73,175,248
Saudi Arabia,2005,sp,5564,51,70,121
Saudi Arabia,2005,sp,65,61,107,168
Saudi Arabia,2006,ep,014,71,35,106
Saudi Arabia,2006,ep,1524,123,100,223
Saudi Arabia,2006,ep,2534,187,163,350
Saudi Arabia,2006,ep,3544,85,97,182
Saudi Arabia,2006,ep,4554,37,43,80
Saudi Arabia,2006,ep,5564,33,48,81
Saudi Arabia,2006,ep,65,27,47,74
Saudi Arabia,2006,sn,014,47,39,86
Saudi Arabia,2006,sn,1524,76,67,143
Saudi Arabia,2006,sn,2534,59,91,150
Saudi Arabia,2006,sn,3544,37,51,88
Saudi Arabia,2006,sn,4554,30,41,71
Saudi Arabia,2006,sn,5564,22,29,51
Saudi Arabia,2006,sn,65,25,49,74
Saudi Arabia,2006,sp,014,39,10,49
Saudi Arabia,2006,sp,1524,226,256,482
Saudi Arabia,2006,sp,2534,211,323,534
Saudi Arabia,2006,sp,3544,107,229,336
Saudi Arabia,2006,sp,4554,56,169,225
Saudi Arabia,2006,sp,5564,37,94,131
Saudi Arabia,2006,sp,65,56,101,157
Saudi Arabia,2007,ep,014,50,52,102
Saudi Arabia,2007,ep,1524,130,115,245
Saudi Arabia,2007,ep,2534,218,219,437
Saudi Arabia,2007,ep,3544,86,129,215
Saudi Arabia,2007,ep,4554,60,54,114
Saudi Arabia,2007,ep,5564,40,43,83
Saudi Arabia,2007,ep,65,46,55,101
Saudi Arabia,2007,sn,014,37,34,71
Saudi Arabia,2007,sn,1524,67,45,112
Saudi Arabia,2007,sn,2534,45,61,106
Saudi Arabia,2007,sn,3544,35,46,81
Saudi Arabia,2007,sn,4554,26,41,67
Saudi Arabia,2007,sn,5564,25,25,50
Saudi Arabia,2007,sn,65,42,53,95
Saudi Arabia,2007,sp,014,30,8,38
Saudi Arabia,2007,sp,1524,298,246,544
Saudi Arabia,2007,sp,2534,197,312,509
Saudi Arabia,2007,sp,3544,110,219,329
Saudi Arabia,2007,sp,4554,71,187,258
Saudi Arabia,2007,sp,5564,39,111,150
Saudi Arabia,2007,sp,65,64,92,156
Saudi Arabia,2008,ep,014,60,51,111
Saudi Arabia,2008,ep,1524,127,135,262
Saudi Arabia,2008,ep,2534,193,188,381
Saudi Arabia,2008,ep,3544,98,107,205
Saudi Arabia,2008,ep,4554,67,67,134
Saudi Arabia,2008,ep,5564,33,44,77
Saudi Arabia,2008,ep,65,53,43,96
Saudi Arabia,2008,sn,014,20,22,42
Saudi Arabia,2008,sn,1524,63,75,138
Saudi Arabia,2008,sn,2534,87,52,139
Saudi Arabia,2008,sn,3544,34,22,56
Saudi Arabia,2008,sn,4554,35,13,48
Saudi Arabia,2008,sn,5564,28,17,45
Saudi Arabia,2008,sn,65,50,27,77
Saudi Arabia,2008,sp,014,33,16,49
Saudi Arabia,2008,sp,1524,274,295,569
Saudi Arabia,2008,sp,2534,271,334,605
Saudi Arabia,2008,sp,3544,137,184,321
Saudi Arabia,2008,sp,4554,85,153,238
Saudi Arabia,2008,sp,5564,48,93,141
Saudi Arabia,2008,sp,65,83,102,185
Saudi Arabia,2009,ep,014,46,26,72
Saudi Arabia,2009,ep,1524,136,137,273
Saudi Arabia,2009,ep,2534,160,200,360
Saudi Arabia,2009,ep,3544,102,99,201
Saudi Arabia,2009,ep,4554,54,64,118
Saudi Arabia,2009,ep,5564,28,35,63
Saudi Arabia,2009,ep,65,37,46,83
Saudi Arabia,2009,sn,014,32,27,59
Saudi Arabia,2009,sn,1524,65,65,130
Saudi Arabia,2009,sn,2534,52,98,150
Saudi Arabia,2009,sn,3544,28,39,67
Saudi Arabia,2009,sn,4554,25,31,56
Saudi Arabia,2009,sn,5564,16,27,43
Saudi Arabia,2009,sn,65,31,42,73
Saudi Arabia,2009,sp,014,43,15,58
Saudi Arabia,2009,sp,1524,260,280,540
Saudi Arabia,2009,sp,2534,245,386,631
Saudi Arabia,2009,sp,3544,112,257,369
Saudi Arabia,2009,sp,4554,61,200,261
Saudi Arabia,2009,sp,5564,55,129,184
Saudi Arabia,2009,sp,65,53,105,158
Saudi Arabia,2010,ep,014,38,48,86
Saudi Arabia,2010,ep,1524,115,134,249
Saudi Arabia,2010,ep,2534,178,243,421
Saudi Arabia,2010,ep,3544,111,133,244
Saudi Arabia,2010,ep,4554,58,78,136
Saudi Arabia,2010,ep,5564,35,43,78
Saudi Arabia,2010,ep,65,32,59,91
Saudi Arabia,2010,sn,014,29,19,48
Saudi Arabia,2010,sn,1524,67,90,157
Saudi Arabia,2010,sn,2534,83,112,195
Saudi Arabia,2010,sn,3544,32,47,79
Saudi Arabia,2010,sn,4554,23,45,68
Saudi Arabia,2010,sn,5564,20,38,58
Saudi Arabia,2010,sn,65,34,48,82
Saudi Arabia,2010,sp,014,33,14,47
Saudi Arabia,2010,sp,1524,239,335,574
Saudi Arabia,2010,sp,2534,271,458,729
Saudi Arabia,2010,sp,3544,105,242,347
Saudi Arabia,2010,sp,4554,70,210,280
Saudi Arabia,2010,sp,5564,49,116,165
Saudi Arabia,2010,sp,65,58,102,160
Saudi Arabia,2011,ep,014,43,29,72
Saudi Arabia,2011,ep,1524,97,136,233
Saudi Arabia,2011,ep,2534,170,249,419
Saudi Arabia,2011,ep,3544,98,105,203
Saudi Arabia,2011,ep,4554,49,73,122
Saudi Arabia,2011,ep,5564,40,51,91
Saudi Arabia,2011,ep,65,27,60,87
Saudi Arabia,2011,sn,014,18,13,31
Saudi Arabia,2011,sn,1524,60,74,134
Saudi Arabia,2011,sn,2534,70,83,153
Saudi Arabia,2011,sn,3544,37,63,100
Saudi Arabia,2011,sn,4554,20,35,55
Saudi Arabia,2011,sn,5564,18,26,44
Saudi Arabia,2011,sn,65,34,35,69
Saudi Arabia,2011,sp,014,35,4,39
Saudi Arabia,2011,sp,1524,200,227,427
Saudi Arabia,2011,sp,2534,245,406,651
Saudi Arabia,2011,sp,3544,110,225,335
Saudi Arabia,2011,sp,4554,64,225,289
Saudi Arabia,2011,sp,5564,49,113,162
Saudi Arabia,2011,sp,65,46,106,152
Saudi Arabia,2012,ep,014,26,31,57
Saudi Arabia,2012,ep,1524,70,104,174
Saudi Arabia,2012,ep,2534,123,209,332
Saudi Arabia,2012,ep,3544,78,128,206
Saudi Arabia,2012,ep,4554,43,64,107
Saudi Arabia,2012,ep,5564,31,32,63
Saudi Arabia,2012,ep,65,35,48,83
Saudi Arabia,2012,sn,014,17,13,30
Saudi Arabia,2012,sn,1524,57,63,120
Saudi Arabia,2012,sn,2534,57,88,145
Saudi Arabia,2012,sn,3544,27,51,78
Saudi Arabia,2012,sn,4554,20,30,50
Saudi Arabia,2012,sn,5564,22,34,56
Saudi Arabia,2012,sn,65,24,46,70
Saudi Arabia,2012,sp,014,28,13,41
Saudi Arabia,2012,sp,1524,207,228,435
Saudi Arabia,2012,sp,2534,236,394,630
Saudi Arabia,2012,sp,3544,107,214,321
Saudi Arabia,2012,sp,4554,50,210,260
Saudi Arabia,2012,sp,5564,49,133,182
Saudi Arabia,2012,sp,65,63,96,159
Saudi Arabia,2013,rel,014,63,41,104
Saudi Arabia,2013,rel,1524,298,400,698
Saudi Arabia,2013,rel,2534,388,743,1131
Saudi Arabia,2013,rel,3544,143,399,542
Saudi Arabia,2013,rel,4554,92,317,409
Saudi Arabia,2013,rel,5564,72,204,276
Saudi Arabia,2013,rel,65,98,177,275
Senegal,1995,sp,014,84,94,178
Senegal,1995,sp,1524,428,717,1145
Senegal,1995,sp,2534,461,1219,1680
Senegal,1995,sp,3544,283,813,1096
Senegal,1995,sp,4554,203,408,611
Senegal,1995,sp,5564,126,300,426
Senegal,1995,sp,65,72,213,285
Senegal,1996,sp,014,89,74,163
Senegal,1996,sp,1524,450,773,1223
Senegal,1996,sp,2534,549,1281,1830
Senegal,1996,sp,3544,341,973,1314
Senegal,1996,sp,4554,209,474,683
Senegal,1996,sp,5564,121,277,398
Senegal,1996,sp,65,74,264,338
Senegal,1997,sp,014,75,64,139
Senegal,1997,sp,1524,421,753,1174
Senegal,1997,sp,2534,509,1151,1660
Senegal,1997,sp,3544,292,876,1168
Senegal,1997,sp,4554,191,467,658
Senegal,1997,sp,5564,87,267,354
Senegal,1997,sp,65,62,215,277
Senegal,1998,sp,014,84,90,174
Senegal,1998,sp,1524,412,781,1193
Senegal,1998,sp,2534,447,1208,1655
Senegal,1998,sp,3544,307,856,1163
Senegal,1998,sp,4554,178,453,631
Senegal,1998,sp,5564,98,250,348
Senegal,1998,sp,65,75,215,290
Senegal,1999,sp,014,58,50,108
Senegal,1999,sp,1524,441,721,1162
Senegal,1999,sp,2534,434,1070,1504
Senegal,1999,sp,3544,298,749,1047
Senegal,1999,sp,4554,184,424,608
Senegal,1999,sp,5564,106,233,339
Senegal,1999,sp,65,58,185,243
Senegal,2000,sp,014,77,60,137
Senegal,2000,sp,1524,521,772,1293
Senegal,2000,sp,2534,540,1297,1837
Senegal,2000,sp,3544,376,857,1233
Senegal,2000,sp,4554,217,470,687
Senegal,2000,sp,5564,107,279,386
Senegal,2000,sp,65,61,189,250
Senegal,2001,sp,014,90,77,167
Senegal,2001,sp,1524,540,908,1448
Senegal,2001,sp,2534,531,1331,1862
Senegal,2001,sp,3544,333,890,1223
Senegal,2001,sp,4554,204,498,702
Senegal,2001,sp,5564,113,258,371
Senegal,2001,sp,65,95,226,321
Senegal,2002,sp,014,61,58,119
Senegal,2002,sp,1524,545,815,1360
Senegal,2002,sp,2534,523,1271,1794
Senegal,2002,sp,3544,317,813,1130
Senegal,2002,sp,4554,210,488,698
Senegal,2002,sp,5564,118,279,397
Senegal,2002,sp,65,86,212,298
Senegal,2003,sp,014,77,50,127
Senegal,2003,sp,1524,629,1005,1634
Senegal,2003,sp,2534,600,1438,2038
Senegal,2003,sp,3544,398,896,1294
Senegal,2003,sp,4554,212,531,743
Senegal,2003,sp,5564,122,293,415
Senegal,2003,sp,65,86,250,336
Senegal,2004,sp,014,73,60,133
Senegal,2004,sp,1524,620,1085,1705
Senegal,2004,sp,2534,485,1464,1949
Senegal,2004,sp,3544,324,915,1239
Senegal,2004,sp,4554,211,506,717
Senegal,2004,sp,5564,139,264,403
Senegal,2004,sp,65,78,213,291
Senegal,2005,sp,014,83,71,154
Senegal,2005,sp,1524,709,1050,1759
Senegal,2005,sp,2534,568,1561,2129
Senegal,2005,sp,3544,351,904,1255
Senegal,2005,sp,4554,185,533,718
Senegal,2005,sp,5564,116,274,390
Senegal,2005,sp,65,81,236,317
Senegal,2006,sp,014,74,60,134
Senegal,2006,sp,1524,676,1124,1800
Senegal,2006,sp,2534,572,1606,2178
Senegal,2006,sp,3544,360,919,1279
Senegal,2006,sp,4554,204,553,757
Senegal,2006,sp,5564,124,292,416
Senegal,2006,sp,65,88,230,318
Senegal,2007,ep,014,0,0,0
Senegal,2007,ep,1524,0,0,0
Senegal,2007,ep,2534,0,0,0
Senegal,2007,ep,3544,0,0,0
Senegal,2007,ep,4554,0,0,0
Senegal,2007,ep,5564,0,0,0
Senegal,2007,ep,65,0,0,0
Senegal,2007,sn,014,0,0,0
Senegal,2007,sn,1524,0,0,0
Senegal,2007,sn,2534,0,0,0
Senegal,2007,sn,3544,0,0,0
Senegal,2007,sn,4554,0,0,0
Senegal,2007,sn,5564,0,0,0
Senegal,2007,sn,65,0,0,0
Senegal,2007,sp,014,73,57,130
Senegal,2007,sp,1524,761,1053,1814
Senegal,2007,sp,2534,603,1722,2325
Senegal,2007,sp,3544,378,875,1253
Senegal,2007,sp,4554,241,549,790
Senegal,2007,sp,5564,121,329,450
Senegal,2007,sp,65,95,251,346
Senegal,2008,sp,014,79,67,146
Senegal,2008,sp,1524,816,1274,2090
Senegal,2008,sp,2534,659,1767,2426
Senegal,2008,sp,3544,368,907,1275
Senegal,2008,sp,4554,230,593,823
Senegal,2008,sp,5564,148,351,499
Senegal,2008,sp,65,97,228,325
Senegal,2009,sp,014,108,66,174
Senegal,2009,sp,1524,815,1362,2177
Senegal,2009,sp,2534,660,1790,2450
Senegal,2009,sp,3544,352,1035,1387
Senegal,2009,sp,4554,231,638,869
Senegal,2009,sp,5564,127,335,462
Senegal,2009,sp,65,114,250,364
Senegal,2010,sp,014,81,81,162
Senegal,2010,sp,1524,835,1351,2186
Senegal,2010,sp,2534,643,1793,2436
Senegal,2010,sp,3544,332,972,1304
Senegal,2010,sp,4554,217,590,807
Senegal,2010,sp,5564,136,329,465
Senegal,2010,sp,65,105,221,326
Senegal,2011,sp,014,88,75,163
Senegal,2011,sp,1524,807,1264,2071
Senegal,2011,sp,2534,664,1835,2499
Senegal,2011,sp,3544,362,981,1343
Senegal,2011,sp,4554,208,582,790
Senegal,2011,sp,5564,144,335,479
Senegal,2011,sp,65,74,214,288
Senegal,2012,sp,014,125,84,209
Senegal,2012,sp,1524,836,1454,2290
Senegal,2012,sp,2534,715,2036,2751
Senegal,2012,sp,3544,383,1121,1504
Senegal,2012,sp,4554,263,597,860
Senegal,2012,sp,5564,155,365,520
Senegal,2012,sp,65,90,224,314
Serbia,2005,sp,014,6,3,9
Serbia,2005,sp,1524,69,62,131
Serbia,2005,sp,2534,76,96,172
Serbia,2005,sp,3544,55,118,173
Serbia,2005,sp,4554,49,156,205
Serbia,2005,sp,5564,22,112,134
Serbia,2005,sp,65,149,132,281
Serbia,2006,ep,014,3,4,7
Serbia,2006,ep,1524,14,15,29
Serbia,2006,ep,2534,16,16,32
Serbia,2006,ep,3544,25,26,51
Serbia,2006,ep,4554,23,11,34
Serbia,2006,ep,5564,21,27,48
Serbia,2006,ep,65,43,31,74
Serbia,2006,sn,014,6,2,8
Serbia,2006,sn,1524,23,21,44
Serbia,2006,sn,2534,25,47,72
Serbia,2006,sn,3544,25,54,79
Serbia,2006,sn,4554,48,104,152
Serbia,2006,sn,5564,25,66,91
Serbia,2006,sn,65,129,171,300
Serbia,2006,sp,014,7,6,13
Serbia,2006,sp,1524,78,87,165
Serbia,2006,sp,2534,74,91,165
Serbia,2006,sp,3544,43,107,150
Serbia,2006,sp,4554,44,167,211
Serbia,2006,sp,5564,44,83,127
Serbia,2006,sp,65,152,144,296
Serbia,2007,ep,014,1,6,7
Serbia,2007,ep,1524,9,20,29
Serbia,2007,ep,2534,12,8,20
Serbia,2007,ep,3544,12,13,25
Serbia,2007,ep,4554,22,19,41
Serbia,2007,ep,5564,18,8,26
Serbia,2007,ep,65,36,45,81
Serbia,2007,sn,014,10,9,19
Serbia,2007,sn,1524,17,16,33
Serbia,2007,sn,2534,26,33,59
Serbia,2007,sn,3544,44,42,86
Serbia,2007,sn,4554,27,81,108
Serbia,2007,sn,5564,36,61,97
Serbia,2007,sn,65,120,118,238
Serbia,2007,sp,014,2,0,2
Serbia,2007,sp,1524,38,42,80
Serbia,2007,sp,2534,52,59,111
Serbia,2007,sp,3544,43,102,145
Serbia,2007,sp,4554,43,163,206
Serbia,2007,sp,5564,26,94,120
Serbia,2007,sp,65,135,106,241
Serbia,2008,ep,014,0,2,2
Serbia,2008,ep,1524,12,11,23
Serbia,2008,ep,2534,12,8,20
Serbia,2008,ep,3544,20,17,37
Serbia,2008,ep,4554,13,22,35
Serbia,2008,ep,5564,18,17,35
Serbia,2008,ep,65,30,31,61
Serbia,2008,sn,014,7,9,16
Serbia,2008,sn,1524,20,17,37
Serbia,2008,sn,2534,26,26,52
Serbia,2008,sn,3544,32,25,57
Serbia,2008,sn,4554,32,74,106
Serbia,2008,sn,5564,27,58,85
Serbia,2008,sn,65,82,85,167
Serbia,2008,sp,014,3,3,6
Serbia,2008,sp,1524,68,66,134
Serbia,2008,sp,2534,66,89,155
Serbia,2008,sp,3544,46,111,157
Serbia,2008,sp,4554,51,149,200
Serbia,2008,sp,5564,37,135,172
Serbia,2008,sp,65,169,139,308
Serbia,2009,ep,014,2,4,6
Serbia,2009,ep,1524,13,17,30
Serbia,2009,ep,2534,7,13,20
Serbia,2009,ep,3544,5,14,19
Serbia,2009,ep,4554,17,14,31
Serbia,2009,ep,5564,16,14,30
Serbia,2009,ep,65,34,27,61
Serbia,2009,sn,014,6,7,13
Serbia,2009,sn,1524,22,20,42
Serbia,2009,sn,2534,22,18,40
Serbia,2009,sn,3544,27,34,61
Serbia,2009,sn,4554,23,52,75
Serbia,2009,sn,5564,28,69,97
Serbia,2009,sn,65,65,95,160
Serbia,2009,sp,014,5,1,6
Serbia,2009,sp,1524,63,76,139
Serbia,2009,sp,2534,59,67,126
Serbia,2009,sp,3544,55,111,166
Serbia,2009,sp,4554,38,119,157
Serbia,2009,sp,5564,44,105,149
Serbia,2009,sp,65,167,145,312
Serbia,2010,ep,014,2,0,2
Serbia,2010,ep,1524,12,22,34
Serbia,2010,ep,2534,6,10,16
Serbia,2010,ep,3544,10,13,23
Serbia,2010,ep,4554,12,14,26
Serbia,2010,ep,5564,16,18,34
Serbia,2010,ep,65,42,25,67
Serbia,2010,sn,014,4,6,10
Serbia,2010,sn,1524,15,20,35
Serbia,2010,sn,2534,20,17,37
Serbia,2010,sn,3544,25,42,67
Serbia,2010,sn,4554,18,49,67
Serbia,2010,sn,5564,20,50,70
Serbia,2010,sn,65,71,74,145
Serbia,2010,sp,014,5,2,7
Serbia,2010,sp,1524,66,76,142
Serbia,2010,sp,2534,74,70,144
Serbia,2010,sp,3544,46,93,139
Serbia,2010,sp,4554,39,116,155
Serbia,2010,sp,5564,34,83,117
Serbia,2010,sp,65,164,109,273
Serbia,2011,ep,014,1,1,2
Serbia,2011,ep,1524,9,4,13
Serbia,2011,ep,2534,9,10,19
Serbia,2011,ep,3544,13,6,19
Serbia,2011,ep,4554,9,15,24
Serbia,2011,ep,5564,9,18,27
Serbia,2011,ep,65,32,19,51
Serbia,2011,sn,014,4,6,10
Serbia,2011,sn,1524,16,11,27
Serbia,2011,sn,2534,13,25,38
Serbia,2011,sn,3544,18,23,41
Serbia,2011,sn,4554,21,53,74
Serbia,2011,sn,5564,25,49,74
Serbia,2011,sn,65,70,62,132
Serbia,2011,sp,014,5,2,7
Serbia,2011,sp,1524,46,60,106
Serbia,2011,sp,2534,59,73,132
Serbia,2011,sp,3544,43,74,117
Serbia,2011,sp,4554,30,122,152
Serbia,2011,sp,5564,20,112,132
Serbia,2011,sp,65,129,101,230
Serbia,2012,ep,014,1,2,3
Serbia,2012,ep,1524,6,15,21
Serbia,2012,ep,2534,4,9,13
Serbia,2012,ep,3544,8,9,17
Serbia,2012,ep,4554,5,8,13
Serbia,2012,ep,5564,11,15,26
Serbia,2012,ep,65,23,14,37
Serbia,2012,sn,014,8,4,12
Serbia,2012,sn,1524,12,14,26
Serbia,2012,sn,2534,20,20,40
Serbia,2012,sn,3544,21,25,46
Serbia,2012,sn,4554,15,47,62
Serbia,2012,sn,5564,19,49,68
Serbia,2012,sn,65,58,71,129
Serbia,2012,sp,014,4,1,5
Serbia,2012,sp,1524,46,70,116
Serbia,2012,sp,2534,66,72,138
Serbia,2012,sp,3544,38,77,115
Serbia,2012,sp,4554,31,98,129
Serbia,2012,sp,5564,35,86,121
Serbia,2012,sp,65,118,77,195
Serbia,2013,rel,014,9,5,14
Serbia,2013,rel,1524,46,43,89
Serbia,2013,rel,2534,63,66,129
Serbia,2013,rel,3544,60,99,159
Serbia,2013,rel,4554,53,134,187
Serbia,2013,rel,5564,45,161,206
Serbia,2013,rel,65,170,207,377
Serbia & Montenegro,1995,sp,014,11,10,21
Serbia & Montenegro,1995,sp,1524,127,108,235
Serbia & Montenegro,1995,sp,2534,167,204,371
Serbia & Montenegro,1995,sp,3544,133,317,450
Serbia & Montenegro,1995,sp,4554,83,296,379
Serbia & Montenegro,1995,sp,5564,158,350,508
Serbia & Montenegro,1995,sp,65,275,386,661
Serbia & Montenegro,1996,sp,014,57,45,102
Serbia & Montenegro,1996,sp,1524,192,207,399
Serbia & Montenegro,1996,sp,2534,159,310,469
Serbia & Montenegro,1996,sp,3544,183,461,644
Serbia & Montenegro,1996,sp,4554,152,396,548
Serbia & Montenegro,1996,sp,5564,217,389,606
Serbia & Montenegro,1996,sp,65,384,474,858
Serbia & Montenegro,1997,sp,014,30,45,75
Serbia & Montenegro,1997,sp,1524,146,136,282
Serbia & Montenegro,1997,sp,2534,274,310,584
Serbia & Montenegro,1997,sp,3544,254,450,704
Serbia & Montenegro,1997,sp,4554,170,415,585
Serbia & Montenegro,1997,sp,5564,239,410,649
Serbia & Montenegro,1997,sp,65,399,463,862
Serbia & Montenegro,2001,sp,014,5,3,8
Serbia & Montenegro,2001,sp,1524,49,52,101
Serbia & Montenegro,2001,sp,2534,46,48,94
Serbia & Montenegro,2001,sp,3544,23,44,67
Serbia & Montenegro,2001,sp,4554,25,34,59
Serbia & Montenegro,2001,sp,5564,23,31,54
Serbia & Montenegro,2001,sp,65,20,18,38
Serbia & Montenegro,2002,sp,014,9,7,16
Serbia & Montenegro,2002,sp,1524,46,37,83
Serbia & Montenegro,2002,sp,2534,48,53,101
Serbia & Montenegro,2002,sp,3544,19,44,63
Serbia & Montenegro,2002,sp,4554,17,29,46
Serbia & Montenegro,2002,sp,5564,19,22,41
Serbia & Montenegro,2002,sp,65,19,33,52
Serbia & Montenegro,2003,sp,014,1,1,2
Serbia & Montenegro,2003,sp,1524,44,51,95
Serbia & Montenegro,2003,sp,2534,58,64,122
Serbia & Montenegro,2003,sp,3544,38,70,108
Serbia & Montenegro,2003,sp,4554,28,113,141
Serbia & Montenegro,2003,sp,5564,20,54,74
Serbia & Montenegro,2003,sp,65,54,61,115
Serbia & Montenegro,2004,sp,014,3,4,7
Serbia & Montenegro,2004,sp,1524,66,61,127
Serbia & Montenegro,2004,sp,2534,89,106,195
Serbia & Montenegro,2004,sp,3544,75,125,200
Serbia & Montenegro,2004,sp,4554,48,182,230
Serbia & Montenegro,2004,sp,5564,41,128,169
Serbia & Montenegro,2004,sp,65,145,157,302
Seychelles,1995,sp,014,0,0,0
Seychelles,1995,sp,1524,0,2,2
Seychelles,1995,sp,2534,1,0,1
Seychelles,1995,sp,3544,0,1,1
Seychelles,1995,sp,4554,0,1,1
Seychelles,1995,sp,5564,0,2,2
Seychelles,1995,sp,65,1,1,2
Seychelles,1996,sp,014,0,0,0
Seychelles,1996,sp,1524,1,0,1
Seychelles,1996,sp,2534,0,1,1
Seychelles,1996,sp,3544,0,3,3
Seychelles,1996,sp,4554,0,1,1
Seychelles,1996,sp,5564,1,1,2
Seychelles,1996,sp,65,1,0,1
Seychelles,1997,sp,014,0,0,0
Seychelles,1997,sp,1524,1,1,2
Seychelles,1997,sp,2534,0,2,2
Seychelles,1997,sp,3544,0,2,2
Seychelles,1997,sp,4554,0,1,1
Seychelles,1997,sp,5564,1,1,2
Seychelles,1997,sp,65,1,1,2
Seychelles,1998,sp,014,0,0,0
Seychelles,1998,sp,1524,0,0,0
Seychelles,1998,sp,2534,0,1,1
Seychelles,1998,sp,3544,1,3,4
Seychelles,1998,sp,4554,0,2,2
Seychelles,1998,sp,5564,1,1,2
Seychelles,1998,sp,65,0,1,1
Seychelles,2000,sp,2534,1,2,3
Seychelles,2000,sp,3544,0,4,4
Seychelles,2000,sp,4554,1,1,2
Seychelles,2000,sp,5564,1,1,2
Seychelles,2001,sp,014,0,0,0
Seychelles,2001,sp,1524,0,0,0
Seychelles,2001,sp,2534,2,2,4
Seychelles,2001,sp,3544,0,4,4
Seychelles,2001,sp,4554,1,0,1
Seychelles,2001,sp,5564,0,2,2
Seychelles,2001,sp,65,1,2,3
Seychelles,2002,sp,014,0,0,0
Seychelles,2002,sp,1524,0,1,1
Seychelles,2002,sp,2534,0,3,3
Seychelles,2002,sp,3544,0,1,1
Seychelles,2002,sp,4554,0,0,0
Seychelles,2002,sp,5564,0,1,1
Seychelles,2002,sp,65,2,1,3
Seychelles,2003,sp,014,0,0,0
Seychelles,2003,sp,1524,0,1,1
Seychelles,2003,sp,2534,0,0,0
Seychelles,2003,sp,3544,0,0,0
Seychelles,2003,sp,4554,0,1,1
Seychelles,2003,sp,5564,0,2,2
Seychelles,2003,sp,65,0,0,0
Seychelles,2004,sp,014,0,0,0
Seychelles,2004,sp,1524,0,0,0
Seychelles,2004,sp,2534,1,2,3
Seychelles,2004,sp,3544,2,0,2
Seychelles,2004,sp,4554,2,3,5
Seychelles,2004,sp,5564,1,2,3
Seychelles,2004,sp,65,0,0,0
Seychelles,2005,sp,014,0,0,0
Seychelles,2005,sp,1524,0,2,2
Seychelles,2005,sp,2534,1,1,2
Seychelles,2005,sp,3544,1,2,3
Seychelles,2005,sp,4554,0,1,1
Seychelles,2005,sp,5564,0,0,0
Seychelles,2005,sp,65,0,0,0
Seychelles,2008,ep,014,0,0,0
Seychelles,2008,ep,1524,0,0,0
Seychelles,2008,ep,2534,0,0,0
Seychelles,2008,ep,3544,0,0,0
Seychelles,2008,ep,4554,0,2,2
Seychelles,2008,ep,5564,0,0,0
Seychelles,2008,ep,65,0,0,0
Seychelles,2008,sn,014,0,0,0
Seychelles,2008,sn,1524,0,0,0
Seychelles,2008,sn,2534,0,0,0
Seychelles,2008,sn,3544,0,0,0
Seychelles,2008,sn,4554,0,0,0
Seychelles,2008,sn,5564,0,0,0
Seychelles,2008,sn,65,0,0,0
Seychelles,2008,sp,014,0,0,0
Seychelles,2008,sp,1524,0,0,0
Seychelles,2008,sp,2534,0,1,1
Seychelles,2008,sp,3544,0,0,0
Seychelles,2008,sp,4554,0,1,1
Seychelles,2008,sp,5564,0,0,0
Seychelles,2008,sp,65,0,2,2
Seychelles,2009,ep,014,0,0,0
Seychelles,2009,ep,1524,0,0,0
Seychelles,2009,ep,2534,0,0,0
Seychelles,2009,ep,3544,0,2,2
Seychelles,2009,ep,4554,0,0,0
Seychelles,2009,ep,5564,0,0,0
Seychelles,2009,ep,65,0,0,0
Seychelles,2009,sn,014,0,0,0
Seychelles,2009,sn,1524,0,0,0
Seychelles,2009,sn,2534,0,0,0
Seychelles,2009,sn,3544,0,1,1
Seychelles,2009,sn,4554,0,0,0
Seychelles,2009,sn,5564,0,1,1
Seychelles,2009,sn,65,0,0,0
Seychelles,2009,sp,014,0,0,0
Seychelles,2009,sp,1524,0,0,0
Seychelles,2009,sp,2534,1,4,5
Seychelles,2009,sp,3544,0,1,1
Seychelles,2009,sp,4554,1,1,2
Seychelles,2009,sp,5564,0,1,1
Seychelles,2009,sp,65,0,2,2
Seychelles,2010,ep,014,0,0,0
Seychelles,2010,ep,1524,0,0,0
Seychelles,2010,ep,2534,0,0,0
Seychelles,2010,ep,3544,0,0,0
Seychelles,2010,ep,4554,0,0,0
Seychelles,2010,ep,5564,0,0,0
Seychelles,2010,ep,65,0,0,0
Seychelles,2010,sn,014,0,0,0
Seychelles,2010,sn,1524,0,0,0
Seychelles,2010,sn,2534,0,3,3
Seychelles,2010,sn,3544,0,0,0
Seychelles,2010,sn,4554,0,1,1
Seychelles,2010,sn,5564,1,1,2
Seychelles,2010,sn,65,0,2,2
Seychelles,2010,sp,014,0,0,0
Seychelles,2010,sp,1524,2,0,2
Seychelles,2010,sp,2534,0,0,0
Seychelles,2010,sp,3544,0,6,6
Seychelles,2010,sp,4554,0,0,0
Seychelles,2010,sp,5564,0,0,0
Seychelles,2010,sp,65,0,1,1
Seychelles,2011,ep,014,0,0,0
Seychelles,2011,ep,1524,0,0,0
Seychelles,2011,ep,2534,0,2,2
Seychelles,2011,ep,3544,0,1,1
Seychelles,2011,ep,4554,0,0,0
Seychelles,2011,ep,5564,0,2,2
Seychelles,2011,ep,65,0,0,0
Seychelles,2011,sn,014,0,0,0
Seychelles,2011,sn,1524,0,1,1
Seychelles,2011,sn,2534,0,2,2
Seychelles,2011,sn,3544,1,4,5
Seychelles,2011,sn,4554,0,13,13
Seychelles,2011,sn,5564,1,2,3
Seychelles,2011,sn,65,0,0,0
Seychelles,2011,sp,014,0,0,0
Seychelles,2011,sp,1524,1,0,1
Seychelles,2011,sp,2534,0,1,1
Seychelles,2011,sp,3544,0,0,0
Seychelles,2011,sp,4554,0,0,0
Seychelles,2011,sp,5564,0,0,0
Seychelles,2011,sp,65,0,0,0
Seychelles,2012,ep,014,0,0,0
Seychelles,2012,ep,1524,0,1,1
Seychelles,2012,ep,2534,0,0,0
Seychelles,2012,ep,3544,0,0,0
Seychelles,2012,ep,4554,1,0,1
Seychelles,2012,ep,5564,0,0,0
Seychelles,2012,ep,65,0,0,0
Seychelles,2012,sn,014,0,0,0
Seychelles,2012,sn,1524,0,1,1
Seychelles,2012,sn,2534,0,0,0
Seychelles,2012,sn,3544,0,1,1
Seychelles,2012,sn,4554,1,1,2
Seychelles,2012,sn,5564,1,1,2
Seychelles,2012,sn,65,2,0,2
Seychelles,2012,sp,014,0,0,0
Seychelles,2012,sp,1524,0,0,0
Seychelles,2012,sp,2534,1,1,2
Seychelles,2012,sp,3544,1,2,3
Seychelles,2012,sp,4554,1,2,3
Seychelles,2012,sp,5564,0,0,0
Seychelles,2012,sp,65,1,0,1
Seychelles,2013,rel,014,0,0,0
Seychelles,2013,rel,1524,2,0,2
Seychelles,2013,rel,2534,1,5,6
Seychelles,2013,rel,3544,1,3,4
Seychelles,2013,rel,4554,0,3,3
Seychelles,2013,rel,5564,1,5,6
Seychelles,2013,rel,65,2,1,3
Sierra Leone,1995,sp,014,18,10,28
Sierra Leone,1995,sp,1524,165,184,349
Sierra Leone,1995,sp,2534,193,305,498
Sierra Leone,1995,sp,3544,110,201,311
Sierra Leone,1995,sp,4554,65,99,164
Sierra Leone,1995,sp,5564,24,47,71
Sierra Leone,1995,sp,65,11,22,33
Sierra Leone,1996,sp,014,35,23,58
Sierra Leone,1996,sp,1524,201,249,450
Sierra Leone,1996,sp,2534,278,450,728
Sierra Leone,1996,sp,3544,218,310,528
Sierra Leone,1996,sp,4554,89,180,269
Sierra Leone,1996,sp,5564,49,79,128
Sierra Leone,1996,sp,65,22,51,73
Sierra Leone,1997,sp,014,21,14,35
Sierra Leone,1997,sp,1524,207,230,437
Sierra Leone,1997,sp,2534,328,470,798
Sierra Leone,1997,sp,3544,228,359,587
Sierra Leone,1997,sp,4554,67,182,249
Sierra Leone,1997,sp,5564,39,89,128
Sierra Leone,1997,sp,65,15,47,62
Sierra Leone,1998,sp,014,36,14,50
Sierra Leone,1998,sp,1524,235,226,461
Sierra Leone,1998,sp,2534,294,445,739
Sierra Leone,1998,sp,3544,217,338,555
Sierra Leone,1998,sp,4554,86,191,277
Sierra Leone,1998,sp,5564,43,78,121
Sierra Leone,1998,sp,65,17,42,59
Sierra Leone,2000,sp,014,27,18,45
Sierra Leone,2000,sp,1524,249,287,536
Sierra Leone,2000,sp,2534,298,486,784
Sierra Leone,2000,sp,3544,225,361,586
Sierra Leone,2000,sp,4554,92,190,282
Sierra Leone,2000,sp,5564,49,113,162
Sierra Leone,2000,sp,65,30,47,77
Sierra Leone,2001,sp,014,36,19,55
Sierra Leone,2001,sp,1524,279,268,547
Sierra Leone,2001,sp,2534,292,546,838
Sierra Leone,2001,sp,3544,234,406,640
Sierra Leone,2001,sp,4554,120,230,350
Sierra Leone,2001,sp,5564,61,123,184
Sierra Leone,2001,sp,65,27,51,78
Sierra Leone,2002,sp,014,31,23,54
Sierra Leone,2002,sp,1524,300,317,617
Sierra Leone,2002,sp,2534,382,561,943
Sierra Leone,2002,sp,3544,284,427,711
Sierra Leone,2002,sp,4554,133,246,379
Sierra Leone,2002,sp,5564,48,102,150
Sierra Leone,2002,sp,65,26,58,84
Sierra Leone,2003,sp,014,26,19,45
Sierra Leone,2003,sp,1524,308,351,659
Sierra Leone,2003,sp,2534,394,564,958
Sierra Leone,2003,sp,3544,249,481,730
Sierra Leone,2003,sp,4554,122,264,386
Sierra Leone,2003,sp,5564,77,149,226
Sierra Leone,2003,sp,65,32,77,109
Sierra Leone,2004,sp,014,40,19,59
Sierra Leone,2004,sp,1524,304,417,721
Sierra Leone,2004,sp,2534,440,659,1099
Sierra Leone,2004,sp,3544,319,581,900
Sierra Leone,2004,sp,4554,170,364,534
Sierra Leone,2004,sp,5564,89,153,242
Sierra Leone,2004,sp,65,50,130,180
Sierra Leone,2005,sp,014,54,45,99
Sierra Leone,2005,sp,1524,393,490,883
Sierra Leone,2005,sp,2534,518,792,1310
Sierra Leone,2005,sp,3544,312,651,963
Sierra Leone,2005,sp,4554,207,397,604
Sierra Leone,2005,sp,5564,114,226,340
Sierra Leone,2005,sp,65,47,124,171
Sierra Leone,2006,sp,014,68,43,111
Sierra Leone,2006,sp,1524,375,485,860
Sierra Leone,2006,sp,2534,536,851,1387
Sierra Leone,2006,sp,3544,357,709,1066
Sierra Leone,2006,sp,4554,207,446,653
Sierra Leone,2006,sp,5564,111,216,327
Sierra Leone,2006,sp,65,59,166,225
Sierra Leone,2007,ep,014,NA,337,NA
Sierra Leone,2007,ep,1524,NA,369,NA
Sierra Leone,2007,sn,014,NA,1081,NA
Sierra Leone,2007,sn,1524,NA,2116,NA
Sierra Leone,2007,sp,014,74,45,119
Sierra Leone,2007,sp,1524,398,538,936
Sierra Leone,2007,sp,2534,568,1032,1600
Sierra Leone,2007,sp,3544,468,797,1265
Sierra Leone,2007,sp,4554,255,520,775
Sierra Leone,2007,sp,5564,143,258,401
Sierra Leone,2007,sp,65,79,172,251
Sierra Leone,2008,sp,1524,460,625,1085
Sierra Leone,2008,sp,2534,609,1062,1671
Sierra Leone,2008,sp,3544,501,938,1439
Sierra Leone,2008,sp,4554,269,573,842
Sierra Leone,2008,sp,5564,153,265,418
Sierra Leone,2008,sp,65,83,188,271
Sierra Leone,2009,sp,014,66,44,110
Sierra Leone,2009,sp,1524,524,737,1261
Sierra Leone,2009,sp,2534,645,1073,1718
Sierra Leone,2009,sp,3544,506,905,1411
Sierra Leone,2009,sp,4554,260,621,881
Sierra Leone,2009,sp,5564,146,280,426
Sierra Leone,2009,sp,65,90,195,285
Sierra Leone,2010,sp,014,77,64,141
Sierra Leone,2010,sp,1524,648,718,1366
Sierra Leone,2010,sp,2534,742,1176,1918
Sierra Leone,2010,sp,3544,556,1076,1632
Sierra Leone,2010,sp,4554,293,663,956
Sierra Leone,2010,sp,5564,180,320,500
Sierra Leone,2010,sp,65,131,254,385
Sierra Leone,2011,sp,014,115,75,190
Sierra Leone,2011,sp,1524,678,825,1503
Sierra Leone,2011,sp,2534,796,1224,2020
Sierra Leone,2011,sp,3544,543,1099,1642
Sierra Leone,2011,sp,4554,343,781,1124
Sierra Leone,2011,sp,5564,219,334,553
Sierra Leone,2011,sp,65,116,287,403
Sierra Leone,2012,ep,014,103,112,215
Sierra Leone,2012,sn,014,634,811,1445
Sierra Leone,2012,sp,014,80,70,150
Sierra Leone,2012,sp,1524,703,858,1561
Sierra Leone,2012,sp,2534,861,1324,2185
Sierra Leone,2012,sp,3544,667,1213,1880
Sierra Leone,2012,sp,4554,391,841,1232
Sierra Leone,2012,sp,5564,201,416,617
Sierra Leone,2012,sp,65,132,274,406
Sierra Leone,2013,rel,014,52,51,103
Sierra Leone,2013,rel,1524,618,810,1428
Sierra Leone,2013,rel,2534,785,1231,2016
Sierra Leone,2013,rel,3544,618,1109,1727
Sierra Leone,2013,rel,4554,351,791,1142
Sierra Leone,2013,rel,5564,229,384,613
Sierra Leone,2013,rel,65,128,233,361
Singapore,1995,sp,014,1,0,1
Singapore,1995,sp,1524,8,9,17
Singapore,1995,sp,2534,18,40,58
Singapore,1995,sp,3544,21,60,81
Singapore,1995,sp,4554,22,62,84
Singapore,1995,sp,5564,19,70,89
Singapore,1995,sp,65,31,94,125
Singapore,1997,sp,014,0,0,0
Singapore,1997,sp,1524,11,8,19
Singapore,1997,sp,2534,16,27,43
Singapore,1997,sp,3544,12,49,61
Singapore,1997,sp,4554,16,60,76
Singapore,1997,sp,5564,12,88,100
Singapore,1997,sp,65,32,101,133
Singapore,1998,sp,014,2,1,3
Singapore,1998,sp,1524,6,9,15
Singapore,1998,sp,2534,18,36,54
Singapore,1998,sp,3544,11,70,81
Singapore,1998,sp,4554,20,63,83
Singapore,1998,sp,5564,25,81,106
Singapore,1998,sp,65,34,104,138
Singapore,1999,sp,014,0,0,0
Singapore,1999,sp,1524,12,18,30
Singapore,1999,sp,2534,21,23,44
Singapore,1999,sp,3544,18,41,59
Singapore,1999,sp,4554,23,72,95
Singapore,1999,sp,5564,17,55,72
Singapore,1999,sp,65,29,124,153
Singapore,2000,sp,014,1,1,2
Singapore,2000,sp,1524,9,8,17
Singapore,2000,sp,2534,8,9,17
Singapore,2000,sp,3544,7,34,41
Singapore,2000,sp,4554,9,51,60
Singapore,2000,sp,5564,5,26,31
Singapore,2000,sp,65,16,64,80
Singapore,2001,sp,014,1,1,2
Singapore,2001,sp,1524,5,6,11
Singapore,2001,sp,2534,7,19,26
Singapore,2001,sp,3544,19,39,58
Singapore,2001,sp,4554,15,70,85
Singapore,2001,sp,5564,9,66,75
Singapore,2001,sp,65,24,76,100
Singapore,2002,sp,014,2,0,2
Singapore,2002,sp,1524,10,14,24
Singapore,2002,sp,2534,15,28,43
Singapore,2002,sp,3544,30,73,103
Singapore,2002,sp,4554,32,88,120
Singapore,2002,sp,5564,24,65,89
Singapore,2002,sp,65,38,130,168
Singapore,2003,sp,014,0,1,1
Singapore,2003,sp,1524,6,17,23
Singapore,2003,sp,2534,26,28,54
Singapore,2003,sp,3544,30,68,98
Singapore,2003,sp,4554,20,96,116
Singapore,2003,sp,5564,20,80,100
Singapore,2003,sp,65,58,133,191
Singapore,2004,sp,014,0,1,1
Singapore,2004,sp,1524,6,12,18
Singapore,2004,sp,2534,15,32,47
Singapore,2004,sp,3544,18,56,74
Singapore,2004,sp,4554,17,83,100
Singapore,2004,sp,5564,19,75,94
Singapore,2004,sp,65,48,119,167
Singapore,2005,sp,014,0,0,0
Singapore,2005,sp,1524,5,8,13
Singapore,2005,sp,2534,20,25,45
Singapore,2005,sp,3544,33,61,94
Singapore,2005,sp,4554,29,94,123
Singapore,2005,sp,5564,20,96,116
Singapore,2005,sp,65,43,118,161
Singapore,2006,ep,014,5,10,15
Singapore,2006,ep,1524,8,5,13
Singapore,2006,ep,2534,10,13,23
Singapore,2006,ep,3544,14,22,36
Singapore,2006,ep,4554,17,12,29
Singapore,2006,ep,5564,16,13,29
Singapore,2006,ep,65,13,25,38
Singapore,2006,sn,014,7,3,10
Singapore,2006,sn,1524,16,21,37
Singapore,2006,sn,2534,33,35,68
Singapore,2006,sn,3544,31,42,73
Singapore,2006,sn,4554,13,56,69
Singapore,2006,sn,5564,20,69,89
Singapore,2006,sn,65,42,137,179
Singapore,2006,sp,014,0,2,2
Singapore,2006,sp,1524,19,7,26
Singapore,2006,sp,2534,22,31,53
Singapore,2006,sp,3544,22,67,89
Singapore,2006,sp,4554,22,107,129
Singapore,2006,sp,5564,27,75,102
Singapore,2006,sp,65,31,106,137
Singapore,2007,ep,014,1,1,2
Singapore,2007,ep,1524,8,10,18
Singapore,2007,ep,2534,18,11,29
Singapore,2007,ep,3544,14,18,32
Singapore,2007,ep,4554,14,14,28
Singapore,2007,ep,5564,18,22,40
Singapore,2007,ep,65,11,21,32
Singapore,2007,sn,014,7,2,9
Singapore,2007,sn,1524,32,29,61
Singapore,2007,sn,2534,29,38,67
Singapore,2007,sn,3544,17,50,67
Singapore,2007,sn,4554,29,69,98
Singapore,2007,sn,5564,21,53,74
Singapore,2007,sn,65,58,130,188
Singapore,2007,sp,014,1,0,1
Singapore,2007,sp,1524,13,15,28
Singapore,2007,sp,2534,13,18,31
Singapore,2007,sp,3544,25,63,88
Singapore,2007,sp,4554,23,98,121
Singapore,2007,sp,5564,11,80,91
Singapore,2007,sp,65,39,105,144
Singapore,2008,ep,014,3,3,6
Singapore,2008,ep,1524,10,12,22
Singapore,2008,ep,2534,15,18,33
Singapore,2008,ep,3544,20,20,40
Singapore,2008,ep,4554,19,23,42
Singapore,2008,ep,5564,20,16,36
Singapore,2008,ep,65,30,31,61
Singapore,2008,sn,014,1,1,2
Singapore,2008,sn,1524,25,45,70
Singapore,2008,sn,2534,35,42,77
Singapore,2008,sn,3544,24,64,88
Singapore,2008,sn,4554,21,88,109
Singapore,2008,sn,5564,29,74,103
Singapore,2008,sn,65,50,173,223
Singapore,2008,sp,014,0,0,0
Singapore,2008,sp,1524,9,10,19
Singapore,2008,sp,2534,16,21,37
Singapore,2008,sp,3544,20,46,66
Singapore,2008,sp,4554,26,106,132
Singapore,2008,sp,5564,17,94,111
Singapore,2008,sp,65,33,127,160
Singapore,2009,ep,014,4,3,7
Singapore,2009,ep,1524,7,9,16
Singapore,2009,ep,2534,23,13,36
Singapore,2009,ep,3544,17,28,45
Singapore,2009,ep,4554,19,28,47
Singapore,2009,ep,5564,20,13,33
Singapore,2009,ep,65,21,30,51
Singapore,2009,sn,014,5,5,10
Singapore,2009,sn,1524,17,31,48
Singapore,2009,sn,2534,35,33,68
Singapore,2009,sn,3544,23,63,86
Singapore,2009,sn,4554,27,99,126
Singapore,2009,sn,5564,23,112,135
Singapore,2009,sn,65,31,151,182
Singapore,2009,sp,014,0,0,0
Singapore,2009,sp,1524,15,16,31
Singapore,2009,sp,2534,22,27,49
Singapore,2009,sp,3544,24,56,80
Singapore,2009,sp,4554,18,100,118
Singapore,2009,sp,5564,23,92,115
Singapore,2009,sp,65,28,131,159
Singapore,2010,ep,014,2,2,4
Singapore,2010,ep,1524,7,8,15
Singapore,2010,ep,2534,11,13,24
Singapore,2010,ep,3544,15,17,32
Singapore,2010,ep,4554,19,18,37
Singapore,2010,ep,5564,14,32,46
Singapore,2010,ep,65,22,33,55
Singapore,2010,sn,014,10,5,15
Singapore,2010,sn,1524,22,35,57
Singapore,2010,sn,2534,60,46,106
Singapore,2010,sn,3544,25,61,86
Singapore,2010,sn,4554,43,87,130
Singapore,2010,sn,5564,28,102,130
Singapore,2010,sn,65,55,156,211
Singapore,2010,sp,014,1,0,1
Singapore,2010,sp,1524,15,11,26
Singapore,2010,sp,2534,21,21,42
Singapore,2010,sp,3544,26,38,64
Singapore,2010,sp,4554,21,105,126
Singapore,2010,sp,5564,21,86,107
Singapore,2010,sp,65,44,120,164
Singapore,2011,ep,014,3,0,3
Singapore,2011,ep,1524,13,7,20
Singapore,2011,ep,2534,14,21,35
Singapore,2011,ep,3544,19,22,41
Singapore,2011,ep,4554,21,25,46
Singapore,2011,ep,5564,13,17,30
Singapore,2011,ep,65,20,29,49
Singapore,2011,sn,014,4,2,6
Singapore,2011,sn,1524,26,28,54
Singapore,2011,sn,2534,29,49,78
Singapore,2011,sn,3544,34,64,98
Singapore,2011,sn,4554,29,112,141
Singapore,2011,sn,5564,35,102,137
Singapore,2011,sn,65,53,150,203
Singapore,2011,sp,014,0,0,0
Singapore,2011,sp,1524,11,21,32
Singapore,2011,sp,2534,25,21,46
Singapore,2011,sp,3544,23,44,67
Singapore,2011,sp,4554,23,108,131
Singapore,2011,sp,5564,20,119,139
Singapore,2011,sp,65,51,126,177
Singapore,2012,ep,014,1,1,2
Singapore,2012,ep,1524,16,25,41
Singapore,2012,ep,2534,53,37,90
Singapore,2012,ep,3544,18,33,51
Singapore,2012,ep,4554,22,18,40
Singapore,2012,ep,5564,16,15,31
Singapore,2012,ep,65,20,31,51
Singapore,2012,sn,014,5,1,6
Singapore,2012,sn,1524,45,76,121
Singapore,2012,sn,2534,196,144,340
Singapore,2012,sn,3544,82,124,206
Singapore,2012,sn,4554,46,130,176
Singapore,2012,sn,5564,44,125,169
Singapore,2012,sn,65,45,156,201
Singapore,2012,sp,014,0,1,1
Singapore,2012,sp,1524,26,31,57
Singapore,2012,sp,2534,46,36,82
Singapore,2012,sp,3544,27,54,81
Singapore,2012,sp,4554,26,106,132
Singapore,2012,sp,5564,19,124,143
Singapore,2012,sp,65,39,143,182
Singapore,2013,rel,014,4,8,12
Singapore,2013,rel,1524,85,99,184
Singapore,2013,rel,2534,289,199,488
Singapore,2013,rel,3544,143,201,344
Singapore,2013,rel,4554,64,256,320
Singapore,2013,rel,5564,72,262,334
Singapore,2013,rel,65,130,352,482
Sint Maarten (Dutch part),2010,ep,014,0,0,0
Sint Maarten (Dutch part),2010,ep,1524,0,0,0
Sint Maarten (Dutch part),2010,ep,2534,0,0,0
Sint Maarten (Dutch part),2010,ep,3544,0,0,0
Sint Maarten (Dutch part),2010,ep,4554,0,0,0
Sint Maarten (Dutch part),2010,ep,5564,0,0,0
Sint Maarten (Dutch part),2010,ep,65,0,0,0
Sint Maarten (Dutch part),2010,sn,014,0,0,0
Sint Maarten (Dutch part),2010,sn,1524,0,0,0
Sint Maarten (Dutch part),2010,sn,2534,0,0,0
Sint Maarten (Dutch part),2010,sn,3544,0,0,0
Sint Maarten (Dutch part),2010,sn,4554,0,0,0
Sint Maarten (Dutch part),2010,sn,5564,0,0,0
Sint Maarten (Dutch part),2010,sn,65,0,0,0
Sint Maarten (Dutch part),2010,sp,2534,NA,1,NA
Sint Maarten (Dutch part),2010,sp,4554,2,NA,NA
Sint Maarten (Dutch part),2011,sp,1524,NA,1,NA
Sint Maarten (Dutch part),2011,sp,2534,1,NA,NA
Sint Maarten (Dutch part),2012,ep,014,0,0,0
Sint Maarten (Dutch part),2012,ep,1524,0,0,0
Sint Maarten (Dutch part),2012,ep,2534,0,0,0
Sint Maarten (Dutch part),2012,ep,3544,0,0,0
Sint Maarten (Dutch part),2012,ep,4554,0,0,0
Sint Maarten (Dutch part),2012,ep,5564,0,0,0
Sint Maarten (Dutch part),2012,ep,65,0,0,0
Sint Maarten (Dutch part),2012,sn,014,0,0,0
Sint Maarten (Dutch part),2012,sn,1524,1,0,1
Sint Maarten (Dutch part),2012,sn,2534,0,0,0
Sint Maarten (Dutch part),2012,sn,3544,0,0,0
Sint Maarten (Dutch part),2012,sn,4554,0,0,0
Sint Maarten (Dutch part),2012,sn,5564,0,0,0
Sint Maarten (Dutch part),2012,sn,65,0,0,0
Sint Maarten (Dutch part),2012,sp,014,0,0,0
Sint Maarten (Dutch part),2012,sp,1524,1,0,1
Sint Maarten (Dutch part),2012,sp,2534,0,0,0
Sint Maarten (Dutch part),2012,sp,3544,0,0,0
Sint Maarten (Dutch part),2012,sp,4554,0,0,0
Sint Maarten (Dutch part),2012,sp,5564,0,0,0
Sint Maarten (Dutch part),2012,sp,65,0,0,0
Sint Maarten (Dutch part),2013,rel,3544,NA,1,NA
Sint Maarten (Dutch part),2013,rel,65,1,NA,NA
Slovakia,1995,sp,014,5,4,9
Slovakia,1995,sp,1524,16,18,34
Slovakia,1995,sp,2534,17,44,61
Slovakia,1995,sp,3544,22,123,145
Slovakia,1995,sp,4554,24,108,132
Slovakia,1995,sp,5564,33,63,96
Slovakia,1995,sp,65,159,152,311
Slovakia,1996,sp,014,4,2,6
Slovakia,1996,sp,1524,23,16,39
Slovakia,1996,sp,2534,28,42,70
Slovakia,1996,sp,3544,24,64,88
Slovakia,1996,sp,4554,17,105,122
Slovakia,1996,sp,5564,17,61,78
Slovakia,1996,sp,65,203,134,337
Slovakia,1997,sp,014,0,1,1
Slovakia,1997,sp,1524,10,2,12
Slovakia,1997,sp,2534,11,24,35
Slovakia,1997,sp,3544,10,54,64
Slovakia,1997,sp,4554,3,38,41
Slovakia,1997,sp,5564,9,31,40
Slovakia,1997,sp,65,50,40,90
Slovakia,1998,sp,014,0,0,0
Slovakia,1998,sp,1524,5,5,10
Slovakia,1998,sp,2534,3,30,33
Slovakia,1998,sp,3544,16,53,69
Slovakia,1998,sp,4554,6,50,56
Slovakia,1998,sp,5564,5,37,42
Slovakia,1998,sp,65,58,35,93
Slovakia,1999,sp,014,0,1,1
Slovakia,1999,sp,1524,8,2,10
Slovakia,1999,sp,2534,10,19,29
Slovakia,1999,sp,3544,7,42,49
Slovakia,1999,sp,4554,7,51,58
Slovakia,1999,sp,5564,8,19,27
Slovakia,1999,sp,65,43,29,72
Slovakia,2000,sp,014,0,2,2
Slovakia,2000,sp,1524,5,6,11
Slovakia,2000,sp,2534,9,15,24
Slovakia,2000,sp,3544,7,31,38
Slovakia,2000,sp,4554,5,50,55
Slovakia,2000,sp,5564,4,16,20
Slovakia,2000,sp,65,54,32,86
Slovakia,2001,sp,014,1,0,1
Slovakia,2001,sp,1524,4,8,12
Slovakia,2001,sp,2534,9,13,22
Slovakia,2001,sp,3544,12,30,42
Slovakia,2001,sp,4554,8,48,56
Slovakia,2001,sp,5564,4,26,30
Slovakia,2001,sp,65,41,22,63
Slovakia,2002,sp,014,0,0,0
Slovakia,2002,sp,1524,6,4,10
Slovakia,2002,sp,2534,9,18,27
Slovakia,2002,sp,3544,7,35,42
Slovakia,2002,sp,4554,3,40,43
Slovakia,2002,sp,5564,5,21,26
Slovakia,2002,sp,65,26,26,52
Slovakia,2003,sp,014,1,1,2
Slovakia,2003,sp,1524,8,6,14
Slovakia,2003,sp,2534,9,8,17
Slovakia,2003,sp,3544,10,31,41
Slovakia,2003,sp,4554,3,36,39
Slovakia,2003,sp,5564,4,19,23
Slovakia,2003,sp,65,38,25,63
Slovakia,2004,sp,014,1,0,1
Slovakia,2004,sp,1524,1,2,3
Slovakia,2004,sp,2534,2,17,19
Slovakia,2004,sp,3544,3,30,33
Slovakia,2004,sp,4554,6,30,36
Slovakia,2004,sp,5564,4,12,16
Slovakia,2004,sp,65,26,21,47
Slovakia,2005,sp,014,0,0,0
Slovakia,2005,sp,1524,1,3,4
Slovakia,2005,sp,2534,8,13,21
Slovakia,2005,sp,3544,9,16,25
Slovakia,2005,sp,4554,5,25,30
Slovakia,2005,sp,5564,6,25,31
Slovakia,2005,sp,65,27,20,47
Slovakia,2006,ep,014,0,3,3
Slovakia,2006,ep,1524,1,6,7
Slovakia,2006,ep,2534,4,4,8
Slovakia,2006,ep,3544,1,10,11
Slovakia,2006,ep,4554,17,11,28
Slovakia,2006,ep,5564,13,11,24
Slovakia,2006,ep,65,23,18,41
Slovakia,2006,sn,014,7,9,16
Slovakia,2006,sn,1524,4,13,17
Slovakia,2006,sn,2534,9,11,20
Slovakia,2006,sn,3544,7,27,34
Slovakia,2006,sn,4554,19,46,65
Slovakia,2006,sn,5564,16,43,59
Slovakia,2006,sn,65,67,66,133
Slovakia,2006,sp,014,0,4,4
Slovakia,2006,sp,1524,6,8,14
Slovakia,2006,sp,2534,6,11,17
Slovakia,2006,sp,3544,7,18,25
Slovakia,2006,sp,4554,4,27,31
Slovakia,2006,sp,5564,3,29,32
Slovakia,2006,sp,65,20,17,37
Slovakia,2007,ep,014,1,4,5
Slovakia,2007,ep,1524,2,4,6
Slovakia,2007,ep,2534,6,7,13
Slovakia,2007,ep,3544,8,4,12
Slovakia,2007,ep,4554,9,11,20
Slovakia,2007,ep,5564,8,16,24
Slovakia,2007,ep,65,25,15,40
Slovakia,2007,sn,014,5,5,10
Slovakia,2007,sn,1524,9,9,18
Slovakia,2007,sn,2534,9,14,23
Slovakia,2007,sn,3544,14,26,40
Slovakia,2007,sn,4554,18,43,61
Slovakia,2007,sn,5564,10,36,46
Slovakia,2007,sn,65,43,48,91
Slovakia,2007,sp,014,1,0,1
Slovakia,2007,sp,1524,5,8,13
Slovakia,2007,sp,2534,3,10,13
Slovakia,2007,sp,3544,5,18,23
Slovakia,2007,sp,4554,6,51,57
Slovakia,2007,sp,5564,3,15,18
Slovakia,2007,sp,65,28,23,51
Slovakia,2008,ep,014,3,3,6
Slovakia,2008,ep,1524,3,5,8
Slovakia,2008,ep,2534,5,2,7
Slovakia,2008,ep,3544,2,5,7
Slovakia,2008,ep,4554,6,6,12
Slovakia,2008,ep,5564,9,10,19
Slovakia,2008,ep,65,26,14,40
Slovakia,2008,sn,014,3,4,7
Slovakia,2008,sn,1524,6,5,11
Slovakia,2008,sn,2534,15,17,32
Slovakia,2008,sn,3544,6,17,23
Slovakia,2008,sn,4554,15,42,57
Slovakia,2008,sn,5564,18,29,47
Slovakia,2008,sn,65,52,56,108
Slovakia,2008,sp,014,1,0,1
Slovakia,2008,sp,1524,2,2,4
Slovakia,2008,sp,2534,4,7,11
Slovakia,2008,sp,3544,4,16,20
Slovakia,2008,sp,4554,5,46,51
Slovakia,2008,sp,5564,1,10,11
Slovakia,2008,sp,65,17,11,28
Slovakia,2009,ep,014,0,2,2
Slovakia,2009,ep,1524,3,0,3
Slovakia,2009,ep,2534,3,2,5
Slovakia,2009,ep,3544,0,7,7
Slovakia,2009,ep,4554,8,9,17
Slovakia,2009,ep,5564,6,14,20
Slovakia,2009,ep,65,20,9,29
Slovakia,2009,sn,014,4,3,7
Slovakia,2009,sn,1524,1,11,12
Slovakia,2009,sn,2534,6,9,15
Slovakia,2009,sn,3544,7,15,22
Slovakia,2009,sn,4554,10,26,36
Slovakia,2009,sn,5564,11,28,39
Slovakia,2009,sn,65,36,35,71
Slovakia,2009,sp,014,0,0,0
Slovakia,2009,sp,1524,0,3,3
Slovakia,2009,sp,2534,5,14,19
Slovakia,2009,sp,3544,6,19,25
Slovakia,2009,sp,4554,2,22,24
Slovakia,2009,sp,5564,5,18,23
Slovakia,2009,sp,65,18,9,27
Slovakia,2010,ep,014,0,0,0
Slovakia,2010,ep,1524,2,2,4
Slovakia,2010,ep,2534,3,2,5
Slovakia,2010,ep,3544,2,0,2
Slovakia,2010,ep,4554,4,7,11
Slovakia,2010,ep,5564,6,10,16
Slovakia,2010,ep,65,14,7,21
Slovakia,2010,sn,014,2,8,10
Slovakia,2010,sn,1524,4,3,7
Slovakia,2010,sn,2534,6,13,19
Slovakia,2010,sn,3544,3,26,29
Slovakia,2010,sn,4554,13,26,39
Slovakia,2010,sn,5564,8,19,27
Slovakia,2010,sn,65,26,33,59
Slovakia,2010,sp,014,0,1,1
Slovakia,2010,sp,1524,1,7,8
Slovakia,2010,sp,2534,6,7,13
Slovakia,2010,sp,3544,7,18,25
Slovakia,2010,sp,4554,2,17,19
Slovakia,2010,sp,5564,3,17,20
Slovakia,2010,sp,65,11,15,26
Slovakia,2011,ep,014,4,2,6
Slovakia,2011,ep,1524,3,3,6
Slovakia,2011,ep,2534,3,0,3
Slovakia,2011,ep,3544,2,3,5
Slovakia,2011,ep,4554,4,5,9
Slovakia,2011,ep,5564,4,3,7
Slovakia,2011,ep,65,13,8,21
Slovakia,2011,sn,014,6,5,11
Slovakia,2011,sn,1524,4,11,15
Slovakia,2011,sn,2534,5,10,15
Slovakia,2011,sn,3544,8,11,19
Slovakia,2011,sn,4554,7,27,34
Slovakia,2011,sn,5564,9,18,27
Slovakia,2011,sn,65,27,22,49
Slovakia,2011,sp,014,0,0,0
Slovakia,2011,sp,1524,2,6,8
Slovakia,2011,sp,2534,3,8,11
Slovakia,2011,sp,3544,4,6,10
Slovakia,2011,sp,4554,6,20,26
Slovakia,2011,sp,5564,1,16,17
Slovakia,2011,sp,65,11,13,24
Slovakia,2012,ep,014,1,1,2
Slovakia,2012,ep,1524,3,0,3
Slovakia,2012,ep,2534,3,1,4
Slovakia,2012,ep,3544,2,4,6
Slovakia,2012,ep,4554,0,2,2
Slovakia,2012,ep,5564,3,7,10
Slovakia,2012,ep,65,4,8,12
Slovakia,2012,sn,014,5,10,15
Slovakia,2012,sn,1524,5,6,11
Slovakia,2012,sn,2534,6,5,11
Slovakia,2012,sn,3544,0,7,7
Slovakia,2012,sn,4554,9,14,23
Slovakia,2012,sn,5564,12,22,34
Slovakia,2012,sn,65,17,26,43
Slovakia,2012,sp,014,0,0,0
Slovakia,2012,sp,1524,2,2,4
Slovakia,2012,sp,2534,3,9,12
Slovakia,2012,sp,3544,4,17,21
Slovakia,2012,sp,4554,6,20,26
Slovakia,2012,sp,5564,1,12,13
Slovakia,2012,sp,65,13,7,20
Slovakia,2013,rel,014,20,18,38
Slovakia,2013,rel,1524,12,17,29
Slovakia,2013,rel,2534,11,20,31
Slovakia,2013,rel,3544,10,28,38
Slovakia,2013,rel,4554,15,52,67
Slovakia,2013,rel,5564,21,68,89
Slovakia,2013,rel,65,56,50,106
Slovenia,1995,sp,014,0,1,1
Slovenia,1995,sp,1524,7,13,20
Slovenia,1995,sp,2534,24,39,63
Slovenia,1995,sp,3544,11,63,74
Slovenia,1995,sp,4554,9,36,45
Slovenia,1995,sp,5564,5,26,31
Slovenia,1995,sp,65,42,27,69
Slovenia,1996,sp,014,0,0,0
Slovenia,1996,sp,1524,8,5,13
Slovenia,1996,sp,2534,15,27,42
Slovenia,1996,sp,3544,9,46,55
Slovenia,1996,sp,4554,7,37,44
Slovenia,1996,sp,5564,7,28,35
Slovenia,1996,sp,65,19,13,32
Slovenia,1997,sp,014,0,0,0
Slovenia,1997,sp,1524,8,4,12
Slovenia,1997,sp,2534,15,16,31
Slovenia,1997,sp,3544,8,33,41
Slovenia,1997,sp,4554,1,19,20
Slovenia,1997,sp,5564,4,15,19
Slovenia,1997,sp,65,13,20,33
Slovenia,1998,sp,014,0,0,0
Slovenia,1998,sp,1524,8,5,13
Slovenia,1998,sp,2534,12,22,34
Slovenia,1998,sp,3544,10,27,37
Slovenia,1998,sp,4554,7,19,26
Slovenia,1998,sp,5564,2,13,15
Slovenia,1998,sp,65,18,14,32
Slovenia,1999,sp,014,0,0,0
Slovenia,1999,sp,1524,0,3,3
Slovenia,1999,sp,2534,5,21,26
Slovenia,1999,sp,3544,6,40,46
Slovenia,1999,sp,4554,5,27,32
Slovenia,1999,sp,5564,6,11,17
Slovenia,1999,sp,65,20,15,35
Slovenia,2000,sp,014,0,0,0
Slovenia,2000,sp,1524,3,3,6
Slovenia,2000,sp,2534,9,11,20
Slovenia,2000,sp,3544,3,36,39
Slovenia,2000,sp,4554,4,22,26
Slovenia,2000,sp,5564,3,14,17
Slovenia,2000,sp,65,20,17,37
Slovenia,2001,sp,014,0,0,0
Slovenia,2001,sp,1524,5,4,9
Slovenia,2001,sp,2534,11,11,22
Slovenia,2001,sp,3544,11,30,41
Slovenia,2001,sp,4554,3,27,30
Slovenia,2001,sp,5564,5,11,16
Slovenia,2001,sp,65,14,7,21
Slovenia,2002,sp,014,0,0,0
Slovenia,2002,sp,1524,3,8,11
Slovenia,2002,sp,2534,7,11,18
Slovenia,2002,sp,3544,6,25,31
Slovenia,2002,sp,4554,1,26,27
Slovenia,2002,sp,5564,3,14,17
Slovenia,2002,sp,65,17,9,26
Slovenia,2003,sp,014,0,0,0
Slovenia,2003,sp,1524,5,3,8
Slovenia,2003,sp,2534,5,9,14
Slovenia,2003,sp,3544,4,23,27
Slovenia,2003,sp,4554,3,22,25
Slovenia,2003,sp,5564,4,7,11
Slovenia,2003,sp,65,16,15,31
Slovenia,2004,sp,014,0,0,0
Slovenia,2004,sp,1524,4,5,9
Slovenia,2004,sp,2534,6,7,13
Slovenia,2004,sp,3544,4,10,14
Slovenia,2004,sp,4554,3,10,13
Slovenia,2004,sp,5564,2,8,10
Slovenia,2004,sp,65,17,13,30
Slovenia,2005,sp,014,0,0,0
Slovenia,2005,sp,1524,4,4,8
Slovenia,2005,sp,2534,4,10,14
Slovenia,2005,sp,3544,6,16,22
Slovenia,2005,sp,4554,5,15,20
Slovenia,2005,sp,5564,4,11,15
Slovenia,2005,sp,65,16,14,30
Slovenia,2006,ep,014,0,1,1
Slovenia,2006,ep,1524,1,1,2
Slovenia,2006,ep,2534,2,4,6
Slovenia,2006,ep,3544,0,4,4
Slovenia,2006,ep,4554,1,0,1
Slovenia,2006,ep,5564,1,3,4
Slovenia,2006,ep,65,15,5,20
Slovenia,2006,sn,014,2,5,7
Slovenia,2006,sn,1524,0,6,6
Slovenia,2006,sn,2534,6,1,7
Slovenia,2006,sn,3544,2,5,7
Slovenia,2006,sn,4554,5,4,9
Slovenia,2006,sn,5564,1,10,11
Slovenia,2006,sn,65,18,16,34
Slovenia,2006,sp,014,0,0,0
Slovenia,2006,sp,1524,5,3,8
Slovenia,2006,sp,2534,7,5,12
Slovenia,2006,sp,3544,4,9,13
Slovenia,2006,sp,4554,2,12,14
Slovenia,2006,sp,5564,4,7,11
Slovenia,2006,sp,65,19,6,25
Slovenia,2007,ep,014,0,3,3
Slovenia,2007,ep,1524,1,2,3
Slovenia,2007,ep,2534,3,1,4
Slovenia,2007,ep,3544,2,1,3
Slovenia,2007,ep,4554,1,1,2
Slovenia,2007,ep,5564,1,NA,NA
Slovenia,2007,ep,65,11,10,21
Slovenia,2007,sn,014,2,1,3
Slovenia,2007,sn,1524,3,3,6
Slovenia,2007,sn,2534,2,6,8
Slovenia,2007,sn,3544,1,3,4
Slovenia,2007,sn,4554,3,6,9
Slovenia,2007,sn,5564,5,6,11
Slovenia,2007,sn,65,15,15,30
Slovenia,2007,sp,014,0,0,0
Slovenia,2007,sp,1524,1,0,1
Slovenia,2007,sp,2534,5,7,12
Slovenia,2007,sp,3544,6,15,21
Slovenia,2007,sp,4554,2,14,16
Slovenia,2007,sp,5564,3,12,15
Slovenia,2007,sp,65,16,9,25
Slovenia,2008,ep,014,1,0,1
Slovenia,2008,ep,1524,2,1,3
Slovenia,2008,ep,2534,1,1,2
Slovenia,2008,ep,3544,1,1,2
Slovenia,2008,ep,4554,1,1,2
Slovenia,2008,ep,5564,0,5,5
Slovenia,2008,ep,65,9,9,18
Slovenia,2008,sn,014,1,1,2
Slovenia,2008,sn,1524,1,3,4
Slovenia,2008,sn,2534,3,5,8
Slovenia,2008,sn,3544,1,5,6
Slovenia,2008,sn,4554,4,12,16
Slovenia,2008,sn,5564,0,7,7
Slovenia,2008,sn,65,26,14,40
Slovenia,2008,sp,014,0,0,0
Slovenia,2008,sp,1524,2,3,5
Slovenia,2008,sp,2534,7,12,19
Slovenia,2008,sp,3544,2,9,11
Slovenia,2008,sp,4554,5,17,22
Slovenia,2008,sp,5564,2,12,14
Slovenia,2008,sp,65,7,3,10
Slovenia,2009,ep,014,0,1,1
Slovenia,2009,ep,1524,0,1,1
Slovenia,2009,ep,2534,0,3,3
Slovenia,2009,ep,3544,0,1,1
Slovenia,2009,ep,4554,2,1,3
Slovenia,2009,ep,5564,1,1,2
Slovenia,2009,ep,65,7,7,14
Slovenia,2009,sn,014,2,3,5
Slovenia,2009,sn,1524,1,4,5
Slovenia,2009,sn,2534,4,6,10
Slovenia,2009,sn,3544,6,5,11
Slovenia,2009,sn,4554,6,6,12
Slovenia,2009,sn,5564,2,7,9
Slovenia,2009,sn,65,13,5,18
Slovenia,2009,sp,014,0,0,0
Slovenia,2009,sp,1524,3,3,6
Slovenia,2009,sp,2534,6,8,14
Slovenia,2009,sp,3544,4,13,17
Slovenia,2009,sp,4554,1,14,15
Slovenia,2009,sp,5564,3,6,9
Slovenia,2009,sp,65,17,7,24
Slovenia,2010,ep,014,0,0,0
Slovenia,2010,ep,1524,1,1,2
Slovenia,2010,ep,2534,1,3,4
Slovenia,2010,ep,3544,0,4,4
Slovenia,2010,ep,4554,3,1,4
Slovenia,2010,ep,5564,2,2,4
Slovenia,2010,ep,65,8,4,12
Slovenia,2010,sn,014,3,0,3
Slovenia,2010,sn,1524,4,2,6
Slovenia,2010,sn,2534,6,3,9
Slovenia,2010,sn,3544,0,9,9
Slovenia,2010,sn,4554,1,3,4
Slovenia,2010,sn,5564,3,7,10
Slovenia,2010,sn,65,15,11,26
Slovenia,2010,sp,014,0,0,0
Slovenia,2010,sp,1524,1,4,5
Slovenia,2010,sp,2534,5,7,12
Slovenia,2010,sp,3544,2,10,12
Slovenia,2010,sp,4554,4,9,13
Slovenia,2010,sp,5564,1,6,7
Slovenia,2010,sp,65,3,12,15
Slovenia,2011,ep,014,2,0,2
Slovenia,2011,ep,1524,1,0,1
Slovenia,2011,ep,2534,0,3,3
Slovenia,2011,ep,3544,1,2,3
Slovenia,2011,ep,4554,0,2,2
Slovenia,2011,ep,5564,5,3,8
Slovenia,2011,ep,65,4,3,7
Slovenia,2011,sn,014,2,0,2
Slovenia,2011,sn,1524,0,2,2
Slovenia,2011,sn,2534,5,10,15
Slovenia,2011,sn,3544,5,4,9
Slovenia,2011,sn,4554,3,5,8
Slovenia,2011,sn,5564,3,7,10
Slovenia,2011,sn,65,14,13,27
Slovenia,2011,sp,014,0,0,0
Slovenia,2011,sp,1524,0,3,3
Slovenia,2011,sp,2534,5,9,14
Slovenia,2011,sp,3544,4,16,20
Slovenia,2011,sp,4554,2,12,14
Slovenia,2011,sp,5564,1,8,9
Slovenia,2011,sp,65,17,5,22
Slovenia,2012,ep,014,0,0,0
Slovenia,2012,ep,1524,0,0,0
Slovenia,2012,ep,2534,2,2,4
Slovenia,2012,ep,3544,0,2,2
Slovenia,2012,ep,4554,2,0,2
Slovenia,2012,ep,5564,1,1,2
Slovenia,2012,ep,65,1,2,3
Slovenia,2012,sn,014,2,3,5
Slovenia,2012,sn,1524,2,0,2
Slovenia,2012,sn,2534,3,2,5
Slovenia,2012,sn,3544,2,1,3
Slovenia,2012,sn,4554,4,5,9
Slovenia,2012,sn,5564,3,4,7
Slovenia,2012,sn,65,17,16,33
Slovenia,2012,sp,014,0,0,0
Slovenia,2012,sp,1524,2,2,4
Slovenia,2012,sp,2534,3,6,9
Slovenia,2012,sp,3544,0,4,4
Slovenia,2012,sp,4554,1,8,9
Slovenia,2012,sp,5564,1,6,7
Slovenia,2012,sp,65,9,5,14
Slovenia,2013,rel,014,1,1,2
Slovenia,2013,rel,1524,2,3,5
Slovenia,2013,rel,2534,7,12,19
Slovenia,2013,rel,3544,3,5,8
Slovenia,2013,rel,4554,10,18,28
Slovenia,2013,rel,5564,6,13,19
Slovenia,2013,rel,65,39,19,58
Solomon Islands,1995,sp,014,3,2,5
Solomon Islands,1995,sp,1524,17,14,31
Solomon Islands,1995,sp,2534,11,6,17
Solomon Islands,1995,sp,3544,7,5,12
Solomon Islands,1995,sp,4554,12,7,19
Solomon Islands,1995,sp,5564,13,9,22
Solomon Islands,1995,sp,65,0,3,3
Solomon Islands,1996,sp,014,5,4,9
Solomon Islands,1996,sp,1524,5,9,14
Solomon Islands,1996,sp,2534,9,9,18
Solomon Islands,1996,sp,3544,8,3,11
Solomon Islands,1996,sp,4554,12,7,19
Solomon Islands,1996,sp,5564,6,4,10
Solomon Islands,1996,sp,65,3,6,9
Solomon Islands,1997,sp,014,3,2,5
Solomon Islands,1997,sp,1524,19,20,39
Solomon Islands,1997,sp,2534,14,8,22
Solomon Islands,1997,sp,3544,10,6,16
Solomon Islands,1997,sp,4554,8,9,17
Solomon Islands,1997,sp,5564,4,4,8
Solomon Islands,1997,sp,65,1,5,6
Solomon Islands,1998,sp,014,2,3,5
Solomon Islands,1998,sp,1524,14,15,29
Solomon Islands,1998,sp,2534,16,9,25
Solomon Islands,1998,sp,3544,10,14,24
Solomon Islands,1998,sp,4554,11,18,29
Solomon Islands,1998,sp,5564,7,7,14
Solomon Islands,1998,sp,65,2,12,14
Solomon Islands,2000,sp,014,8,3,11
Solomon Islands,2000,sp,1524,15,13,28
Solomon Islands,2000,sp,2534,13,4,17
Solomon Islands,2000,sp,3544,7,8,15
Solomon Islands,2000,sp,4554,7,8,15
Solomon Islands,2000,sp,5564,5,10,15
Solomon Islands,2000,sp,65,2,6,8
Solomon Islands,2002,sp,014,0,3,3
Solomon Islands,2002,sp,1524,16,16,32
Solomon Islands,2002,sp,2534,15,12,27
Solomon Islands,2002,sp,3544,4,9,13
Solomon Islands,2002,sp,4554,2,9,11
Solomon Islands,2002,sp,5564,7,7,14
Solomon Islands,2002,sp,65,4,4,8
Solomon Islands,2003,sp,014,9,4,13
Solomon Islands,2003,sp,1524,14,14,28
Solomon Islands,2003,sp,2534,14,9,23
Solomon Islands,2003,sp,3544,16,12,28
Solomon Islands,2003,sp,4554,13,14,27
Solomon Islands,2003,sp,5564,10,8,18
Solomon Islands,2003,sp,65,1,0,1
Solomon Islands,2004,sp,014,10,6,16
Solomon Islands,2004,sp,1524,22,11,33
Solomon Islands,2004,sp,2534,20,12,32
Solomon Islands,2004,sp,3544,13,8,21
Solomon Islands,2004,sp,4554,14,11,25
Solomon Islands,2004,sp,5564,8,9,17
Solomon Islands,2004,sp,65,3,5,8
Solomon Islands,2005,sp,014,9,4,13
Solomon Islands,2005,sp,1524,23,14,37
Solomon Islands,2005,sp,2534,21,18,39
Solomon Islands,2005,sp,3544,12,9,21
Solomon Islands,2005,sp,4554,11,15,26
Solomon Islands,2005,sp,5564,9,12,21
Solomon Islands,2005,sp,65,1,11,12
Solomon Islands,2006,ep,014,14,18,32
Solomon Islands,2006,ep,1524,9,4,13
Solomon Islands,2006,ep,2534,7,4,11
Solomon Islands,2006,ep,3544,3,3,6
Solomon Islands,2006,ep,4554,2,2,4
Solomon Islands,2006,ep,5564,3,3,6
Solomon Islands,2006,ep,65,0,2,2
Solomon Islands,2006,sn,014,26,21,47
Solomon Islands,2006,sn,1524,7,8,15
Solomon Islands,2006,sn,2534,4,14,18
Solomon Islands,2006,sn,3544,10,11,21
Solomon Islands,2006,sn,4554,15,13,28
Solomon Islands,2006,sn,5564,9,16,25
Solomon Islands,2006,sn,65,5,9,14
Solomon Islands,2006,sp,014,4,1,5
Solomon Islands,2006,sp,1524,16,13,29
Solomon Islands,2006,sp,2534,14,11,25
Solomon Islands,2006,sp,3544,9,4,13
Solomon Islands,2006,sp,4554,14,4,18
Solomon Islands,2006,sp,5564,8,14,22
Solomon Islands,2006,sp,65,4,8,12
Solomon Islands,2007,ep,014,16,20,36
Solomon Islands,2007,ep,1524,3,13,16
Solomon Islands,2007,ep,2534,10,10,20
Solomon Islands,2007,ep,3544,5,9,14
Solomon Islands,2007,ep,4554,2,6,8
Solomon Islands,2007,ep,5564,1,0,1
Solomon Islands,2007,ep,65,0,4,4
Solomon Islands,2007,sn,014,12,17,29
Solomon Islands,2007,sn,1524,12,9,21
Solomon Islands,2007,sn,2534,14,4,18
Solomon Islands,2007,sn,3544,6,9,15
Solomon Islands,2007,sn,4554,14,14,28
Solomon Islands,2007,sn,5564,11,14,25
Solomon Islands,2007,sn,65,2,9,11
Solomon Islands,2007,sp,014,5,5,10
Solomon Islands,2007,sp,1524,12,15,27
Solomon Islands,2007,sp,2534,25,16,41
Solomon Islands,2007,sp,3544,9,12,21
Solomon Islands,2007,sp,4554,10,9,19
Solomon Islands,2007,sp,5564,5,8,13
Solomon Islands,2007,sp,65,5,6,11
Solomon Islands,2008,ep,014,11,11,22
Solomon Islands,2008,ep,1524,8,10,18
Solomon Islands,2008,ep,2534,7,13,20
Solomon Islands,2008,ep,3544,5,10,15
Solomon Islands,2008,ep,4554,3,7,10
Solomon Islands,2008,ep,5564,4,7,11
Solomon Islands,2008,ep,65,1,0,1
Solomon Islands,2008,sn,014,16,18,34
Solomon Islands,2008,sn,1524,6,9,15
Solomon Islands,2008,sn,2534,5,6,11
Solomon Islands,2008,sn,3544,14,7,21
Solomon Islands,2008,sn,4554,8,11,19
Solomon Islands,2008,sn,5564,14,9,23
Solomon Islands,2008,sn,65,2,11,13
Solomon Islands,2008,sp,014,4,3,7
Solomon Islands,2008,sp,1524,13,17,30
Solomon Islands,2008,sp,2534,23,12,35
Solomon Islands,2008,sp,3544,11,11,22
Solomon Islands,2008,sp,4554,13,10,23
Solomon Islands,2008,sp,5564,3,11,14
Solomon Islands,2008,sp,65,2,7,9
Solomon Islands,2009,ep,014,22,29,51
Solomon Islands,2009,ep,1524,7,8,15
Solomon Islands,2009,ep,2534,13,5,18
Solomon Islands,2009,ep,3544,8,7,15
Solomon Islands,2009,ep,4554,5,12,17
Solomon Islands,2009,ep,5564,7,7,14
Solomon Islands,2009,ep,65,3,4,7
Solomon Islands,2009,sn,014,14,7,21
Solomon Islands,2009,sn,1524,1,2,3
Solomon Islands,2009,sn,2534,7,6,13
Solomon Islands,2009,sn,3544,7,4,11
Solomon Islands,2009,sn,4554,6,6,12
Solomon Islands,2009,sn,5564,9,9,18
Solomon Islands,2009,sn,65,2,6,8
Solomon Islands,2009,sp,014,9,3,12
Solomon Islands,2009,sp,1524,19,11,30
Solomon Islands,2009,sp,2534,19,17,36
Solomon Islands,2009,sp,3544,9,8,17
Solomon Islands,2009,sp,4554,11,8,19
Solomon Islands,2009,sp,5564,7,8,15
Solomon Islands,2009,sp,65,3,6,9
Solomon Islands,2010,ep,014,21,15,36
Solomon Islands,2010,ep,1524,11,17,28
Solomon Islands,2010,ep,2534,7,6,13
Solomon Islands,2010,ep,3544,2,6,8
Solomon Islands,2010,ep,4554,8,4,12
Solomon Islands,2010,ep,5564,3,3,6
Solomon Islands,2010,ep,65,0,2,2
Solomon Islands,2010,sn,014,15,11,26
Solomon Islands,2010,sn,1524,7,7,14
Solomon Islands,2010,sn,2534,4,6,10
Solomon Islands,2010,sn,3544,3,7,10
Solomon Islands,2010,sn,4554,7,9,16
Solomon Islands,2010,sn,5564,7,3,10
Solomon Islands,2010,sn,65,4,8,12
Solomon Islands,2010,sp,014,4,4,8
Solomon Islands,2010,sp,1524,19,16,35
Solomon Islands,2010,sp,2534,17,18,35
Solomon Islands,2010,sp,3544,11,16,27
Solomon Islands,2010,sp,4554,5,8,13
Solomon Islands,2010,sp,5564,4,3,7
Solomon Islands,2010,sp,65,5,3,8
Solomon Islands,2011,ep,014,25,28,53
Solomon Islands,2011,ep,1524,7,14,21
Solomon Islands,2011,ep,2534,10,9,19
Solomon Islands,2011,ep,3544,10,5,15
Solomon Islands,2011,ep,4554,6,3,9
Solomon Islands,2011,ep,5564,4,0,4
Solomon Islands,2011,ep,65,1,5,6
Solomon Islands,2011,sn,014,20,14,34
Solomon Islands,2011,sn,1524,7,6,13
Solomon Islands,2011,sn,2534,5,7,12
Solomon Islands,2011,sn,3544,7,6,13
Solomon Islands,2011,sn,4554,9,3,12
Solomon Islands,2011,sn,5564,6,11,17
Solomon Islands,2011,sn,65,3,4,7
Solomon Islands,2011,sp,014,3,3,6
Solomon Islands,2011,sp,1524,13,15,28
Solomon Islands,2011,sp,2534,27,22,49
Solomon Islands,2011,sp,3544,15,12,27
Solomon Islands,2011,sp,4554,10,7,17
Solomon Islands,2011,sp,5564,16,8,24
Solomon Islands,2011,sp,65,2,6,8
Solomon Islands,2012,ep,014,15,19,34
Solomon Islands,2012,ep,1524,12,15,27
Solomon Islands,2012,ep,2534,10,10,20
Solomon Islands,2012,ep,3544,4,5,9
Solomon Islands,2012,ep,4554,4,4,8
Solomon Islands,2012,ep,5564,4,4,8
Solomon Islands,2012,ep,65,0,6,6
Solomon Islands,2012,sn,014,10,9,19
Solomon Islands,2012,sn,1524,8,4,12
Solomon Islands,2012,sn,2534,8,4,12
Solomon Islands,2012,sn,3544,9,3,12
Solomon Islands,2012,sn,4554,4,5,9
Solomon Islands,2012,sn,5564,4,6,10
Solomon Islands,2012,sn,65,4,9,13
Solomon Islands,2012,sp,014,5,3,8
Solomon Islands,2012,sp,1524,20,20,40
Solomon Islands,2012,sp,2534,18,19,37
Solomon Islands,2012,sp,3544,11,10,21
Solomon Islands,2012,sp,4554,8,12,20
Solomon Islands,2012,sp,5564,12,8,20
Solomon Islands,2012,sp,65,5,6,11
Solomon Islands,2013,rel,014,33,33,66
Solomon Islands,2013,rel,1524,47,39,86
Solomon Islands,2013,rel,2534,30,36,66
Solomon Islands,2013,rel,3544,14,24,38
Solomon Islands,2013,rel,4554,22,26,48
Solomon Islands,2013,rel,5564,10,24,34
Solomon Islands,2013,rel,65,10,12,22
Somalia,1995,sp,014,38,46,84
Somalia,1995,sp,1524,158,334,492
Somalia,1995,sp,2534,139,730,869
Somalia,1995,sp,3544,97,201,298
Somalia,1995,sp,4554,40,127,167
Somalia,1995,sp,5564,25,278,303
Somalia,1995,sp,65,16,109,125
Somalia,1996,sp,014,49,45,94
Somalia,1996,sp,1524,221,439,660
Somalia,1996,sp,2534,224,557,781
Somalia,1996,sp,3544,108,263,371
Somalia,1996,sp,4554,50,153,203
Somalia,1996,sp,5564,38,82,120
Somalia,1996,sp,65,26,63,89
Somalia,1997,sp,014,63,72,135
Somalia,1997,sp,1524,296,565,861
Somalia,1997,sp,2534,313,658,971
Somalia,1997,sp,3544,173,311,484
Somalia,1997,sp,4554,82,187,269
Somalia,1997,sp,5564,56,172,228
Somalia,1997,sp,65,37,112,149
Somalia,1998,sp,014,77,99,176
Somalia,1998,sp,1524,270,541,811
Somalia,1998,sp,2534,321,599,920
Somalia,1998,sp,3544,176,337,513
Somalia,1998,sp,4554,78,198,276
Somalia,1998,sp,5564,74,145,219
Somalia,1998,sp,65,80,126,206
Somalia,1999,sp,014,131,136,267
Somalia,1999,sp,1524,302,643,945
Somalia,1999,sp,2534,302,678,980
Somalia,1999,sp,3544,190,383,573
Somalia,1999,sp,4554,100,175,275
Somalia,1999,sp,5564,74,175,249
Somalia,1999,sp,65,74,124,198
Somalia,2000,sp,014,85,113,198
Somalia,2000,sp,1524,354,740,1094
Somalia,2000,sp,2534,319,724,1043
Somalia,2000,sp,3544,219,408,627
Somalia,2000,sp,4554,110,254,364
Somalia,2000,sp,5564,72,195,267
Somalia,2000,sp,65,41,142,183
Somalia,2001,sp,014,91,125,216
Somalia,2001,sp,1524,439,899,1338
Somalia,2001,sp,2534,413,880,1293
Somalia,2001,sp,3544,259,476,735
Somalia,2001,sp,4554,129,310,439
Somalia,2001,sp,5564,97,257,354
Somalia,2001,sp,65,69,196,265
Somalia,2002,sp,014,112,119,231
Somalia,2002,sp,1524,468,922,1390
Somalia,2002,sp,2534,447,821,1268
Somalia,2002,sp,3544,302,478,780
Somalia,2002,sp,4554,172,307,479
Somalia,2002,sp,5564,111,219,330
Somalia,2002,sp,65,75,176,251
Somalia,2003,sp,014,106,118,224
Somalia,2003,sp,1524,535,1054,1589
Somalia,2003,sp,2534,462,850,1312
Somalia,2003,sp,3544,333,513,846
Somalia,2003,sp,4554,171,319,490
Somalia,2003,sp,5564,161,250,411
Somalia,2003,sp,65,104,214,318
Somalia,2004,sp,014,129,175,304
Somalia,2004,sp,1524,676,1228,1904
Somalia,2004,sp,2534,618,1059,1677
Somalia,2004,sp,3544,428,610,1038
Somalia,2004,sp,4554,266,419,685
Somalia,2004,sp,5564,157,326,483
Somalia,2004,sp,65,110,278,388
Somalia,2005,sp,014,169,125,294
Somalia,2005,sp,1524,752,1343,2095
Somalia,2005,sp,2534,636,1114,1750
Somalia,2005,sp,3544,436,725,1161
Somalia,2005,sp,4554,292,458,750
Somalia,2005,sp,5564,212,330,542
Somalia,2005,sp,65,157,319,476
Somalia,2006,ep,014,83,187,270
Somalia,2006,ep,1524,190,325,515
Somalia,2006,ep,2534,183,316,499
Somalia,2006,ep,3544,120,187,307
Somalia,2006,ep,4554,88,167,255
Somalia,2006,ep,5564,54,76,130
Somalia,2006,ep,65,14,44,58
Somalia,2006,sn,014,96,198,294
Somalia,2006,sn,1524,205,394,599
Somalia,2006,sn,2534,204,375,579
Somalia,2006,sn,3544,145,222,367
Somalia,2006,sn,4554,126,210,336
Somalia,2006,sn,5564,87,111,198
Somalia,2006,sn,65,29,77,106
Somalia,2006,sp,014,170,166,336
Somalia,2006,sp,1524,668,1377,2045
Somalia,2006,sp,2534,628,1121,1749
Somalia,2006,sp,3544,432,647,1079
Somalia,2006,sp,4554,269,436,705
Somalia,2006,sp,5564,171,309,480
Somalia,2006,sp,65,131,336,467
Somalia,2007,ep,014,0,0,0
Somalia,2007,ep,1524,0,0,0
Somalia,2007,ep,2534,0,0,0
Somalia,2007,ep,3544,0,0,0
Somalia,2007,ep,4554,0,0,0
Somalia,2007,ep,5564,0,0,0
Somalia,2007,ep,65,0,0,0
Somalia,2007,sn,014,0,0,0
Somalia,2007,sn,1524,0,0,0
Somalia,2007,sn,2534,0,0,0
Somalia,2007,sn,3544,0,0,0
Somalia,2007,sn,4554,0,0,0
Somalia,2007,sn,5564,0,0,0
Somalia,2007,sn,65,0,0,0
Somalia,2007,sp,014,135,125,260
Somalia,2007,sp,1524,602,1239,1841
Somalia,2007,sp,2534,520,1008,1528
Somalia,2007,sp,3544,378,578,956
Somalia,2007,sp,4554,243,407,650
Somalia,2007,sp,5564,181,296,477
Somalia,2007,sp,65,129,289,418
Somalia,2008,ep,014,0,0,0
Somalia,2008,ep,1524,0,0,0
Somalia,2008,ep,2534,0,0,0
Somalia,2008,ep,3544,0,0,0
Somalia,2008,ep,4554,0,0,0
Somalia,2008,ep,5564,0,0,0
Somalia,2008,ep,65,0,0,0
Somalia,2008,sn,014,0,0,0
Somalia,2008,sn,1524,0,0,0
Somalia,2008,sn,2534,0,0,0
Somalia,2008,sn,3544,0,0,0
Somalia,2008,sn,4554,0,0,0
Somalia,2008,sn,5564,0,0,0
Somalia,2008,sn,65,0,0,0
Somalia,2008,sp,014,138,116,254
Somalia,2008,sp,1524,604,1273,1877
Somalia,2008,sp,2534,587,1067,1654
Somalia,2008,sp,3544,439,635,1074
Somalia,2008,sp,4554,285,422,707
Somalia,2008,sp,5564,191,314,505
Somalia,2008,sp,65,151,298,449
Somalia,2009,sp,014,129,175,304
Somalia,2009,sp,1524,560,1118,1678
Somalia,2009,sp,2534,524,974,1498
Somalia,2009,sp,3544,396,585,981
Somalia,2009,sp,4554,231,410,641
Somalia,2009,sp,5564,185,314,499
Somalia,2009,sp,65,141,305,446
Somalia,2010,sp,014,91,109,200
Somalia,2010,sp,1524,467,1036,1503
Somalia,2010,sp,2534,444,886,1330
Somalia,2010,sp,3544,341,496,837
Somalia,2010,sp,4554,188,355,543
Somalia,2010,sp,5564,137,266,403
Somalia,2010,sp,65,132,277,409
Somalia,2011,ep,014,240,300,540
Somalia,2011,sn,014,640,842,1482
Somalia,2011,sp,014,114,113,227
Somalia,2011,sp,1524,495,1147,1642
Somalia,2011,sp,2534,465,1047,1512
Somalia,2011,sp,3544,348,587,935
Somalia,2011,sp,4554,260,398,658
Somalia,2011,sp,5564,168,330,498
Somalia,2011,sp,65,135,277,412
Somalia,2012,ep,014,215,269,484
Somalia,2012,sn,014,712,918,1630
Somalia,2012,sp,014,121,129,250
Somalia,2012,sp,1524,553,1147,1700
Somalia,2012,sp,2534,554,1014,1568
Somalia,2012,sp,3544,396,560,956
Somalia,2012,sp,4554,267,449,716
Somalia,2012,sp,5564,165,296,461
Somalia,2012,sp,65,169,307,476
Somalia,2013,rel,014,122,150,272
Somalia,2013,rel,1524,621,1138,1759
Somalia,2013,rel,2534,588,1124,1712
Somalia,2013,rel,3544,430,578,1008
Somalia,2013,rel,4554,303,450,753
Somalia,2013,rel,5564,199,309,508
Somalia,2013,rel,65,189,337,526
South Africa,1999,sp,014,75,52,127
South Africa,1999,sp,1524,972,624,1596
South Africa,1999,sp,2534,1384,1697,3081
South Africa,1999,sp,3544,779,1834,2613
South Africa,1999,sp,4554,314,966,1280
South Africa,1999,sp,5564,159,434,593
South Africa,1999,sp,65,110,221,331
South Africa,2000,sp,014,122,116,238
South Africa,2000,sp,1524,1283,723,2006
South Africa,2000,sp,2534,1716,1999,3715
South Africa,2000,sp,3544,933,2135,3068
South Africa,2000,sp,4554,423,1146,1569
South Africa,2000,sp,5564,167,435,602
South Africa,2000,sp,65,80,212,292
South Africa,2001,sp,014,275,163,438
South Africa,2001,sp,1524,2237,1490,3727
South Africa,2001,sp,2534,3220,3844,7064
South Africa,2001,sp,3544,1748,3540,5288
South Africa,2001,sp,4554,781,1838,2619
South Africa,2001,sp,5564,295,690,985
South Africa,2001,sp,65,168,255,423
South Africa,2002,sp,014,3261,3081,6342
South Africa,2002,sp,1524,7081,5147,12228
South Africa,2002,sp,2534,11312,13681,24993
South Africa,2002,sp,3544,6080,13215,19295
South Africa,2002,sp,4554,2611,7038,9649
South Africa,2002,sp,5564,1076,2342,3418
South Africa,2002,sp,65,600,942,1542
South Africa,2003,sp,014,2341,1769,4110
South Africa,2003,sp,1524,12600,10107,22707
South Africa,2003,sp,2534,16867,20392,37259
South Africa,2003,sp,3544,9207,17862,27069
South Africa,2003,sp,4554,4080,9540,13620
South Africa,2003,sp,5564,1972,3604,5576
South Africa,2003,sp,65,1172,1495,2667
South Africa,2004,sp,014,2810,2269,5079
South Africa,2004,sp,1524,14166,11030,25196
South Africa,2004,sp,2534,18975,22120,41095
South Africa,2004,sp,3544,10839,19675,30514
South Africa,2004,sp,4554,4887,10653,15540
South Africa,2004,sp,5564,2182,3908,6090
South Africa,2004,sp,65,1174,1580,2754
South Africa,2005,sp,014,2561,2035,4596
South Africa,2005,sp,1524,13632,10422,24054
South Africa,2005,sp,2534,19343,20576,39919
South Africa,2005,sp,3544,11338,19465,30803
South Africa,2005,sp,4554,5416,11143,16559
South Africa,2005,sp,5564,2352,4124,6476
South Africa,2005,sp,65,1348,1705,3053
South Africa,2006,ep,014,2457,2673,5130
South Africa,2006,ep,1524,3966,2207,6173
South Africa,2006,ep,2534,8576,6848,15424
South Africa,2006,ep,3544,5384,6476,11860
South Africa,2006,ep,4554,2297,3372,5669
South Africa,2006,ep,5564,901,1391,2292
South Africa,2006,ep,65,571,730,1301
South Africa,2006,sn,014,16172,17471,33643
South Africa,2006,sn,1524,5632,3225,8857
South Africa,2006,sn,2534,11104,9340,20444
South Africa,2006,sn,3544,6888,8706,15594
South Africa,2006,sn,4554,3153,5329,8482
South Africa,2006,sn,5564,1497,2361,3858
South Africa,2006,sn,65,1023,1313,2336
South Africa,2006,sp,014,2579,2062,4641
South Africa,2006,sp,1524,14073,10498,24571
South Africa,2006,sp,2534,20387,21273,41660
South Africa,2006,sp,3544,12656,19743,32399
South Africa,2006,sp,4554,5767,11752,17519
South Africa,2006,sp,5564,2550,4392,6942
South Africa,2006,sp,65,1505,1862,3367
South Africa,2007,ep,014,3750,4026,7776
South Africa,2007,ep,1524,3290,4539,7829
South Africa,2007,ep,2534,5267,6925,12192
South Africa,2007,ep,3544,4439,3752,8191
South Africa,2007,ep,4554,2553,2198,4751
South Africa,2007,ep,5564,1726,1578,3304
South Africa,2007,ep,65,867,828,1695
South Africa,2007,sn,014,12568,12766,25334
South Africa,2007,sn,1524,9170,7211,16381
South Africa,2007,sn,2534,11383,10979,22362
South Africa,2007,sn,3544,8114,8905,17019
South Africa,2007,sn,4554,5787,5788,11575
South Africa,2007,sn,5564,3217,4096,7313
South Africa,2007,sn,65,2633,3014,5647
South Africa,2007,sp,014,2511,1909,4420
South Africa,2007,sp,1524,14410,10514,24924
South Africa,2007,sp,2534,21049,21948,42997
South Africa,2007,sp,3544,13190,20076,33266
South Africa,2007,sp,4554,6245,12164,18409
South Africa,2007,sp,5564,2964,4792,7756
South Africa,2007,sp,65,1811,2021,3832
South Africa,2008,ep,014,3964,4265,8229
South Africa,2008,ep,1524,3389,4694,8083
South Africa,2008,ep,2534,5575,7148,12723
South Africa,2008,ep,3544,4670,3998,8668
South Africa,2008,ep,4554,2694,2345,5039
South Africa,2008,ep,5564,1894,1686,3580
South Africa,2008,ep,65,987,942,1929
South Africa,2008,sn,014,14856,14640,29496
South Africa,2008,sn,1524,10888,9870,20758
South Africa,2008,sn,2534,15868,14816,30684
South Africa,2008,sn,3544,9880,10644,20524
South Africa,2008,sn,4554,7988,6879,14867
South Africa,2008,sn,5564,4719,5636,10355
South Africa,2008,sn,65,2943,3345,6288
South Africa,2008,sp,014,2360,1863,4223
South Africa,2008,sp,1524,14010,10172,24182
South Africa,2008,sp,2534,21579,21706,43285
South Africa,2008,sp,3544,13778,20699,34477
South Africa,2008,sp,4554,7146,12724,19870
South Africa,2008,sp,5564,3234,5169,8403
South Africa,2008,sp,65,2117,2246,4363
South Africa,2009,ep,014,6960,7869,14829
South Africa,2009,ep,1524,7866,8558,16424
South Africa,2009,ep,2534,9999,11843,21842
South Africa,2009,ep,3544,8697,9382,18079
South Africa,2009,ep,4554,6759,5875,12634
South Africa,2009,ep,5564,4684,3957,8641
South Africa,2009,ep,65,2548,2120,4668
South Africa,2009,sn,014,15641,15312,30953
South Africa,2009,sn,1524,12877,10950,23827
South Africa,2009,sn,2534,16885,15950,32835
South Africa,2009,sn,3544,10925,11747,22672
South Africa,2009,sn,4554,8744,7448,16192
South Africa,2009,sn,5564,5633,6790,12423
South Africa,2009,sn,65,3848,4437,8285
South Africa,2009,sp,014,2358,1685,4043
South Africa,2009,sp,1524,14361,8609,22970
South Africa,2009,sp,2534,21944,22620,44564
South Africa,2009,sp,3544,13777,21164,34941
South Africa,2009,sp,4554,7114,12949,20063
South Africa,2009,sp,5564,3320,5256,8576
South Africa,2009,sp,65,2106,2207,4313
South Africa,2010,ep,014,1474,1810,3284
South Africa,2010,ep,1524,4716,2485,7201
South Africa,2010,ep,2534,10759,8500,19259
South Africa,2010,ep,3544,12277,8270,20547
South Africa,2010,ep,4554,3423,4444,7867
South Africa,2010,ep,5564,1498,1948,3446
South Africa,2010,ep,65,1007,1154,2161
South Africa,2010,sn,014,21406,22355,43761
South Africa,2010,sn,1524,10406,5489,15895
South Africa,2010,sn,2534,22281,17584,39865
South Africa,2010,sn,3544,15293,18741,34034
South Africa,2010,sn,4554,8186,11895,20081
South Africa,2010,sn,5564,3695,5981,9676
South Africa,2010,sn,65,2633,3175,5808
South Africa,2010,sp,014,1933,1496,3429
South Africa,2010,sp,1524,13023,9925,22948
South Africa,2010,sp,2534,20205,20855,41060
South Africa,2010,sp,3544,12910,19842,32752
South Africa,2010,sp,4554,6873,12386,19259
South Africa,2010,sp,5564,3165,5155,8320
South Africa,2010,sp,65,2128,2211,4339
South Africa,2011,ep,014,1127,1272,2399
South Africa,2011,ep,1524,2871,1730,4601
South Africa,2011,ep,2534,6670,5673,12343
South Africa,2011,ep,3544,4651,5501,10152
South Africa,2011,ep,4554,2244,3038,5282
South Africa,2011,ep,5564,992,1414,2406
South Africa,2011,ep,65,636,709,1345
South Africa,2011,sn,014,15699,16381,32080
South Africa,2011,sn,1524,6853,3682,10535
South Africa,2011,sn,2534,15343,12442,27785
South Africa,2011,sn,3544,10678,13486,24164
South Africa,2011,sn,4554,5872,8520,14392
South Africa,2011,sn,5564,2909,4565,7474
South Africa,2011,sn,65,1971,2412,4383
South Africa,2011,sp,014,1932,1472,3404
South Africa,2011,sp,1524,12751,9772,22523
South Africa,2011,sp,2534,19250,20487,39737
South Africa,2011,sp,3544,12807,19360,32167
South Africa,2011,sp,4554,6955,12111,19066
South Africa,2011,sp,5564,3266,5220,8486
South Africa,2011,sp,65,2223,2164,4387
South Africa,2012,ep,014,1081,1246,2327
South Africa,2012,ep,1524,3072,1854,4926
South Africa,2012,ep,2534,7290,6304,13594
South Africa,2012,ep,3544,4952,6323,11275
South Africa,2012,ep,4554,2491,3495,5986
South Africa,2012,ep,5564,1118,1591,2709
South Africa,2012,ep,65,791,859,1650
South Africa,2012,sn,014,16383,17218,33601
South Africa,2012,sn,1524,7489,4510,11999
South Africa,2012,sn,2534,16536,14507,31043
South Africa,2012,sn,3544,11769,15734,27503
South Africa,2012,sn,4554,6378,10171,16549
South Africa,2012,sn,5564,3214,5340,8554
South Africa,2012,sn,65,2497,2885,5382
South Africa,2012,sp,014,1545,1132,2677
South Africa,2012,sp,1524,11547,9074,20621
South Africa,2012,sp,2534,17452,19894,37346
South Africa,2012,sp,3544,11430,18510,29940
South Africa,2012,sp,4554,5939,11331,17270
South Africa,2012,sp,5564,2846,5054,7900
South Africa,2012,sp,65,2059,2085,4144
South Africa,2013,rel,014,18054,18617,36671
South Africa,2013,rel,1524,21166,16120,37286
South Africa,2013,rel,2534,41071,43685,84756
South Africa,2013,rel,3544,29297,45922,75219
South Africa,2013,rel,4554,15910,28497,44407
South Africa,2013,rel,5564,7807,13923,21730
South Africa,2013,rel,65,5672,6639,12311
South Sudan,2011,sp,014,60,39,99
South Sudan,2011,sp,1524,181,251,432
South Sudan,2011,sp,2534,318,599,917
South Sudan,2011,sp,3544,239,402,641
South Sudan,2011,sp,4554,172,259,431
South Sudan,2011,sp,5564,59,135,194
South Sudan,2011,sp,65,26,57,83
South Sudan,2012,sp,014,58,42,100
South Sudan,2012,sp,1524,212,356,568
South Sudan,2012,sp,2534,302,753,1055
South Sudan,2012,sp,3544,221,462,683
South Sudan,2012,sp,4554,139,267,406
South Sudan,2012,sp,5564,62,135,197
South Sudan,2012,sp,65,24,87,111
South Sudan,2013,rel,014,68,43,111
South Sudan,2013,rel,1524,185,371,556
South Sudan,2013,rel,2534,302,721,1023
South Sudan,2013,rel,3544,204,447,651
South Sudan,2013,rel,4554,146,247,393
South Sudan,2013,rel,5564,67,118,185
South Sudan,2013,rel,65,26,87,113
Spain,1995,sp,014,23,22,45
Spain,1995,sp,1524,90,132,222
Spain,1995,sp,2534,129,337,466
Spain,1995,sp,3544,64,242,306
Spain,1995,sp,4554,39,150,189
Spain,1995,sp,5564,34,112,146
Spain,1995,sp,65,98,228,326
Spain,1998,sp,014,3,25,28
Spain,1998,sp,1524,149,186,335
Spain,1998,sp,2534,167,361,528
Spain,1998,sp,3544,61,294,355
Spain,1998,sp,4554,27,195,222
Spain,1998,sp,5564,25,114,139
Spain,1998,sp,65,104,205,309
Spain,2001,sp,014,15,13,28
Spain,2001,sp,1524,140,160,300
Spain,2001,sp,2534,237,355,592
Spain,2001,sp,3544,116,351,467
Spain,2001,sp,4554,37,215,252
Spain,2001,sp,5564,21,134,155
Spain,2001,sp,65,83,232,315
Spain,2002,sp,014,17,22,39
Spain,2002,sp,1524,194,189,383
Spain,2002,sp,2534,265,392,657
Spain,2002,sp,3544,131,405,536
Spain,2002,sp,4554,56,300,356
Spain,2002,sp,5564,29,192,221
Spain,2002,sp,65,117,337,454
Spain,2003,sp,014,6,7,13
Spain,2003,sp,1524,138,153,291
Spain,2003,sp,2534,218,334,552
Spain,2003,sp,3544,113,305,418
Spain,2003,sp,4554,51,219,270
Spain,2003,sp,5564,29,132,161
Spain,2003,sp,65,87,222,309
Spain,2004,sp,014,9,14,23
Spain,2004,sp,1524,158,140,298
Spain,2004,sp,2534,202,301,503
Spain,2004,sp,3544,125,312,437
Spain,2004,sp,4554,48,229,277
Spain,2004,sp,5564,22,142,164
Spain,2004,sp,65,82,227,309
Spain,2005,sp,014,10,13,23
Spain,2005,sp,1524,142,166,308
Spain,2005,sp,2534,252,394,646
Spain,2005,sp,3544,151,367,518
Spain,2005,sp,4554,63,230,293
Spain,2005,sp,5564,24,140,164
Spain,2005,sp,65,108,230,338
Spain,2006,ep,014,25,32,57
Spain,2006,ep,1524,55,88,143
Spain,2006,ep,2534,118,166,284
Spain,2006,ep,3544,86,146,232
Spain,2006,ep,4554,58,100,158
Spain,2006,ep,5564,48,81,129
Spain,2006,ep,65,186,185,371
Spain,2006,sn,014,212,228,440
Spain,2006,sn,1524,248,241,489
Spain,2006,sn,2534,383,495,878
Spain,2006,sn,3544,241,572,813
Spain,2006,sn,4554,112,388,500
Spain,2006,sn,5564,77,248,325
Spain,2006,sn,65,224,513,737
Spain,2006,sp,014,17,18,35
Spain,2006,sp,1524,122,142,264
Spain,2006,sp,2534,264,332,596
Spain,2006,sp,3544,137,311,448
Spain,2006,sp,4554,48,232,280
Spain,2006,sp,5564,19,105,124
Spain,2006,sp,65,77,175,252
Spain,2007,ep,014,35,32,67
Spain,2007,ep,1524,95,79,174
Spain,2007,ep,2534,139,173,312
Spain,2007,ep,3544,90,163,253
Spain,2007,ep,4554,50,74,124
Spain,2007,ep,5564,57,73,130
Spain,2007,ep,65,177,158,335
Spain,2007,sn,014,187,180,367
Spain,2007,sn,1524,172,313,485
Spain,2007,sn,2534,302,357,659
Spain,2007,sn,3544,182,431,613
Spain,2007,sn,4554,83,289,372
Spain,2007,sn,5564,77,220,297
Spain,2007,sn,65,227,438,665
Spain,2007,sp,014,12,10,22
Spain,2007,sp,1524,164,184,348
Spain,2007,sp,2534,291,375,666
Spain,2007,sp,3544,136,379,515
Spain,2007,sp,4554,63,257,320
Spain,2007,sp,5564,23,128,151
Spain,2007,sp,65,93,191,284
Spain,2008,ep,014,42,45,87
Spain,2008,ep,1524,83,117,200
Spain,2008,ep,2534,137,213,350
Spain,2008,ep,3544,111,187,298
Spain,2008,ep,4554,58,100,158
Spain,2008,ep,5564,51,77,128
Spain,2008,ep,65,179,177,356
Spain,2008,sn,014,199,225,424
Spain,2008,sn,1524,158,190,348
Spain,2008,sn,2534,240,315,555
Spain,2008,sn,3544,163,337,500
Spain,2008,sn,4554,87,260,347
Spain,2008,sn,5564,60,187,247
Spain,2008,sn,65,124,300,424
Spain,2008,sp,014,13,18,31
Spain,2008,sp,1524,168,179,347
Spain,2008,sp,2534,294,355,649
Spain,2008,sp,3544,173,349,522
Spain,2008,sp,4554,68,268,336
Spain,2008,sp,5564,16,157,173
Spain,2008,sp,65,73,200,273
Spain,2009,ep,014,0,0,0
Spain,2009,ep,1524,0,0,0
Spain,2009,ep,2534,0,0,0
Spain,2009,ep,3544,0,0,0
Spain,2009,ep,4554,0,0,0
Spain,2009,ep,5564,0,0,0
Spain,2009,ep,65,0,0,0
Spain,2009,sn,014,0,0,0
Spain,2009,sn,1524,0,0,0
Spain,2009,sn,2534,0,0,0
Spain,2009,sn,3544,0,0,0
Spain,2009,sn,4554,0,0,0
Spain,2009,sn,5564,0,0,0
Spain,2009,sn,65,0,0,0
Spain,2009,sp,014,0,0,0
Spain,2009,sp,1524,0,0,0
Spain,2009,sp,2534,0,0,0
Spain,2009,sp,3544,0,0,0
Spain,2009,sp,4554,0,0,0
Spain,2009,sp,5564,0,0,0
Spain,2009,sp,65,0,0,0
Spain,2010,ep,014,41,53,94
Spain,2010,ep,1524,94,81,175
Spain,2010,ep,2534,154,231,385
Spain,2010,ep,3544,124,195,319
Spain,2010,ep,4554,73,115,188
Spain,2010,ep,5564,75,87,162
Spain,2010,ep,65,234,197,431
Spain,2010,sn,014,153,194,347
Spain,2010,sn,1524,93,102,195
Spain,2010,sn,2534,197,265,462
Spain,2010,sn,3544,120,249,369
Spain,2010,sn,4554,72,232,304
Spain,2010,sn,5564,59,139,198
Spain,2010,sn,65,149,306,455
Spain,2010,sp,014,18,8,26
Spain,2010,sp,1524,157,160,317
Spain,2010,sp,2534,290,373,663
Spain,2010,sp,3544,170,349,519
Spain,2010,sp,4554,69,357,426
Spain,2010,sp,5564,26,172,198
Spain,2010,sp,65,84,207,291
Spain,2011,ep,014,59,60,119
Spain,2011,ep,1524,66,79,145
Spain,2011,ep,2534,109,221,330
Spain,2011,ep,3544,125,178,303
Spain,2011,ep,4554,100,110,210
Spain,2011,ep,5564,60,71,131
Spain,2011,ep,65,213,215,428
Spain,2011,sn,014,172,209,381
Spain,2011,sn,1524,99,116,215
Spain,2011,sn,2534,167,202,369
Spain,2011,sn,3544,148,230,378
Spain,2011,sn,4554,74,196,270
Spain,2011,sn,5564,54,138,192
Spain,2011,sn,65,127,300,427
Spain,2011,sp,014,16,14,30
Spain,2011,sp,1524,143,136,279
Spain,2011,sp,2534,255,329,584
Spain,2011,sp,3544,163,304,467
Spain,2011,sp,4554,80,282,362
Spain,2011,sp,5564,30,168,198
Spain,2011,sp,65,99,199,298
Spain,2012,ep,014,38,35,73
Spain,2012,ep,1524,71,71,142
Spain,2012,ep,2534,138,164,302
Spain,2012,ep,3544,140,162,302
Spain,2012,ep,4554,75,104,179
Spain,2012,ep,5564,54,85,139
Spain,2012,ep,65,173,196,369
Spain,2012,sn,014,120,125,245
Spain,2012,sn,1524,72,92,164
Spain,2012,sn,2534,141,172,313
Spain,2012,sn,3544,118,175,293
Spain,2012,sn,4554,70,166,236
Spain,2012,sn,5564,50,133,183
Spain,2012,sn,65,114,297,411
Spain,2012,sp,014,15,10,25
Spain,2012,sp,1524,101,112,213
Spain,2012,sp,2534,202,259,461
Spain,2012,sp,3544,161,299,460
Spain,2012,sp,4554,70,276,346
Spain,2012,sp,5564,24,156,180
Spain,2012,sp,65,74,220,294
Spain,2013,rel,014,179,198,377
Spain,2013,rel,1524,228,259,487
Spain,2013,rel,2534,490,524,1014
Spain,2013,rel,3544,409,614,1023
Spain,2013,rel,4554,220,545,765
Spain,2013,rel,5564,159,352,511
Spain,2013,rel,65,427,620,1047
Sri Lanka,1995,sp,014,15,10,25
Sri Lanka,1995,sp,1524,207,163,370
Sri Lanka,1995,sp,2534,206,361,567
Sri Lanka,1995,sp,3544,142,519,661
Sri Lanka,1995,sp,4554,122,521,643
Sri Lanka,1995,sp,5564,81,365,446
Sri Lanka,1995,sp,65,56,261,317
Sri Lanka,1996,sp,014,18,10,28
Sri Lanka,1996,sp,1524,197,163,360
Sri Lanka,1996,sp,2534,168,327,495
Sri Lanka,1996,sp,3544,147,491,638
Sri Lanka,1996,sp,4554,133,523,656
Sri Lanka,1996,sp,5564,111,355,466
Sri Lanka,1996,sp,65,62,253,315
Sri Lanka,1997,sp,014,23,11,34
Sri Lanka,1997,sp,1524,245,215,460
Sri Lanka,1997,sp,2534,217,390,607
Sri Lanka,1997,sp,3544,173,596,769
Sri Lanka,1997,sp,4554,176,623,799
Sri Lanka,1997,sp,5564,89,396,485
Sri Lanka,1997,sp,65,81,271,352
Sri Lanka,1998,sp,014,22,7,29
Sri Lanka,1998,sp,1524,228,237,465
Sri Lanka,1998,sp,2534,235,430,665
Sri Lanka,1998,sp,3544,169,628,797
Sri Lanka,1998,sp,4554,173,663,836
Sri Lanka,1998,sp,5564,119,445,564
Sri Lanka,1998,sp,65,87,304,391
Sri Lanka,1999,sp,014,10,8,18
Sri Lanka,1999,sp,1524,264,255,519
Sri Lanka,1999,sp,2534,231,406,637
Sri Lanka,1999,sp,3544,168,621,789
Sri Lanka,1999,sp,4554,148,646,794
Sri Lanka,1999,sp,5564,126,440,566
Sri Lanka,1999,sp,65,101,325,426
Sri Lanka,2000,sp,014,23,25,48
Sri Lanka,2000,sp,1524,312,266,578
Sri Lanka,2000,sp,2534,264,459,723
Sri Lanka,2000,sp,3544,176,695,871
Sri Lanka,2000,sp,4554,202,793,995
Sri Lanka,2000,sp,5564,144,484,628
Sri Lanka,2000,sp,65,113,360,473
Sri Lanka,2001,sp,014,18,6,24
Sri Lanka,2001,sp,1524,296,284,580
Sri Lanka,2001,sp,2534,247,446,693
Sri Lanka,2001,sp,3544,194,713,907
Sri Lanka,2001,sp,4554,174,779,953
Sri Lanka,2001,sp,5564,156,528,684
Sri Lanka,2001,sp,65,131,336,467
Sri Lanka,2002,sp,014,19,11,30
Sri Lanka,2002,sp,1524,320,287,607
Sri Lanka,2002,sp,2534,248,411,659
Sri Lanka,2002,sp,3544,205,682,887
Sri Lanka,2002,sp,4554,151,788,939
Sri Lanka,2002,sp,5564,151,551,702
Sri Lanka,2002,sp,65,107,366,473
Sri Lanka,2003,sp,014,14,12,26
Sri Lanka,2003,sp,1524,305,311,616
Sri Lanka,2003,sp,2534,218,467,685
Sri Lanka,2003,sp,3544,186,694,880
Sri Lanka,2003,sp,4554,187,791,978
Sri Lanka,2003,sp,5564,132,495,627
Sri Lanka,2003,sp,65,120,389,509
Sri Lanka,2004,sp,014,18,6,24
Sri Lanka,2004,sp,1524,263,358,621
Sri Lanka,2004,sp,2534,237,472,709
Sri Lanka,2004,sp,3544,192,664,856
Sri Lanka,2004,sp,4554,176,800,976
Sri Lanka,2004,sp,5564,122,521,643
Sri Lanka,2004,sp,65,102,371,473
Sri Lanka,2005,sp,014,19,9,28
Sri Lanka,2005,sp,1524,295,341,636
Sri Lanka,2005,sp,2534,261,520,781
Sri Lanka,2005,sp,3544,189,724,913
Sri Lanka,2005,sp,4554,200,918,1118
Sri Lanka,2005,sp,5564,154,657,811
Sri Lanka,2005,sp,65,130,424,554
Sri Lanka,2006,ep,014,100,127,227
Sri Lanka,2006,ep,1524,161,157,318
Sri Lanka,2006,ep,2534,195,206,401
Sri Lanka,2006,ep,3544,160,171,331
Sri Lanka,2006,ep,4554,150,132,282
Sri Lanka,2006,ep,5564,84,120,204
Sri Lanka,2006,ep,65,71,100,171
Sri Lanka,2006,sn,014,47,55,102
Sri Lanka,2006,sn,1524,85,67,152
Sri Lanka,2006,sn,2534,85,125,210
Sri Lanka,2006,sn,3544,85,152,237
Sri Lanka,2006,sn,4554,116,244,360
Sri Lanka,2006,sn,5564,125,266,391
Sri Lanka,2006,sn,65,139,292,431
Sri Lanka,2006,sp,014,13,8,21
Sri Lanka,2006,sp,1524,301,342,643
Sri Lanka,2006,sp,2534,248,496,744
Sri Lanka,2006,sp,3544,178,600,778
Sri Lanka,2006,sp,4554,189,816,1005
Sri Lanka,2006,sp,5564,157,563,720
Sri Lanka,2006,sp,65,129,402,531
Sri Lanka,2007,ep,014,77,87,164
Sri Lanka,2007,ep,1524,161,161,322
Sri Lanka,2007,ep,2534,200,207,407
Sri Lanka,2007,ep,3544,178,168,346
Sri Lanka,2007,ep,4554,158,170,328
Sri Lanka,2007,ep,5564,113,134,247
Sri Lanka,2007,ep,65,67,94,161
Sri Lanka,2007,sn,014,71,65,136
Sri Lanka,2007,sn,1524,95,90,185
Sri Lanka,2007,sn,2534,90,145,235
Sri Lanka,2007,sn,3544,92,174,266
Sri Lanka,2007,sn,4554,119,251,370
Sri Lanka,2007,sn,5564,129,254,383
Sri Lanka,2007,sn,65,121,270,391
Sri Lanka,2007,sp,014,16,10,26
Sri Lanka,2007,sp,1524,279,288,567
Sri Lanka,2007,sp,2534,228,477,705
Sri Lanka,2007,sp,3544,183,664,847
Sri Lanka,2007,sp,4554,182,802,984
Sri Lanka,2007,sp,5564,176,649,825
Sri Lanka,2007,sp,65,111,412,523
Sri Lanka,2008,ep,014,101,101,202
Sri Lanka,2008,ep,1524,174,171,345
Sri Lanka,2008,ep,2534,232,239,471
Sri Lanka,2008,ep,3544,180,187,367
Sri Lanka,2008,ep,4554,145,204,349
Sri Lanka,2008,ep,5564,117,124,241
Sri Lanka,2008,ep,65,73,113,186
Sri Lanka,2008,sn,014,65,75,140
Sri Lanka,2008,sn,1524,90,98,188
Sri Lanka,2008,sn,2534,91,146,237
Sri Lanka,2008,sn,3544,105,177,282
Sri Lanka,2008,sn,4554,160,284,444
Sri Lanka,2008,sn,5564,137,272,409
Sri Lanka,2008,sn,65,126,305,431
Sri Lanka,2008,sp,014,26,11,37
Sri Lanka,2008,sp,1524,298,283,581
Sri Lanka,2008,sp,2534,288,488,776
Sri Lanka,2008,sp,3544,183,717,900
Sri Lanka,2008,sp,4554,173,810,983
Sri Lanka,2008,sp,5564,172,649,821
Sri Lanka,2008,sp,65,133,415,548
Sri Lanka,2009,ep,014,99,126,225
Sri Lanka,2009,ep,1524,182,158,340
Sri Lanka,2009,ep,2534,247,264,511
Sri Lanka,2009,ep,3544,160,194,354
Sri Lanka,2009,ep,4554,176,202,378
Sri Lanka,2009,ep,5564,134,195,329
Sri Lanka,2009,ep,65,75,140,215
Sri Lanka,2009,sn,014,61,72,133
Sri Lanka,2009,sn,1524,98,81,179
Sri Lanka,2009,sn,2534,96,110,206
Sri Lanka,2009,sn,3544,92,149,241
Sri Lanka,2009,sn,4554,116,280,396
Sri Lanka,2009,sn,5564,119,287,406
Sri Lanka,2009,sn,65,156,269,425
Sri Lanka,2009,sp,014,24,10,34
Sri Lanka,2009,sp,1524,244,328,572
Sri Lanka,2009,sp,2534,241,576,817
Sri Lanka,2009,sp,3544,172,703,875
Sri Lanka,2009,sp,4554,186,860,1046
Sri Lanka,2009,sp,5564,163,689,852
Sri Lanka,2009,sp,65,144,414,558
Sri Lanka,2010,ep,014,117,119,236
Sri Lanka,2010,ep,1524,175,179,354
Sri Lanka,2010,ep,2534,210,273,483
Sri Lanka,2010,ep,3544,187,254,441
Sri Lanka,2010,ep,4554,187,249,436
Sri Lanka,2010,ep,5564,131,207,338
Sri Lanka,2010,ep,65,102,158,260
Sri Lanka,2010,sn,014,59,68,127
Sri Lanka,2010,sn,1524,103,86,189
Sri Lanka,2010,sn,2534,109,121,230
Sri Lanka,2010,sn,3544,91,162,253
Sri Lanka,2010,sn,4554,124,277,401
Sri Lanka,2010,sn,5564,168,282,450
Sri Lanka,2010,sn,65,179,316,495
Sri Lanka,2010,sp,014,15,14,29
Sri Lanka,2010,sp,1524,255,268,523
Sri Lanka,2010,sp,2534,233,539,772
Sri Lanka,2010,sp,3544,171,602,773
Sri Lanka,2010,sp,4554,183,884,1067
Sri Lanka,2010,sp,5564,186,683,869
Sri Lanka,2010,sp,65,154,448,602
Sri Lanka,2011,ep,014,72,100,172
Sri Lanka,2011,ep,1524,185,179,364
Sri Lanka,2011,ep,2534,248,295,543
Sri Lanka,2011,ep,3544,190,263,453
Sri Lanka,2011,ep,4554,200,243,443
Sri Lanka,2011,ep,5564,150,209,359
Sri Lanka,2011,ep,65,114,164,278
Sri Lanka,2011,sn,014,91,64,155
Sri Lanka,2011,sn,1524,109,104,213
Sri Lanka,2011,sn,2534,106,145,251
Sri Lanka,2011,sn,3544,99,198,297
Sri Lanka,2011,sn,4554,146,267,413
Sri Lanka,2011,sn,5564,202,351,553
Sri Lanka,2011,sn,65,194,329,523
Sri Lanka,2011,sp,014,13,12,25
Sri Lanka,2011,sp,1524,270,246,516
Sri Lanka,2011,sp,2534,217,459,676
Sri Lanka,2011,sp,3544,191,585,776
Sri Lanka,2011,sp,4554,192,828,1020
Sri Lanka,2011,sp,5564,191,653,844
Sri Lanka,2011,sp,65,154,479,633
Sri Lanka,2012,ep,014,76,112,188
Sri Lanka,2012,ep,1524,153,157,310
Sri Lanka,2012,ep,2534,182,255,437
Sri Lanka,2012,ep,3544,181,227,408
Sri Lanka,2012,ep,4554,189,238,427
Sri Lanka,2012,ep,5564,151,190,341
Sri Lanka,2012,ep,65,102,136,238
Sri Lanka,2012,sn,014,62,35,97
Sri Lanka,2012,sn,1524,74,78,152
Sri Lanka,2012,sn,2534,70,115,185
Sri Lanka,2012,sn,3544,74,120,194
Sri Lanka,2012,sn,4554,107,255,362
Sri Lanka,2012,sn,5564,130,334,464
Sri Lanka,2012,sn,65,153,282,435
Sri Lanka,2012,sp,014,17,7,24
Sri Lanka,2012,sp,1524,242,243,485
Sri Lanka,2012,sp,2534,200,420,620
Sri Lanka,2012,sp,3544,162,504,666
Sri Lanka,2012,sp,4554,211,799,1010
Sri Lanka,2012,sp,5564,200,672,872
Sri Lanka,2012,sp,65,136,456,592
Sri Lanka,2013,rel,014,152,158,310
Sri Lanka,2013,rel,1524,482,502,984
Sri Lanka,2013,rel,2534,500,869,1369
Sri Lanka,2013,rel,3544,417,1007,1424
Sri Lanka,2013,rel,4554,511,1295,1806
Sri Lanka,2013,rel,5564,538,1175,1713
Sri Lanka,2013,rel,65,418,986,1404
Sudan,1995,sp,014,359,250,609
Sudan,1995,sp,1524,490,604,1094
Sudan,1995,sp,2534,613,796,1409
Sudan,1995,sp,3544,299,634,933
Sudan,1995,sp,4554,403,486,889
Sudan,1995,sp,5564,342,362,704
Sudan,1995,sp,65,305,337,642
Sudan,1998,sp,014,680,805,1485
Sudan,1998,sp,1524,875,1079,1954
Sudan,1998,sp,2534,1036,1533,2569
Sudan,1998,sp,3544,723,1133,1856
Sudan,1998,sp,4554,528,820,1348
Sudan,1998,sp,5564,356,523,879
Sudan,1998,sp,65,247,453,700
Sudan,1999,sp,014,903,842,1745
Sudan,1999,sp,1524,1035,1100,2135
Sudan,1999,sp,2534,1111,1456,2567
Sudan,1999,sp,3544,1104,1270,2374
Sudan,1999,sp,4554,817,978,1795
Sudan,1999,sp,5564,594,841,1435
Sudan,1999,sp,65,615,839,1454
Sudan,2000,sp,014,817,785,1602
Sudan,2000,sp,1524,925,1028,1953
Sudan,2000,sp,2534,1134,1511,2645
Sudan,2000,sp,3544,905,1351,2256
Sudan,2000,sp,4554,771,1119,1890
Sudan,2000,sp,5564,327,638,965
Sudan,2000,sp,65,323,677,1000
Sudan,2001,sp,014,590,732,1322
Sudan,2001,sp,1524,787,1018,1805
Sudan,2001,sp,2534,910,1368,2278
Sudan,2001,sp,3544,715,1085,1800
Sudan,2001,sp,4554,467,777,1244
Sudan,2001,sp,5564,212,462,674
Sudan,2001,sp,65,58,301,359
Sudan,2002,sp,014,498,559,1057
Sudan,2002,sp,1524,865,1171,2036
Sudan,2002,sp,2534,1007,1494,2501
Sudan,2002,sp,3544,840,1168,2008
Sudan,2002,sp,4554,523,852,1375
Sudan,2002,sp,5564,275,511,786
Sudan,2002,sp,65,170,405,575
Sudan,2003,sp,014,443,489,932
Sudan,2003,sp,1524,881,1195,2076
Sudan,2003,sp,2534,1052,1644,2696
Sudan,2003,sp,3544,879,1271,2150
Sudan,2003,sp,4554,562,856,1418
Sudan,2003,sp,5564,384,645,1029
Sudan,2003,sp,65,219,473,692
Sudan,2004,sp,014,426,537,963
Sudan,2004,sp,1524,978,1377,2355
Sudan,2004,sp,2534,1187,1791,2978
Sudan,2004,sp,3544,897,1465,2362
Sudan,2004,sp,4554,601,1035,1636
Sudan,2004,sp,5564,400,697,1097
Sudan,2004,sp,65,237,467,704
Sudan,2005,sp,014,381,425,806
Sudan,2005,sp,1524,1102,1358,2460
Sudan,2005,sp,2534,1203,1990,3193
Sudan,2005,sp,3544,978,1541,2519
Sudan,2005,sp,4554,729,1151,1880
Sudan,2005,sp,5564,411,724,1135
Sudan,2005,sp,65,244,493,737
Sudan,2006,sp,014,312,297,609
Sudan,2006,sp,1524,965,1351,2316
Sudan,2006,sp,2534,1108,1890,2998
Sudan,2006,sp,3544,948,1504,2452
Sudan,2006,sp,4554,763,1102,1865
Sudan,2006,sp,5564,442,710,1152
Sudan,2006,sp,65,270,532,802
Sudan,2007,ep,014,61,84,145
Sudan,2007,ep,1524,75,92,167
Sudan,2007,ep,2534,81,108,189
Sudan,2007,ep,3544,76,151,227
Sudan,2007,ep,4554,42,56,98
Sudan,2007,ep,5564,19,28,47
Sudan,2007,ep,65,13,21,34
Sudan,2007,sn,014,970,1214,2184
Sudan,2007,sn,1524,91,129,220
Sudan,2007,sn,2534,108,221,329
Sudan,2007,sn,3544,121,243,364
Sudan,2007,sn,4554,97,192,289
Sudan,2007,sn,5564,66,98,164
Sudan,2007,sn,65,26,42,68
Sudan,2007,sp,014,334,288,622
Sudan,2007,sp,1524,992,1355,2347
Sudan,2007,sp,2534,1318,1903,3221
Sudan,2007,sp,3544,990,1540,2530
Sudan,2007,sp,4554,729,1102,1831
Sudan,2007,sp,5564,467,729,1196
Sudan,2007,sp,65,324,556,880
Sudan,2008,ep,014,239,315,554
Sudan,2008,ep,1524,1437,1857,3294
Sudan,2008,sn,014,571,959,1530
Sudan,2008,sn,1524,2095,3202,5297
Sudan,2008,sp,014,321,317,638
Sudan,2008,sp,1524,850,1241,2091
Sudan,2008,sp,2534,962,1740,2702
Sudan,2008,sp,3544,841,1301,2142
Sudan,2008,sp,4554,601,903,1504
Sudan,2008,sp,5564,344,610,954
Sudan,2008,sp,65,235,534,769
Sudan,2009,ep,014,357,463,820
Sudan,2009,ep,1524,1584,2082,3666
Sudan,2009,sn,014,827,965,1792
Sudan,2009,sn,1524,2122,3269,5391
Sudan,2009,sp,014,236,288,524
Sudan,2009,sp,1524,806,1279,2085
Sudan,2009,sp,2534,983,1757,2740
Sudan,2009,sp,3544,800,1281,2081
Sudan,2009,sp,4554,557,904,1461
Sudan,2009,sp,5564,334,606,940
Sudan,2009,sp,65,233,477,710
Sudan,2010,sp,014,195,209,404
Sudan,2010,sp,1524,761,1185,1946
Sudan,2010,sp,2534,979,1781,2760
Sudan,2010,sp,3544,772,1335,2107
Sudan,2010,sp,4554,520,863,1383
Sudan,2010,sp,5564,279,497,776
Sudan,2010,sp,65,191,391,582
Sudan,2011,ep,014,321,416,737
Sudan,2011,ep,1524,1677,2210,3887
Sudan,2011,ep,2534,0,0,0
Sudan,2011,ep,3544,0,0,0
Sudan,2011,ep,4554,0,0,0
Sudan,2011,ep,5564,0,0,0
Sudan,2011,ep,65,0,0,0
Sudan,2011,sn,014,686,941,1627
Sudan,2011,sn,1524,1935,3184,5119
Sudan,2011,sn,2534,0,0,0
Sudan,2011,sn,3544,0,0,0
Sudan,2011,sn,4554,0,0,0
Sudan,2011,sn,5564,0,0,0
Sudan,2011,sn,65,0,0,0
Sudan,2011,sp,014,113,107,220
Sudan,2011,sp,1524,512,899,1411
Sudan,2011,sp,2534,620,1359,1979
Sudan,2011,sp,3544,513,981,1494
Sudan,2011,sp,4554,352,689,1041
Sudan,2011,sp,5564,188,386,574
Sudan,2011,sp,65,175,372,547
Sudan,2012,ep,014,299,424,723
Sudan,2012,sn,014,691,823,1514
Sudan,2012,sp,014,115,117,232
Sudan,2012,sp,1524,536,869,1405
Sudan,2012,sp,2534,562,1274,1836
Sudan,2012,sp,3544,470,802,1272
Sudan,2012,sp,4554,299,466,765
Sudan,2012,sp,5564,170,404,574
Sudan,2012,sp,65,172,331,503
Sudan,2013,rel,014,976,1205,2181
Suriname,1996,sp,014,2,1,3
Suriname,1996,sp,1524,3,5,8
Suriname,1996,sp,2534,6,11,17
Suriname,1996,sp,3544,5,11,16
Suriname,1996,sp,4554,0,0,0
Suriname,1996,sp,5564,3,4,7
Suriname,1996,sp,65,3,6,9
Suriname,1997,sp,014,0,0,0
Suriname,1997,sp,1524,4,6,10
Suriname,1997,sp,2534,1,7,8
Suriname,1997,sp,3544,0,3,3
Suriname,1997,sp,4554,1,2,3
Suriname,1997,sp,5564,0,0,0
Suriname,1997,sp,65,1,2,3
Suriname,2000,sp,014,2,1,3
Suriname,2000,sp,1524,3,6,9
Suriname,2000,sp,2534,6,6,12
Suriname,2000,sp,3544,3,3,6
Suriname,2000,sp,4554,0,2,2
Suriname,2000,sp,5564,1,0,1
Suriname,2000,sp,65,1,4,5
Suriname,2001,sp,014,0,1,1
Suriname,2001,sp,1524,2,2,4
Suriname,2001,sp,2534,5,7,12
Suriname,2001,sp,3544,3,3,6
Suriname,2001,sp,4554,2,2,4
Suriname,2001,sp,5564,0,4,4
Suriname,2001,sp,65,2,5,7
Suriname,2002,sp,014,0,2,2
Suriname,2002,sp,1524,3,1,4
Suriname,2002,sp,2534,2,12,14
Suriname,2002,sp,3544,4,10,14
Suriname,2002,sp,4554,2,2,4
Suriname,2002,sp,5564,0,3,3
Suriname,2002,sp,65,1,2,3
Suriname,2003,sp,014,1,0,1
Suriname,2003,sp,1524,4,5,9
Suriname,2003,sp,2534,2,1,3
Suriname,2003,sp,3544,2,13,15
Suriname,2003,sp,4554,2,6,8
Suriname,2003,sp,5564,1,1,2
Suriname,2003,sp,65,1,6,7
Suriname,2004,sp,014,0,0,0
Suriname,2004,sp,1524,3,6,9
Suriname,2004,sp,2534,2,8,10
Suriname,2004,sp,3544,1,14,15
Suriname,2004,sp,4554,1,6,7
Suriname,2004,sp,5564,1,2,3
Suriname,2004,sp,65,1,4,5
Suriname,2005,sp,014,0,0,0
Suriname,2005,sp,1524,3,7,10
Suriname,2005,sp,2534,2,8,10
Suriname,2005,sp,3544,1,12,13
Suriname,2005,sp,4554,2,6,8
Suriname,2005,sp,5564,1,3,4
Suriname,2005,sp,65,2,4,6
Suriname,2006,ep,014,1,0,1
Suriname,2006,ep,1524,1,2,3
Suriname,2006,ep,2534,3,0,3
Suriname,2006,ep,3544,3,3,6
Suriname,2006,ep,4554,0,0,0
Suriname,2006,ep,5564,0,2,2
Suriname,2006,ep,65,0,1,1
Suriname,2006,sn,014,1,0,1
Suriname,2006,sn,1524,1,2,3
Suriname,2006,sn,2534,3,4,7
Suriname,2006,sn,3544,3,3,6
Suriname,2006,sn,4554,1,8,9
Suriname,2006,sn,5564,4,2,6
Suriname,2006,sn,65,3,8,11
Suriname,2006,sp,014,2,5,7
Suriname,2006,sp,1524,1,6,7
Suriname,2006,sp,2534,4,13,17
Suriname,2006,sp,3544,1,9,10
Suriname,2006,sp,4554,8,4,12
Suriname,2006,sp,5564,0,1,1
Suriname,2006,sp,65,2,7,9
Suriname,2009,ep,014,0,0,0
Suriname,2009,ep,1524,1,1,2
Suriname,2009,ep,2534,1,0,1
Suriname,2009,ep,3544,1,2,3
Suriname,2009,ep,4554,0,0,0
Suriname,2009,ep,5564,0,2,2
Suriname,2009,ep,65,0,1,1
Suriname,2009,sn,014,1,0,1
Suriname,2009,sn,1524,2,1,3
Suriname,2009,sn,2534,0,0,0
Suriname,2009,sn,3544,2,1,3
Suriname,2009,sn,4554,1,1,2
Suriname,2009,sn,5564,1,3,4
Suriname,2009,sn,65,0,1,1
Suriname,2009,sp,014,1,2,3
Suriname,2009,sp,1524,5,11,16
Suriname,2009,sp,2534,13,17,30
Suriname,2009,sp,3544,11,21,32
Suriname,2009,sp,4554,11,20,31
Suriname,2009,sp,5564,11,11,22
Suriname,2009,sp,65,5,10,15
Suriname,2010,ep,014,0,3,3
Suriname,2010,ep,1524,0,2,2
Suriname,2010,ep,2534,1,2,3
Suriname,2010,ep,3544,1,1,2
Suriname,2010,ep,4554,2,0,2
Suriname,2010,ep,5564,1,0,1
Suriname,2010,ep,65,1,0,1
Suriname,2010,sn,014,2,1,3
Suriname,2010,sn,1524,2,1,3
Suriname,2010,sn,2534,4,6,10
Suriname,2010,sn,3544,3,6,9
Suriname,2010,sn,4554,3,5,8
Suriname,2010,sn,5564,0,4,4
Suriname,2010,sn,65,1,3,4
Suriname,2010,sp,014,1,0,1
Suriname,2010,sp,1524,4,5,9
Suriname,2010,sp,2534,6,21,27
Suriname,2010,sp,3544,10,35,45
Suriname,2010,sp,4554,6,19,25
Suriname,2010,sp,5564,2,5,7
Suriname,2010,sp,65,8,10,18
Suriname,2011,ep,014,0,1,1
Suriname,2011,ep,1524,0,0,0
Suriname,2011,ep,2534,1,3,4
Suriname,2011,ep,3544,4,6,10
Suriname,2011,ep,4554,0,2,2
Suriname,2011,ep,5564,0,0,0
Suriname,2011,ep,65,2,1,3
Suriname,2011,sn,014,0,1,1
Suriname,2011,sn,1524,0,0,0
Suriname,2011,sn,2534,6,5,11
Suriname,2011,sn,3544,3,5,8
Suriname,2011,sn,4554,2,4,6
Suriname,2011,sn,5564,2,1,3
Suriname,2011,sn,65,1,4,5
Suriname,2011,sp,014,0,0,0
Suriname,2011,sp,1524,1,4,5
Suriname,2011,sp,2534,1,7,8
Suriname,2011,sp,3544,5,15,20
Suriname,2011,sp,4554,2,18,20
Suriname,2011,sp,5564,2,3,5
Suriname,2011,sp,65,1,5,6
Suriname,2012,ep,014,1,0,1
Suriname,2012,ep,1524,0,1,1
Suriname,2012,ep,2534,0,2,2
Suriname,2012,ep,3544,0,5,5
Suriname,2012,ep,4554,0,1,1
Suriname,2012,ep,5564,0,1,1
Suriname,2012,ep,65,1,1,2
Suriname,2012,sn,014,1,2,3
Suriname,2012,sn,1524,1,2,3
Suriname,2012,sn,2534,1,2,3
Suriname,2012,sn,3544,1,6,7
Suriname,2012,sn,4554,0,1,1
Suriname,2012,sn,5564,3,3,6
Suriname,2012,sn,65,0,1,1
Suriname,2012,sp,014,2,0,2
Suriname,2012,sp,1524,1,6,7
Suriname,2012,sp,2534,7,7,14
Suriname,2012,sp,3544,5,15,20
Suriname,2012,sp,4554,7,14,21
Suriname,2012,sp,5564,1,9,10
Suriname,2012,sp,65,0,7,7
Suriname,2013,rel,014,6,6,12
Suriname,2013,rel,1524,5,9,14
Suriname,2013,rel,2534,13,18,31
Suriname,2013,rel,3544,6,28,34
Suriname,2013,rel,4554,4,28,32
Suriname,2013,rel,5564,1,13,14
Suriname,2013,rel,65,1,3,4
Swaziland,1995,sp,014,5,4,9
Swaziland,1995,sp,1524,52,59,111
Swaziland,1995,sp,2534,57,117,174
Swaziland,1995,sp,3544,39,130,169
Swaziland,1995,sp,4554,29,98,127
Swaziland,1995,sp,5564,8,40,48
Swaziland,1995,sp,65,6,16,22
Swaziland,1996,sp,014,64,79,143
Swaziland,1996,sp,1524,78,39,117
Swaziland,1996,sp,2534,352,250,602
Swaziland,1996,sp,3544,204,335,539
Swaziland,1996,sp,4554,114,263,377
Swaziland,1996,sp,5564,58,200,258
Swaziland,1996,sp,65,38,120,158
Swaziland,2000,sp,014,10,11,21
Swaziland,2000,sp,1524,198,130,328
Swaziland,2000,sp,2534,298,352,650
Swaziland,2000,sp,3544,62,249,311
Swaziland,2000,sp,4554,62,138,200
Swaziland,2000,sp,5564,24,37,61
Swaziland,2000,sp,65,5,17,22
Swaziland,2001,sp,014,22,16,38
Swaziland,2001,sp,1524,362,180,542
Swaziland,2001,sp,2534,474,468,942
Swaziland,2001,sp,3544,196,374,570
Swaziland,2001,sp,4554,74,238,312
Swaziland,2001,sp,5564,18,70,88
Swaziland,2001,sp,65,16,34,50
Swaziland,2002,sp,014,9,1,10
Swaziland,2002,sp,1524,236,94,330
Swaziland,2002,sp,2534,274,244,518
Swaziland,2002,sp,3544,127,182,309
Swaziland,2002,sp,4554,50,117,167
Swaziland,2002,sp,5564,13,33,46
Swaziland,2002,sp,65,9,10,19
Swaziland,2003,sp,014,14,15,29
Swaziland,2003,sp,1524,242,120,362
Swaziland,2003,sp,2534,325,298,623
Swaziland,2003,sp,3544,145,171,316
Swaziland,2003,sp,4554,60,96,156
Swaziland,2003,sp,5564,20,48,68
Swaziland,2003,sp,65,8,19,27
Swaziland,2004,sp,014,17,6,23
Swaziland,2004,sp,1524,271,152,423
Swaziland,2004,sp,2534,381,316,697
Swaziland,2004,sp,3544,182,245,427
Swaziland,2004,sp,4554,74,140,214
Swaziland,2004,sp,5564,19,53,72
Swaziland,2004,sp,65,14,21,35
Swaziland,2005,sp,014,14,9,23
Swaziland,2005,sp,1524,318,162,480
Swaziland,2005,sp,2534,453,406,859
Swaziland,2005,sp,3544,207,285,492
Swaziland,2005,sp,4554,73,139,212
Swaziland,2005,sp,5564,21,57,78
Swaziland,2005,sp,65,8,27,35
Swaziland,2006,ep,014,53,55,108
Swaziland,2006,ep,1524,157,107,264
Swaziland,2006,ep,2534,277,276,553
Swaziland,2006,ep,3544,140,188,328
Swaziland,2006,ep,4554,56,111,167
Swaziland,2006,ep,5564,32,86,118
Swaziland,2006,ep,65,15,26,41
Swaziland,2006,sn,014,360,399,759
Swaziland,2006,sn,1524,301,199,500
Swaziland,2006,sn,2534,523,493,1016
Swaziland,2006,sn,3544,324,400,724
Swaziland,2006,sn,4554,148,249,397
Swaziland,2006,sn,5564,111,132,243
Swaziland,2006,sn,65,74,91,165
Swaziland,2006,sp,014,35,32,67
Swaziland,2006,sp,1524,367,187,554
Swaziland,2006,sp,2534,464,452,916
Swaziland,2006,sp,3544,245,268,513
Swaziland,2006,sp,4554,107,164,271
Swaziland,2006,sp,5564,48,91,139
Swaziland,2006,sp,65,25,45,70
Swaziland,2007,sp,1524,411,223,634
Swaziland,2007,sp,2534,576,479,1055
Swaziland,2007,sp,3544,232,344,576
Swaziland,2007,sp,4554,98,182,280
Swaziland,2007,sp,5564,39,57,96
Swaziland,2007,sp,65,18,27,45
Swaziland,2008,ep,014,0,0,0
Swaziland,2008,ep,1524,0,0,0
Swaziland,2008,ep,2534,0,0,0
Swaziland,2008,ep,3544,0,0,0
Swaziland,2008,ep,4554,0,0,0
Swaziland,2008,ep,5564,0,0,0
Swaziland,2008,ep,65,0,0,0
Swaziland,2008,sn,014,0,0,0
Swaziland,2008,sn,1524,0,0,0
Swaziland,2008,sn,2534,0,0,0
Swaziland,2008,sn,3544,0,0,0
Swaziland,2008,sn,4554,0,0,0
Swaziland,2008,sn,5564,0,0,0
Swaziland,2008,sn,65,0,0,0
Swaziland,2008,sp,014,39,29,68
Swaziland,2008,sp,1524,427,231,658
Swaziland,2008,sp,2534,663,552,1215
Swaziland,2008,sp,3544,309,357,666
Swaziland,2008,sp,4554,114,193,307
Swaziland,2008,sp,5564,57,80,137
Swaziland,2008,sp,65,19,35,54
Swaziland,2009,sp,014,54,26,80
Swaziland,2009,sp,1524,459,221,680
Swaziland,2009,sp,2534,759,637,1396
Swaziland,2009,sp,3544,353,417,770
Swaziland,2009,sp,4554,121,208,329
Swaziland,2009,sp,5564,57,109,166
Swaziland,2009,sp,65,32,45,77
Swaziland,2010,ep,014,57,65,122
Swaziland,2010,ep,1524,142,78,220
Swaziland,2010,ep,2534,279,293,572
Swaziland,2010,ep,3544,174,230,404
Swaziland,2010,ep,4554,54,104,158
Swaziland,2010,ep,5564,29,79,108
Swaziland,2010,ep,65,18,29,47
Swaziland,2010,sn,014,690,740,1430
Swaziland,2010,sn,1524,380,156,536
Swaziland,2010,sn,2534,630,540,1170
Swaziland,2010,sn,3544,390,492,882
Swaziland,2010,sn,4554,216,266,482
Swaziland,2010,sn,5564,152,197,349
Swaziland,2010,sn,65,89,126,215
Swaziland,2010,sp,014,51,30,81
Swaziland,2010,sp,1524,354,207,561
Swaziland,2010,sp,2534,662,537,1199
Swaziland,2010,sp,3544,276,369,645
Swaziland,2010,sp,4554,104,192,296
Swaziland,2010,sp,5564,54,109,163
Swaziland,2010,sp,65,16,50,66
Swaziland,2011,ep,014,39,44,83
Swaziland,2011,ep,1524,95,64,159
Swaziland,2011,ep,2534,298,254,552
Swaziland,2011,ep,3544,133,192,325
Swaziland,2011,ep,4554,61,87,148
Swaziland,2011,ep,5564,29,49,78
Swaziland,2011,ep,65,25,25,50
Swaziland,2011,sn,014,82,71,153
Swaziland,2011,sn,1524,148,69,217
Swaziland,2011,sn,2534,327,232,559
Swaziland,2011,sn,3544,175,218,393
Swaziland,2011,sn,4554,90,124,214
Swaziland,2011,sn,5564,66,86,152
Swaziland,2011,sn,65,52,90,142
Swaziland,2011,sp,014,35,16,51
Swaziland,2011,sp,1524,281,161,442
Swaziland,2011,sp,2534,495,459,954
Swaziland,2011,sp,3544,220,318,538
Swaziland,2011,sp,4554,86,158,244
Swaziland,2011,sp,5564,40,69,109
Swaziland,2011,sp,65,24,46,70
Swaziland,2012,ep,014,34,34,68
Swaziland,2012,ep,1524,93,46,139
Swaziland,2012,ep,2534,234,222,456
Swaziland,2012,ep,3544,131,171,302
Swaziland,2012,ep,4554,50,82,132
Swaziland,2012,ep,5564,17,46,63
Swaziland,2012,ep,65,20,29,49
Swaziland,2012,sn,014,298,362,660
Swaziland,2012,sn,1524,194,99,293
Swaziland,2012,sn,2534,446,411,857
Swaziland,2012,sn,3544,253,349,602
Swaziland,2012,sn,4554,119,197,316
Swaziland,2012,sn,5564,72,143,215
Swaziland,2012,sn,65,66,102,168
Swaziland,2012,sp,014,39,18,57
Swaziland,2012,sp,1524,284,163,447
Swaziland,2012,sp,2534,535,479,1014
Swaziland,2012,sp,3544,242,332,574
Swaziland,2012,sp,4554,88,168,256
Swaziland,2012,sp,5564,51,84,135
Swaziland,2012,sp,65,27,38,65
Swaziland,2013,rel,014,331,340,671
Swaziland,2013,rel,1524,517,302,819
Swaziland,2013,rel,2534,1087,1088,2175
Swaziland,2013,rel,3544,562,952,1514
Swaziland,2013,rel,4554,267,480,747
Swaziland,2013,rel,5564,156,302,458
Swaziland,2013,rel,65,113,194,307
Sweden,1995,sp,014,0,1,1
Sweden,1995,sp,1524,10,5,15
Sweden,1995,sp,2534,13,12,25
Sweden,1995,sp,3544,5,8,13
Sweden,1995,sp,4554,5,5,10
Sweden,1995,sp,5564,4,4,8
Sweden,1995,sp,65,14,27,41
Sweden,1996,sp,014,1,1,2
Sweden,1996,sp,1524,4,11,15
Sweden,1996,sp,2534,10,8,18
Sweden,1996,sp,3544,4,3,7
Sweden,1996,sp,4554,1,5,6
Sweden,1996,sp,5564,6,5,11
Sweden,1996,sp,65,14,17,31
Sweden,1997,sp,014,2,0,2
Sweden,1997,sp,1524,10,6,16
Sweden,1997,sp,2534,8,9,17
Sweden,1997,sp,3544,9,13,22
Sweden,1997,sp,4554,2,5,7
Sweden,1997,sp,5564,3,0,3
Sweden,1997,sp,65,11,16,27
Sweden,1998,sp,014,1,2,3
Sweden,1998,sp,1524,10,6,16
Sweden,1998,sp,2534,15,9,24
Sweden,1998,sp,3544,5,3,8
Sweden,1998,sp,4554,0,8,8
Sweden,1998,sp,5564,2,3,5
Sweden,1998,sp,65,18,15,33
Sweden,1999,sp,014,1,0,1
Sweden,1999,sp,1524,7,13,20
Sweden,1999,sp,2534,14,18,32
Sweden,1999,sp,3544,7,12,19
Sweden,1999,sp,4554,3,5,8
Sweden,1999,sp,5564,2,2,4
Sweden,1999,sp,65,10,22,32
Sweden,2000,sp,014,1,0,1
Sweden,2000,sp,1524,9,9,18
Sweden,2000,sp,2534,8,10,18
Sweden,2000,sp,3544,10,12,22
Sweden,2000,sp,4554,2,11,13
Sweden,2000,sp,5564,2,4,6
Sweden,2000,sp,65,15,25,40
Sweden,2001,sp,014,1,1,2
Sweden,2001,sp,1524,4,10,14
Sweden,2001,sp,2534,12,15,27
Sweden,2001,sp,3544,8,5,13
Sweden,2001,sp,4554,2,3,5
Sweden,2001,sp,5564,2,1,3
Sweden,2001,sp,65,18,23,41
Sweden,2002,sp,014,0,0,0
Sweden,2002,sp,1524,11,6,17
Sweden,2002,sp,2534,14,15,29
Sweden,2002,sp,3544,8,10,18
Sweden,2002,sp,4554,7,8,15
Sweden,2002,sp,5564,2,7,9
Sweden,2002,sp,65,13,8,21
Sweden,2003,sp,014,0,0,0
Sweden,2003,sp,1524,10,8,18
Sweden,2003,sp,2534,18,14,32
Sweden,2003,sp,3544,6,12,18
Sweden,2003,sp,4554,2,4,6
Sweden,2003,sp,5564,0,5,5
Sweden,2003,sp,65,10,20,30
Sweden,2004,sp,014,0,1,1
Sweden,2004,sp,1524,11,10,21
Sweden,2004,sp,2534,11,19,30
Sweden,2004,sp,3544,13,8,21
Sweden,2004,sp,4554,2,8,10
Sweden,2004,sp,5564,3,12,15
Sweden,2004,sp,65,9,13,22
Sweden,2005,sp,014,1,0,1
Sweden,2005,sp,1524,10,7,17
Sweden,2005,sp,2534,15,21,36
Sweden,2005,sp,3544,12,16,28
Sweden,2005,sp,4554,5,10,15
Sweden,2005,sp,5564,3,5,8
Sweden,2005,sp,65,13,16,29
Sweden,2006,ep,014,2,7,9
Sweden,2006,ep,1524,15,8,23
Sweden,2006,ep,2534,25,28,53
Sweden,2006,ep,3544,20,14,34
Sweden,2006,ep,4554,10,7,17
Sweden,2006,ep,5564,6,1,7
Sweden,2006,ep,65,17,16,33
Sweden,2006,sn,014,8,10,18
Sweden,2006,sn,1524,15,12,27
Sweden,2006,sn,2534,23,23,46
Sweden,2006,sn,3544,7,16,23
Sweden,2006,sn,4554,4,9,13
Sweden,2006,sn,5564,9,5,14
Sweden,2006,sn,65,24,38,62
Sweden,2006,sp,014,1,0,1
Sweden,2006,sp,1524,12,4,16
Sweden,2006,sp,2534,14,15,29
Sweden,2006,sp,3544,9,14,23
Sweden,2006,sp,4554,1,5,6
Sweden,2006,sp,5564,2,3,5
Sweden,2006,sp,65,10,16,26
Sweden,2007,ep,014,0,4,4
Sweden,2007,ep,1524,12,9,21
Sweden,2007,ep,2534,23,26,49
Sweden,2007,ep,3544,23,17,40
Sweden,2007,ep,4554,11,8,19
Sweden,2007,ep,5564,7,2,9
Sweden,2007,ep,65,7,11,18
Sweden,2007,sn,014,9,17,26
Sweden,2007,sn,1524,17,15,32
Sweden,2007,sn,2534,25,18,43
Sweden,2007,sn,3544,14,9,23
Sweden,2007,sn,4554,7,12,19
Sweden,2007,sn,5564,5,11,16
Sweden,2007,sn,65,23,16,39
Sweden,2007,sp,014,1,0,1
Sweden,2007,sp,1524,5,7,12
Sweden,2007,sp,2534,11,20,31
Sweden,2007,sp,3544,8,10,18
Sweden,2007,sp,4554,4,5,9
Sweden,2007,sp,5564,1,3,4
Sweden,2007,sp,65,12,9,21
Sweden,2008,ep,014,5,2,7
Sweden,2008,ep,1524,17,14,31
Sweden,2008,ep,2534,30,28,58
Sweden,2008,ep,3544,28,16,44
Sweden,2008,ep,4554,9,13,22
Sweden,2008,ep,5564,6,7,13
Sweden,2008,ep,65,17,7,24
Sweden,2008,sn,014,7,3,10
Sweden,2008,sn,1524,16,16,32
Sweden,2008,sn,2534,18,18,36
Sweden,2008,sn,3544,16,11,27
Sweden,2008,sn,4554,6,10,16
Sweden,2008,sn,5564,9,6,15
Sweden,2008,sn,65,15,10,25
Sweden,2008,sp,014,0,0,0
Sweden,2008,sp,1524,12,14,26
Sweden,2008,sp,2534,13,15,28
Sweden,2008,sp,3544,5,9,14
Sweden,2008,sp,4554,4,5,9
Sweden,2008,sp,5564,1,7,8
Sweden,2008,sp,65,6,6,12
Sweden,2009,ep,014,4,8,12
Sweden,2009,ep,1524,31,17,48
Sweden,2009,ep,2534,26,40,66
Sweden,2009,ep,3544,23,17,40
Sweden,2009,ep,4554,8,8,16
Sweden,2009,ep,5564,10,5,15
Sweden,2009,ep,65,18,9,27
Sweden,2009,sn,014,4,8,12
Sweden,2009,sn,1524,14,19,33
Sweden,2009,sn,2534,15,28,43
Sweden,2009,sn,3544,13,10,23
Sweden,2009,sn,4554,5,13,18
Sweden,2009,sn,5564,9,9,18
Sweden,2009,sn,65,14,16,30
Sweden,2009,sp,014,1,0,1
Sweden,2009,sp,1524,9,14,23
Sweden,2009,sp,2534,10,16,26
Sweden,2009,sp,3544,6,10,16
Sweden,2009,sp,4554,5,7,12
Sweden,2009,sp,5564,2,5,7
Sweden,2009,sp,65,11,11,22
Sweden,2010,ep,014,3,4,7
Sweden,2010,ep,1524,18,24,42
Sweden,2010,ep,2534,36,37,73
Sweden,2010,ep,3544,13,19,32
Sweden,2010,ep,4554,12,8,20
Sweden,2010,ep,5564,5,4,9
Sweden,2010,ep,65,17,6,23
Sweden,2010,sn,014,14,13,27
Sweden,2010,sn,1524,29,33,62
Sweden,2010,sn,2534,27,33,60
Sweden,2010,sn,3544,8,15,23
Sweden,2010,sn,4554,6,3,9
Sweden,2010,sn,5564,1,8,9
Sweden,2010,sn,65,16,17,33
Sweden,2010,sp,014,2,1,3
Sweden,2010,sp,1524,9,10,19
Sweden,2010,sp,2534,16,28,44
Sweden,2010,sp,3544,11,8,19
Sweden,2010,sp,4554,4,5,9
Sweden,2010,sp,5564,2,5,7
Sweden,2010,sp,65,3,13,16
Sweden,2011,ep,014,2,4,6
Sweden,2011,ep,1524,13,26,39
Sweden,2011,ep,2534,31,33,64
Sweden,2011,ep,3544,17,13,30
Sweden,2011,ep,4554,11,7,18
Sweden,2011,ep,5564,5,5,10
Sweden,2011,ep,65,1,2,3
Sweden,2011,sn,014,9,13,22
Sweden,2011,sn,1524,14,22,36
Sweden,2011,sn,2534,15,40,55
Sweden,2011,sn,3544,11,12,23
Sweden,2011,sn,4554,6,4,10
Sweden,2011,sn,5564,6,4,10
Sweden,2011,sn,65,9,15,24
Sweden,2011,sp,014,0,1,1
Sweden,2011,sp,1524,12,14,26
Sweden,2011,sp,2534,9,15,24
Sweden,2011,sp,3544,10,12,22
Sweden,2011,sp,4554,2,8,10
Sweden,2011,sp,5564,2,3,5
Sweden,2011,sp,65,3,8,11
Sweden,2012,ep,014,4,3,7
Sweden,2012,ep,1524,18,34,52
Sweden,2012,ep,2534,36,43,79
Sweden,2012,ep,3544,20,21,41
Sweden,2012,ep,4554,11,6,17
Sweden,2012,ep,5564,13,8,21
Sweden,2012,ep,65,7,5,12
Sweden,2012,sn,014,8,9,17
Sweden,2012,sn,1524,23,39,62
Sweden,2012,sn,2534,23,30,53
Sweden,2012,sn,3544,17,12,29
Sweden,2012,sn,4554,14,10,24
Sweden,2012,sn,5564,7,9,16
Sweden,2012,sn,65,10,22,32
Sweden,2012,sp,014,0,0,0
Sweden,2012,sp,1524,11,8,19
Sweden,2012,sp,2534,10,16,26
Sweden,2012,sp,3544,3,8,11
Sweden,2012,sp,4554,7,9,16
Sweden,2012,sp,5564,2,8,10
Sweden,2012,sp,65,6,13,19
Sweden,2013,rel,014,30,18,48
Sweden,2013,rel,1524,48,94,142
Sweden,2013,rel,2534,90,93,183
Sweden,2013,rel,3544,33,40,73
Sweden,2013,rel,4554,39,20,59
Sweden,2013,rel,5564,16,25,41
Sweden,2013,rel,65,30,34,64
Switzerland,1995,sp,014,1,0,1
Switzerland,1995,sp,1524,13,12,25
Switzerland,1995,sp,2534,20,23,43
Switzerland,1995,sp,3544,9,26,35
Switzerland,1995,sp,4554,1,23,24
Switzerland,1995,sp,5564,2,13,15
Switzerland,1995,sp,65,15,27,42
Switzerland,1996,sp,014,0,1,1
Switzerland,1996,sp,1524,6,12,18
Switzerland,1996,sp,2534,18,28,46
Switzerland,1996,sp,3544,4,27,31
Switzerland,1996,sp,4554,4,17,21
Switzerland,1996,sp,5564,4,17,21
Switzerland,1996,sp,65,12,22,34
Switzerland,1997,sp,014,0,0,0
Switzerland,1997,sp,1524,14,16,30
Switzerland,1997,sp,2534,14,20,34
Switzerland,1997,sp,3544,6,15,21
Switzerland,1997,sp,4554,2,11,13
Switzerland,1997,sp,5564,2,7,9
Switzerland,1997,sp,65,12,25,37
Switzerland,1998,sp,014,1,0,1
Switzerland,1998,sp,1524,11,15,26
Switzerland,1998,sp,2534,15,30,45
Switzerland,1998,sp,3544,6,26,32
Switzerland,1998,sp,4554,4,12,16
Switzerland,1998,sp,5564,1,10,11
Switzerland,1998,sp,65,11,23,34
Switzerland,1999,ep,014,2,0,2
Switzerland,1999,ep,1524,9,3,12
Switzerland,1999,ep,2534,11,13,24
Switzerland,1999,ep,3544,9,11,20
Switzerland,1999,ep,4554,7,2,9
Switzerland,1999,ep,5564,3,1,4
Switzerland,1999,ep,65,16,10,26
Switzerland,1999,sn,014,9,2,11
Switzerland,1999,sn,1524,10,20,30
Switzerland,1999,sn,2534,24,20,44
Switzerland,1999,sn,3544,13,15,28
Switzerland,1999,sn,4554,5,20,25
Switzerland,1999,sn,5564,7,8,15
Switzerland,1999,sn,65,25,22,47
Switzerland,1999,sp,014,0,1,1
Switzerland,1999,sp,1524,6,9,15
Switzerland,1999,sp,2534,11,9,20
Switzerland,1999,sp,3544,6,11,17
Switzerland,1999,sp,4554,0,2,2
Switzerland,1999,sp,5564,1,3,4
Switzerland,1999,sp,65,3,3,6
Switzerland,2000,ep,014,2,1,3
Switzerland,2000,ep,1524,14,7,21
Switzerland,2000,ep,2534,13,9,22
Switzerland,2000,ep,3544,11,8,19
Switzerland,2000,ep,4554,3,5,8
Switzerland,2000,ep,5564,4,4,8
Switzerland,2000,ep,65,12,8,20
Switzerland,2000,sn,014,1,5,6
Switzerland,2000,sn,1524,13,17,30
Switzerland,2000,sn,2534,23,19,42
Switzerland,2000,sn,3544,22,21,43
Switzerland,2000,sn,4554,4,16,20
Switzerland,2000,sn,5564,4,17,21
Switzerland,2000,sn,65,20,34,54
Switzerland,2000,sp,014,1,0,1
Switzerland,2000,sp,1524,8,5,13
Switzerland,2000,sp,2534,11,17,28
Switzerland,2000,sp,3544,7,10,17
Switzerland,2000,sp,4554,2,7,9
Switzerland,2000,sp,5564,1,6,7
Switzerland,2000,sp,65,5,6,11
Switzerland,2001,ep,014,2,1,3
Switzerland,2001,ep,1524,11,8,19
Switzerland,2001,ep,2534,17,4,21
Switzerland,2001,ep,3544,9,7,16
Switzerland,2001,ep,4554,3,5,8
Switzerland,2001,ep,5564,6,5,11
Switzerland,2001,ep,65,12,6,18
Switzerland,2001,sn,014,4,5,9
Switzerland,2001,sn,1524,13,20,33
Switzerland,2001,sn,2534,28,15,43
Switzerland,2001,sn,3544,11,19,30
Switzerland,2001,sn,4554,3,18,21
Switzerland,2001,sn,5564,5,13,18
Switzerland,2001,sn,65,27,26,53
Switzerland,2001,sp,014,0,0,0
Switzerland,2001,sp,1524,4,7,11
Switzerland,2001,sp,2534,9,16,25
Switzerland,2001,sp,3544,3,12,15
Switzerland,2001,sp,4554,2,6,8
Switzerland,2001,sp,5564,1,9,10
Switzerland,2001,sp,65,6,5,11
Switzerland,2002,ep,014,1,1,2
Switzerland,2002,ep,1524,8,9,17
Switzerland,2002,ep,2534,10,17,27
Switzerland,2002,ep,3544,12,8,20
Switzerland,2002,ep,4554,5,5,10
Switzerland,2002,ep,5564,5,6,11
Switzerland,2002,ep,65,9,9,18
Switzerland,2002,sn,014,10,8,18
Switzerland,2002,sn,1524,20,31,51
Switzerland,2002,sn,2534,34,21,55
Switzerland,2002,sn,3544,11,20,31
Switzerland,2002,sn,4554,6,7,13
Switzerland,2002,sn,5564,4,14,18
Switzerland,2002,sn,65,23,22,45
Switzerland,2002,sp,014,0,0,0
Switzerland,2002,sp,1524,12,10,22
Switzerland,2002,sp,2534,14,16,30
Switzerland,2002,sp,3544,5,10,15
Switzerland,2002,sp,4554,4,16,20
Switzerland,2002,sp,5564,0,4,4
Switzerland,2002,sp,65,4,7,11
Switzerland,2003,ep,014,1,1,2
Switzerland,2003,ep,1524,13,10,23
Switzerland,2003,ep,2534,15,14,29
Switzerland,2003,ep,3544,8,4,12
Switzerland,2003,ep,4554,13,2,15
Switzerland,2003,ep,5564,3,1,4
Switzerland,2003,ep,65,14,7,21
Switzerland,2003,sn,014,7,10,17
Switzerland,2003,sn,1524,11,24,35
Switzerland,2003,sn,2534,17,23,40
Switzerland,2003,sn,3544,11,18,29
Switzerland,2003,sn,4554,7,19,26
Switzerland,2003,sn,5564,8,12,20
Switzerland,2003,sn,65,23,20,43
Switzerland,2003,sp,014,1,0,1
Switzerland,2003,sp,1524,9,10,19
Switzerland,2003,sp,2534,9,7,16
Switzerland,2003,sp,3544,3,20,23
Switzerland,2003,sp,4554,0,7,7
Switzerland,2003,sp,5564,5,4,9
Switzerland,2003,sp,65,1,9,10
Switzerland,2004,ep,014,1,1,2
Switzerland,2004,ep,1524,8,8,16
Switzerland,2004,ep,2534,16,13,29
Switzerland,2004,ep,3544,10,14,24
Switzerland,2004,ep,4554,8,2,10
Switzerland,2004,ep,5564,1,5,6
Switzerland,2004,ep,65,11,7,18
Switzerland,2004,sn,014,3,5,8
Switzerland,2004,sn,1524,15,17,32
Switzerland,2004,sn,2534,20,22,42
Switzerland,2004,sn,3544,15,24,39
Switzerland,2004,sn,4554,7,17,24
Switzerland,2004,sn,5564,9,10,19
Switzerland,2004,sn,65,18,23,41
Switzerland,2004,sp,014,0,0,0
Switzerland,2004,sp,1524,6,12,18
Switzerland,2004,sp,2534,13,11,24
Switzerland,2004,sp,3544,6,11,17
Switzerland,2004,sp,4554,3,9,12
Switzerland,2004,sp,5564,3,7,10
Switzerland,2004,sp,65,5,11,16
Switzerland,2005,ep,014,0,1,1
Switzerland,2005,ep,1524,11,8,19
Switzerland,2005,ep,2534,14,11,25
Switzerland,2005,ep,3544,8,14,22
Switzerland,2005,ep,4554,6,9,15
Switzerland,2005,ep,5564,3,3,6
Switzerland,2005,ep,65,8,14,22
Switzerland,2005,sn,014,8,6,14
Switzerland,2005,sn,1524,13,16,29
Switzerland,2005,sn,2534,21,25,46
Switzerland,2005,sn,3544,10,15,25
Switzerland,2005,sn,4554,5,18,23
Switzerland,2005,sn,5564,3,7,10
Switzerland,2005,sn,65,23,17,40
Switzerland,2005,sp,014,0,2,2
Switzerland,2005,sp,1524,6,8,14
Switzerland,2005,sp,2534,11,10,21
Switzerland,2005,sp,3544,8,11,19
Switzerland,2005,sp,4554,3,11,14
Switzerland,2005,sp,5564,1,2,3
Switzerland,2005,sp,65,4,7,11
Switzerland,2006,ep,014,0,1,1
Switzerland,2006,ep,1524,4,3,7
Switzerland,2006,ep,2534,9,12,21
Switzerland,2006,ep,3544,14,6,20
Switzerland,2006,ep,4554,5,2,7
Switzerland,2006,ep,5564,4,3,7
Switzerland,2006,ep,65,7,5,12
Switzerland,2006,sn,014,4,2,6
Switzerland,2006,sn,1524,13,13,26
Switzerland,2006,sn,2534,20,14,34
Switzerland,2006,sn,3544,19,14,33
Switzerland,2006,sn,4554,9,15,24
Switzerland,2006,sn,5564,6,13,19
Switzerland,2006,sn,65,21,24,45
Switzerland,2006,sp,014,1,1,2
Switzerland,2006,sp,1524,7,7,14
Switzerland,2006,sp,2534,14,14,28
Switzerland,2006,sp,3544,6,6,12
Switzerland,2006,sp,4554,3,7,10
Switzerland,2006,sp,5564,0,6,6
Switzerland,2006,sp,65,0,7,7
Switzerland,2007,ep,014,1,2,3
Switzerland,2007,ep,1524,4,10,14
Switzerland,2007,ep,2534,16,7,23
Switzerland,2007,ep,3544,8,5,13
Switzerland,2007,ep,4554,8,2,10
Switzerland,2007,ep,5564,5,2,7
Switzerland,2007,ep,65,6,14,20
Switzerland,2007,sn,014,8,3,11
Switzerland,2007,sn,1524,7,12,19
Switzerland,2007,sn,2534,23,13,36
Switzerland,2007,sn,3544,8,15,23
Switzerland,2007,sn,4554,6,14,20
Switzerland,2007,sn,5564,7,6,13
Switzerland,2007,sn,65,12,17,29
Switzerland,2007,sp,014,1,0,1
Switzerland,2007,sp,1524,8,9,17
Switzerland,2007,sp,2534,13,7,20
Switzerland,2007,sp,3544,3,7,10
Switzerland,2007,sp,4554,0,5,5
Switzerland,2007,sp,5564,2,4,6
Switzerland,2007,sp,65,5,8,13
Switzerland,2008,ep,014,1,1,2
Switzerland,2008,ep,1524,7,4,11
Switzerland,2008,ep,2534,17,13,30
Switzerland,2008,ep,3544,13,13,26
Switzerland,2008,ep,4554,4,3,7
Switzerland,2008,ep,5564,2,5,7
Switzerland,2008,ep,65,13,3,16
Switzerland,2008,sn,014,5,3,8
Switzerland,2008,sn,1524,6,14,20
Switzerland,2008,sn,2534,19,24,43
Switzerland,2008,sn,3544,15,13,28
Switzerland,2008,sn,4554,7,9,16
Switzerland,2008,sn,5564,6,8,14
Switzerland,2008,sn,65,11,16,27
Switzerland,2008,sp,014,1,0,1
Switzerland,2008,sp,1524,3,8,11
Switzerland,2008,sp,2534,13,13,26
Switzerland,2008,sp,3544,6,5,11
Switzerland,2008,sp,4554,2,4,6
Switzerland,2008,sp,5564,1,3,4
Switzerland,2008,sp,65,1,4,5
Switzerland,2009,ep,014,3,2,5
Switzerland,2009,ep,1524,5,13,18
Switzerland,2009,ep,2534,12,11,23
Switzerland,2009,ep,3544,8,5,13
Switzerland,2009,ep,4554,7,6,13
Switzerland,2009,ep,5564,5,4,9
Switzerland,2009,ep,65,12,4,16
Switzerland,2009,sn,014,5,5,10
Switzerland,2009,sn,1524,9,15,24
Switzerland,2009,sn,2534,21,20,41
Switzerland,2009,sn,3544,12,15,27
Switzerland,2009,sn,4554,7,13,20
Switzerland,2009,sn,5564,9,10,19
Switzerland,2009,sn,65,10,12,22
Switzerland,2009,sp,014,1,0,1
Switzerland,2009,sp,1524,1,11,12
Switzerland,2009,sp,2534,10,10,20
Switzerland,2009,sp,3544,8,12,20
Switzerland,2009,sp,4554,5,7,12
Switzerland,2009,sp,5564,1,2,3
Switzerland,2009,sp,65,2,4,6
Switzerland,2010,ep,014,0,1,1
Switzerland,2010,ep,1524,3,9,12
Switzerland,2010,ep,2534,13,10,23
Switzerland,2010,ep,3544,11,11,22
Switzerland,2010,ep,4554,7,4,11
Switzerland,2010,ep,5564,4,6,10
Switzerland,2010,ep,65,10,2,12
Switzerland,2010,sn,014,6,5,11
Switzerland,2010,sn,1524,13,11,24
Switzerland,2010,sn,2534,22,16,38
Switzerland,2010,sn,3544,11,14,25
Switzerland,2010,sn,4554,4,10,14
Switzerland,2010,sn,5564,3,9,12
Switzerland,2010,sn,65,8,17,25
Switzerland,2010,sp,014,0,0,0
Switzerland,2010,sp,1524,7,6,13
Switzerland,2010,sp,2534,15,12,27
Switzerland,2010,sp,3544,6,9,15
Switzerland,2010,sp,4554,4,6,10
Switzerland,2010,sp,5564,1,5,6
Switzerland,2010,sp,65,3,8,11
Switzerland,2011,ep,014,1,0,1
Switzerland,2011,ep,1524,2,12,14
Switzerland,2011,ep,2534,16,16,32
Switzerland,2011,ep,3544,13,14,27
Switzerland,2011,ep,4554,17,3,20
Switzerland,2011,ep,5564,0,5,5
Switzerland,2011,ep,65,10,10,20
Switzerland,2011,sn,014,8,6,14
Switzerland,2011,sn,1524,13,14,27
Switzerland,2011,sn,2534,10,21,31
Switzerland,2011,sn,3544,10,15,25
Switzerland,2011,sn,4554,9,19,28
Switzerland,2011,sn,5564,5,12,17
Switzerland,2011,sn,65,13,15,28
Switzerland,2011,sp,014,2,2,4
Switzerland,2011,sp,1524,6,8,14
Switzerland,2011,sp,2534,13,16,29
Switzerland,2011,sp,3544,2,10,12
Switzerland,2011,sp,4554,4,13,17
Switzerland,2011,sp,5564,2,7,9
Switzerland,2011,sp,65,2,3,5
Switzerland,2012,ep,014,1,1,2
Switzerland,2012,ep,1524,7,10,17
Switzerland,2012,ep,2534,8,11,19
Switzerland,2012,ep,3544,11,7,18
Switzerland,2012,ep,4554,5,0,5
Switzerland,2012,ep,5564,2,3,5
Switzerland,2012,ep,65,7,11,18
Switzerland,2012,sn,014,6,5,11
Switzerland,2012,sn,1524,3,9,12
Switzerland,2012,sn,2534,18,20,38
Switzerland,2012,sn,3544,9,15,24
Switzerland,2012,sn,4554,5,8,13
Switzerland,2012,sn,5564,4,6,10
Switzerland,2012,sn,65,10,6,16
Switzerland,2012,sp,014,0,0,0
Switzerland,2012,sp,1524,7,3,10
Switzerland,2012,sp,2534,15,18,33
Switzerland,2012,sp,3544,7,8,15
Switzerland,2012,sp,4554,1,6,7
Switzerland,2012,sp,5564,2,5,7
Switzerland,2012,sp,65,4,11,15
Switzerland,2013,rel,014,7,15,22
Switzerland,2013,rel,1524,26,39,65
Switzerland,2013,rel,2534,65,53,118
Switzerland,2013,rel,3544,54,42,96
Switzerland,2013,rel,4554,16,23,39
Switzerland,2013,rel,5564,23,27,50
Switzerland,2013,rel,65,37,39,76
Syrian Arab Republic,1995,sp,014,22,13,35
Syrian Arab Republic,1995,sp,1524,158,332,490
Syrian Arab Republic,1995,sp,2534,97,255,352
Syrian Arab Republic,1995,sp,3544,53,111,164
Syrian Arab Republic,1995,sp,4554,44,70,114
Syrian Arab Republic,1995,sp,5564,37,59,96
Syrian Arab Republic,1995,sp,65,20,50,70
Syrian Arab Republic,1996,sp,014,12,11,23
Syrian Arab Republic,1996,sp,1524,200,390,590
Syrian Arab Republic,1996,sp,2534,107,290,397
Syrian Arab Republic,1996,sp,3544,57,110,167
Syrian Arab Republic,1996,sp,4554,51,90,141
Syrian Arab Republic,1996,sp,5564,45,69,114
Syrian Arab Republic,1996,sp,65,31,60,91
Syrian Arab Republic,1997,sp,014,23,6,29
Syrian Arab Republic,1997,sp,1524,201,337,538
Syrian Arab Republic,1997,sp,2534,112,295,407
Syrian Arab Republic,1997,sp,3544,47,118,165
Syrian Arab Republic,1997,sp,4554,31,74,105
Syrian Arab Republic,1997,sp,5564,36,52,88
Syrian Arab Republic,1997,sp,65,18,52,70
Syrian Arab Republic,1998,sp,014,20,5,25
Syrian Arab Republic,1998,sp,1524,197,335,532
Syrian Arab Republic,1998,sp,2534,99,293,392
Syrian Arab Republic,1998,sp,3544,43,111,154
Syrian Arab Republic,1998,sp,4554,49,93,142
Syrian Arab Republic,1998,sp,5564,18,48,66
Syrian Arab Republic,1998,sp,65,21,50,71
Syrian Arab Republic,2000,sp,014,23,8,31
Syrian Arab Republic,2000,sp,1524,195,359,554
Syrian Arab Republic,2000,sp,2534,101,289,390
Syrian Arab Republic,2000,sp,3544,53,125,178
Syrian Arab Republic,2000,sp,4554,46,86,132
Syrian Arab Republic,2000,sp,5564,38,76,114
Syrian Arab Republic,2000,sp,65,28,55,83
Syrian Arab Republic,2001,sp,014,26,8,34
Syrian Arab Republic,2001,sp,1524,210,317,527
Syrian Arab Republic,2001,sp,2534,116,248,364
Syrian Arab Republic,2001,sp,3544,56,134,190
Syrian Arab Republic,2001,sp,4554,50,108,158
Syrian Arab Republic,2001,sp,5564,42,64,106
Syrian Arab Republic,2001,sp,65,28,47,75
Syrian Arab Republic,2002,sp,014,23,12,35
Syrian Arab Republic,2002,sp,1524,182,359,541
Syrian Arab Republic,2002,sp,2534,116,278,394
Syrian Arab Republic,2002,sp,3544,53,121,174
Syrian Arab Republic,2002,sp,4554,43,80,123
Syrian Arab Republic,2002,sp,5564,31,62,93
Syrian Arab Republic,2002,sp,65,26,61,87
Syrian Arab Republic,2003,sp,014,26,10,36
Syrian Arab Republic,2003,sp,1524,242,343,585
Syrian Arab Republic,2003,sp,2534,99,279,378
Syrian Arab Republic,2003,sp,3544,68,127,195
Syrian Arab Republic,2003,sp,4554,48,98,146
Syrian Arab Republic,2003,sp,5564,33,75,108
Syrian Arab Republic,2003,sp,65,33,64,97
Syrian Arab Republic,2004,sp,014,20,13,33
Syrian Arab Republic,2004,sp,1524,230,318,548
Syrian Arab Republic,2004,sp,2534,121,308,429
Syrian Arab Republic,2004,sp,3544,46,115,161
Syrian Arab Republic,2004,sp,4554,56,113,169
Syrian Arab Republic,2004,sp,5564,59,77,136
Syrian Arab Republic,2004,sp,65,35,50,85
Syrian Arab Republic,2005,sp,014,27,9,36
Syrian Arab Republic,2005,sp,1524,182,266,448
Syrian Arab Republic,2005,sp,2534,108,237,345
Syrian Arab Republic,2005,sp,3544,59,111,170
Syrian Arab Republic,2005,sp,4554,59,112,171
Syrian Arab Republic,2005,sp,5564,32,62,94
Syrian Arab Republic,2005,sp,65,23,63,86
Syrian Arab Republic,2006,ep,014,154,171,325
Syrian Arab Republic,2006,ep,1524,298,288,586
Syrian Arab Republic,2006,ep,2534,225,188,413
Syrian Arab Republic,2006,ep,3544,130,70,200
Syrian Arab Republic,2006,ep,4554,104,63,167
Syrian Arab Republic,2006,ep,5564,80,58,138
Syrian Arab Republic,2006,ep,65,52,69,121
Syrian Arab Republic,2006,sn,014,51,36,87
Syrian Arab Republic,2006,sn,1524,76,65,141
Syrian Arab Republic,2006,sn,2534,25,47,72
Syrian Arab Republic,2006,sn,3544,25,31,56
Syrian Arab Republic,2006,sn,4554,34,35,69
Syrian Arab Republic,2006,sn,5564,29,40,69
Syrian Arab Republic,2006,sn,65,27,42,69
Syrian Arab Republic,2006,sp,014,18,8,26
Syrian Arab Republic,2006,sp,1524,195,225,420
Syrian Arab Republic,2006,sp,2534,109,267,376
Syrian Arab Republic,2006,sp,3544,42,137,179
Syrian Arab Republic,2006,sp,4554,53,110,163
Syrian Arab Republic,2006,sp,5564,39,71,110
Syrian Arab Republic,2006,sp,65,34,44,78
Syrian Arab Republic,2007,ep,014,198,188,386
Syrian Arab Republic,2007,ep,1524,345,288,633
Syrian Arab Republic,2007,ep,2534,244,202,446
Syrian Arab Republic,2007,ep,3544,133,90,223
Syrian Arab Republic,2007,ep,4554,120,57,177
Syrian Arab Republic,2007,ep,5564,95,56,151
Syrian Arab Republic,2007,ep,65,78,75,153
Syrian Arab Republic,2007,sn,014,44,31,75
Syrian Arab Republic,2007,sn,1524,103,73,176
Syrian Arab Republic,2007,sn,2534,52,86,138
Syrian Arab Republic,2007,sn,3544,37,56,93
Syrian Arab Republic,2007,sn,4554,26,52,78
Syrian Arab Republic,2007,sn,5564,42,26,68
Syrian Arab Republic,2007,sn,65,33,45,78
Syrian Arab Republic,2007,sp,014,14,7,21
Syrian Arab Republic,2007,sp,1524,148,198,346
Syrian Arab Republic,2007,sp,2534,106,222,328
Syrian Arab Republic,2007,sp,3544,41,123,164
Syrian Arab Republic,2007,sp,4554,43,74,117
Syrian Arab Republic,2007,sp,5564,30,49,79
Syrian Arab Republic,2007,sp,65,41,59,100
Syrian Arab Republic,2008,ep,014,152,171,323
Syrian Arab Republic,2008,ep,1524,285,227,512
Syrian Arab Republic,2008,ep,2534,238,188,426
Syrian Arab Republic,2008,ep,3544,126,75,201
Syrian Arab Republic,2008,ep,4554,105,57,162
Syrian Arab Republic,2008,ep,5564,83,38,121
Syrian Arab Republic,2008,ep,65,63,80,143
Syrian Arab Republic,2008,sn,014,37,32,69
Syrian Arab Republic,2008,sn,1524,68,80,148
Syrian Arab Republic,2008,sn,2534,59,77,136
Syrian Arab Republic,2008,sn,3544,35,55,90
Syrian Arab Republic,2008,sn,4554,26,40,66
Syrian Arab Republic,2008,sn,5564,30,40,70
Syrian Arab Republic,2008,sn,65,36,52,88
Syrian Arab Republic,2008,sp,014,30,18,48
Syrian Arab Republic,2008,sp,1524,149,170,319
Syrian Arab Republic,2008,sp,2534,80,212,292
Syrian Arab Republic,2008,sp,3544,48,128,176
Syrian Arab Republic,2008,sp,4554,32,82,114
Syrian Arab Republic,2008,sp,5564,29,61,90
Syrian Arab Republic,2008,sp,65,25,52,77
Syrian Arab Republic,2009,ep,014,164,155,319
Syrian Arab Republic,2009,ep,1524,336,203,539
Syrian Arab Republic,2009,ep,2534,273,179,452
Syrian Arab Republic,2009,ep,3544,154,92,246
Syrian Arab Republic,2009,ep,4554,126,67,193
Syrian Arab Republic,2009,ep,5564,82,61,143
Syrian Arab Republic,2009,ep,65,67,77,144
Syrian Arab Republic,2009,sn,014,43,21,64
Syrian Arab Republic,2009,sn,1524,81,76,157
Syrian Arab Republic,2009,sn,2534,39,65,104
Syrian Arab Republic,2009,sn,3544,38,53,91
Syrian Arab Republic,2009,sn,4554,40,54,94
Syrian Arab Republic,2009,sn,5564,31,47,78
Syrian Arab Republic,2009,sn,65,32,55,87
Syrian Arab Republic,2009,sp,014,17,10,27
Syrian Arab Republic,2009,sp,1524,167,172,339
Syrian Arab Republic,2009,sp,2534,82,212,294
Syrian Arab Republic,2009,sp,3544,41,121,162
Syrian Arab Republic,2009,sp,4554,44,97,141
Syrian Arab Republic,2009,sp,5564,34,74,108
Syrian Arab Republic,2009,sp,65,25,47,72
Syrian Arab Republic,2010,ep,014,157,189,346
Syrian Arab Republic,2010,ep,1524,293,191,484
Syrian Arab Republic,2010,ep,2534,263,175,438
Syrian Arab Republic,2010,ep,3544,152,79,231
Syrian Arab Republic,2010,ep,4554,124,62,186
Syrian Arab Republic,2010,ep,5564,83,43,126
Syrian Arab Republic,2010,ep,65,70,67,137
Syrian Arab Republic,2010,sn,014,38,14,52
Syrian Arab Republic,2010,sn,1524,62,62,124
Syrian Arab Republic,2010,sn,2534,51,61,112
Syrian Arab Republic,2010,sn,3544,20,37,57
Syrian Arab Republic,2010,sn,4554,22,32,54
Syrian Arab Republic,2010,sn,5564,23,42,65
Syrian Arab Republic,2010,sn,65,30,50,80
Syrian Arab Republic,2010,sp,014,16,7,23
Syrian Arab Republic,2010,sp,1524,164,170,334
Syrian Arab Republic,2010,sp,2534,105,212,317
Syrian Arab Republic,2010,sp,3544,47,101,148
Syrian Arab Republic,2010,sp,4554,41,80,121
Syrian Arab Republic,2010,sp,5564,38,65,103
Syrian Arab Republic,2010,sp,65,27,49,76
Syrian Arab Republic,2011,ep,014,215,267,482
Syrian Arab Republic,2011,ep,1524,247,172,419
Syrian Arab Republic,2011,ep,2534,254,181,435
Syrian Arab Republic,2011,ep,3544,126,58,184
Syrian Arab Republic,2011,ep,4554,109,64,173
Syrian Arab Republic,2011,ep,5564,61,44,105
Syrian Arab Republic,2011,ep,65,70,47,117
Syrian Arab Republic,2011,sn,014,19,23,42
Syrian Arab Republic,2011,sn,1524,52,39,91
Syrian Arab Republic,2011,sn,2534,30,51,81
Syrian Arab Republic,2011,sn,3544,14,30,44
Syrian Arab Republic,2011,sn,4554,21,33,54
Syrian Arab Republic,2011,sn,5564,8,31,39
Syrian Arab Republic,2011,sn,65,11,31,42
Syrian Arab Republic,2011,sp,014,20,8,28
Syrian Arab Republic,2011,sp,1524,113,139,252
Syrian Arab Republic,2011,sp,2534,97,195,292
Syrian Arab Republic,2011,sp,3544,56,116,172
Syrian Arab Republic,2011,sp,4554,35,81,116
Syrian Arab Republic,2011,sp,5564,36,49,85
Syrian Arab Republic,2011,sp,65,37,45,82
Syrian Arab Republic,2012,ep,014,192,245,437
Syrian Arab Republic,2012,ep,1524,249,121,370
Syrian Arab Republic,2012,ep,2534,238,128,366
Syrian Arab Republic,2012,ep,3544,147,65,212
Syrian Arab Republic,2012,ep,4554,84,47,131
Syrian Arab Republic,2012,ep,5564,70,37,107
Syrian Arab Republic,2012,ep,65,38,41,79
Syrian Arab Republic,2012,sn,014,21,18,39
Syrian Arab Republic,2012,sn,1524,40,41,81
Syrian Arab Republic,2012,sn,2534,34,34,68
Syrian Arab Republic,2012,sn,3544,25,25,50
Syrian Arab Republic,2012,sn,4554,15,37,52
Syrian Arab Republic,2012,sn,5564,14,24,38
Syrian Arab Republic,2012,sn,65,12,24,36
Syrian Arab Republic,2012,sp,014,5,7,12
Syrian Arab Republic,2012,sp,1524,104,91,195
Syrian Arab Republic,2012,sp,2534,75,146,221
Syrian Arab Republic,2012,sp,3544,35,90,125
Syrian Arab Republic,2012,sp,4554,33,85,118
Syrian Arab Republic,2012,sp,5564,32,46,78
Syrian Arab Republic,2012,sp,65,19,41,60
Syrian Arab Republic,2013,rel,014,192,211,403
Syrian Arab Republic,2013,rel,1524,344,273,617
Syrian Arab Republic,2013,rel,2534,320,304,624
Syrian Arab Republic,2013,rel,3544,197,201,398
Syrian Arab Republic,2013,rel,4554,150,180,330
Syrian Arab Republic,2013,rel,5564,103,127,230
Syrian Arab Republic,2013,rel,65,80,113,193
Tajikistan,1996,sp,014,5,4,9
Tajikistan,1996,sp,1524,18,22,40
Tajikistan,1996,sp,2534,26,25,51
Tajikistan,1996,sp,3544,46,23,69
Tajikistan,1996,sp,4554,20,12,32
Tajikistan,1996,sp,5564,11,12,23
Tajikistan,1996,sp,65,4,4,8
Tajikistan,1997,sp,014,7,8,15
Tajikistan,1997,sp,1524,17,16,33
Tajikistan,1997,sp,2534,33,38,71
Tajikistan,1997,sp,3544,24,26,50
Tajikistan,1997,sp,4554,17,18,35
Tajikistan,1997,sp,5564,12,12,24
Tajikistan,1997,sp,65,9,8,17
Tajikistan,1998,sp,014,2,9,11
Tajikistan,1998,sp,1524,33,67,100
Tajikistan,1998,sp,2534,60,90,150
Tajikistan,1998,sp,3544,37,48,85
Tajikistan,1998,sp,4554,21,18,39
Tajikistan,1998,sp,5564,10,22,32
Tajikistan,1998,sp,65,8,10,18
Tajikistan,2001,sp,014,0,8,8
Tajikistan,2001,sp,1524,61,129,190
Tajikistan,2001,sp,2534,83,152,235
Tajikistan,2001,sp,3544,62,89,151
Tajikistan,2001,sp,4554,25,43,68
Tajikistan,2001,sp,5564,11,17,28
Tajikistan,2001,sp,65,8,16,24
Tajikistan,2002,sp,014,6,7,13
Tajikistan,2002,sp,1524,69,134,203
Tajikistan,2002,sp,2534,84,133,217
Tajikistan,2002,sp,3544,46,66,112
Tajikistan,2002,sp,4554,29,45,74
Tajikistan,2002,sp,5564,15,28,43
Tajikistan,2002,sp,65,6,19,25
Tajikistan,2004,sp,014,11,7,18
Tajikistan,2004,sp,1524,77,146,223
Tajikistan,2004,sp,2534,59,90,149
Tajikistan,2004,sp,3544,41,58,99
Tajikistan,2004,sp,4554,23,34,57
Tajikistan,2004,sp,5564,17,12,29
Tajikistan,2004,sp,65,16,10,26
Tajikistan,2005,sp,014,26,8,34
Tajikistan,2005,sp,1524,225,308,533
Tajikistan,2005,sp,2534,185,279,464
Tajikistan,2005,sp,3544,151,164,315
Tajikistan,2005,sp,4554,89,104,193
Tajikistan,2005,sp,5564,43,54,97
Tajikistan,2005,sp,65,53,48,101
Tajikistan,2007,ep,014,197,228,425
Tajikistan,2007,ep,1524,172,386,558
Tajikistan,2007,ep,2534,150,167,317
Tajikistan,2007,ep,3544,90,96,186
Tajikistan,2007,ep,4554,69,52,121
Tajikistan,2007,ep,5564,40,27,67
Tajikistan,2007,ep,65,23,36,59
Tajikistan,2007,sn,014,65,61,126
Tajikistan,2007,sn,1524,235,444,679
Tajikistan,2007,sn,2534,220,320,540
Tajikistan,2007,sn,3544,135,186,321
Tajikistan,2007,sn,4554,103,122,225
Tajikistan,2007,sn,5564,71,54,125
Tajikistan,2007,sn,65,53,51,104
Tajikistan,2007,sp,014,21,13,34
Tajikistan,2007,sp,1524,329,413,742
Tajikistan,2007,sp,2534,243,361,604
Tajikistan,2007,sp,3544,154,194,348
Tajikistan,2007,sp,4554,92,132,224
Tajikistan,2007,sp,5564,61,63,124
Tajikistan,2007,sp,65,87,65,152
Tajikistan,2008,ep,014,162,222,384
Tajikistan,2008,ep,1524,162,435,597
Tajikistan,2008,ep,2534,119,191,310
Tajikistan,2008,ep,3544,90,114,204
Tajikistan,2008,ep,4554,72,77,149
Tajikistan,2008,ep,5564,50,27,77
Tajikistan,2008,ep,65,25,27,52
Tajikistan,2008,sn,014,61,70,131
Tajikistan,2008,sn,1524,258,447,705
Tajikistan,2008,sn,2534,229,343,572
Tajikistan,2008,sn,3544,158,194,352
Tajikistan,2008,sn,4554,121,149,270
Tajikistan,2008,sn,5564,68,69,137
Tajikistan,2008,sn,65,47,71,118
Tajikistan,2008,sp,014,25,7,32
Tajikistan,2008,sp,1524,290,437,727
Tajikistan,2008,sp,2534,211,358,569
Tajikistan,2008,sp,3544,121,165,286
Tajikistan,2008,sp,4554,101,113,214
Tajikistan,2008,sp,5564,40,52,92
Tajikistan,2008,sp,65,73,64,137
Tajikistan,2009,ep,014,146,188,334
Tajikistan,2009,ep,1524,178,389,567
Tajikistan,2009,ep,2534,130,174,304
Tajikistan,2009,ep,3544,93,95,188
Tajikistan,2009,ep,4554,71,80,151
Tajikistan,2009,ep,5564,41,30,71
Tajikistan,2009,ep,65,36,33,69
Tajikistan,2009,sn,014,47,59,106
Tajikistan,2009,sn,1524,257,461,718
Tajikistan,2009,sn,2534,258,363,621
Tajikistan,2009,sn,3544,141,182,323
Tajikistan,2009,sn,4554,104,108,212
Tajikistan,2009,sn,5564,74,60,134
Tajikistan,2009,sn,65,38,56,94
Tajikistan,2009,sp,014,12,4,16
Tajikistan,2009,sp,1524,253,407,660
Tajikistan,2009,sp,2534,223,322,545
Tajikistan,2009,sp,3544,111,173,284
Tajikistan,2009,sp,4554,92,107,199
Tajikistan,2009,sp,5564,60,78,138
Tajikistan,2009,sp,65,72,58,130
Tajikistan,2010,ep,014,154,189,343
Tajikistan,2010,ep,1524,249,262,511
Tajikistan,2010,ep,2534,165,173,338
Tajikistan,2010,ep,3544,78,88,166
Tajikistan,2010,ep,4554,68,72,140
Tajikistan,2010,ep,5564,35,40,75
Tajikistan,2010,ep,65,27,31,58
Tajikistan,2010,sn,014,62,51,113
Tajikistan,2010,sn,1524,251,432,683
Tajikistan,2010,sn,2534,216,283,499
Tajikistan,2010,sn,3544,122,174,296
Tajikistan,2010,sn,4554,96,119,215
Tajikistan,2010,sn,5564,62,64,126
Tajikistan,2010,sn,65,44,62,106
Tajikistan,2010,sp,014,23,12,35
Tajikistan,2010,sp,1524,320,398,718
Tajikistan,2010,sp,2534,272,366,638
Tajikistan,2010,sp,3544,111,214,325
Tajikistan,2010,sp,4554,109,129,238
Tajikistan,2010,sp,5564,87,93,180
Tajikistan,2010,sp,65,82,74,156
Tajikistan,2011,ep,014,152,241,393
Tajikistan,2011,ep,1524,158,321,479
Tajikistan,2011,ep,2534,148,151,299
Tajikistan,2011,ep,3544,82,78,160
Tajikistan,2011,ep,4554,68,60,128
Tajikistan,2011,ep,5564,56,32,88
Tajikistan,2011,ep,65,34,32,66
Tajikistan,2011,sn,014,66,71,137
Tajikistan,2011,sn,1524,248,417,665
Tajikistan,2011,sn,2534,227,309,536
Tajikistan,2011,sn,3544,116,188,304
Tajikistan,2011,sn,4554,114,124,238
Tajikistan,2011,sn,5564,67,84,151
Tajikistan,2011,sn,65,55,62,117
Tajikistan,2011,sp,014,31,8,39
Tajikistan,2011,sp,1524,314,343,657
Tajikistan,2011,sp,2534,229,365,594
Tajikistan,2011,sp,3544,104,181,285
Tajikistan,2011,sp,4554,100,128,228
Tajikistan,2011,sp,5564,105,75,180
Tajikistan,2011,sp,65,114,77,191
Tajikistan,2012,ep,014,106,138,244
Tajikistan,2012,ep,1524,186,301,487
Tajikistan,2012,ep,2534,164,157,321
Tajikistan,2012,ep,3544,85,92,177
Tajikistan,2012,ep,4554,81,61,142
Tajikistan,2012,ep,5564,46,47,93
Tajikistan,2012,ep,65,35,33,68
Tajikistan,2012,sn,014,42,50,92
Tajikistan,2012,sn,1524,192,380,572
Tajikistan,2012,sn,2534,193,325,518
Tajikistan,2012,sn,3544,120,163,283
Tajikistan,2012,sn,4554,100,104,204
Tajikistan,2012,sn,5564,72,68,140
Tajikistan,2012,sn,65,43,59,102
Tajikistan,2012,sp,014,16,8,24
Tajikistan,2012,sp,1524,243,346,589
Tajikistan,2012,sp,2534,243,320,563
Tajikistan,2012,sp,3544,105,169,274
Tajikistan,2012,sp,4554,99,124,223
Tajikistan,2012,sp,5564,94,75,169
Tajikistan,2012,sp,65,127,72,199
Tajikistan,2013,rel,014,184,205,389
Tajikistan,2013,rel,1524,621,949,1570
Tajikistan,2013,rel,2534,564,779,1343
Tajikistan,2013,rel,3544,295,399,694
Tajikistan,2013,rel,4554,258,280,538
Tajikistan,2013,rel,5564,224,207,431
Tajikistan,2013,rel,65,165,176,341
Thailand,1995,sp,014,52,59,111
Thailand,1995,sp,1524,741,1191,1932
Thailand,1995,sp,2534,888,2936,3824
Thailand,1995,sp,3544,782,2948,3730
Thailand,1995,sp,4554,936,2434,3370
Thailand,1995,sp,5564,1175,2607,3782
Thailand,1995,sp,65,1178,2346,3524
Thailand,1996,sp,014,50,54,104
Thailand,1996,sp,1524,598,1088,1686
Thailand,1996,sp,2534,844,2857,3701
Thailand,1996,sp,3544,683,2496,3179
Thailand,1996,sp,4554,718,1935,2653
Thailand,1996,sp,5564,918,2004,2922
Thailand,1996,sp,65,980,1772,2752
Thailand,1997,sp,014,38,53,91
Thailand,1997,sp,1524,545,864,1409
Thailand,1997,sp,2534,725,2336,3061
Thailand,1997,sp,3544,504,2101,2605
Thailand,1997,sp,4554,475,1488,1963
Thailand,1997,sp,5564,633,1434,2067
Thailand,1997,sp,65,690,1326,2016
Thailand,1998,sp,014,17,11,28
Thailand,1998,sp,1524,297,427,724
Thailand,1998,sp,2534,401,1153,1554
Thailand,1998,sp,3544,317,1098,1415
Thailand,1998,sp,4554,386,892,1278
Thailand,1998,sp,5564,475,945,1420
Thailand,1998,sp,65,558,985,1543
Thailand,1999,sp,014,30,20,50
Thailand,1999,sp,1524,511,791,1302
Thailand,1999,sp,2534,771,2123,2894
Thailand,1999,sp,3544,676,2015,2691
Thailand,1999,sp,4554,750,1702,2452
Thailand,1999,sp,5564,879,1705,2584
Thailand,1999,sp,65,1164,1795,2959
Thailand,2000,sp,014,32,27,59
Thailand,2000,sp,1524,624,859,1483
Thailand,2000,sp,2534,1035,2570,3605
Thailand,2000,sp,3544,780,2380,3160
Thailand,2000,sp,4554,873,2117,2990
Thailand,2000,sp,5564,1016,1908,2924
Thailand,2000,sp,65,1321,2213,3534
Thailand,2001,sp,014,58,37,95
Thailand,2001,sp,1524,999,1868,2867
Thailand,2001,sp,2534,1550,5192,6742
Thailand,2001,sp,3544,1231,4516,5747
Thailand,2001,sp,4554,1251,3269,4520
Thailand,2001,sp,5564,1265,2617,3882
Thailand,2001,sp,65,1777,2912,4689
Thailand,2002,sp,014,61,35,96
Thailand,2002,sp,1524,897,1352,2249
Thailand,2002,sp,2534,1525,3805,5330
Thailand,2002,sp,3544,1212,3699,4911
Thailand,2002,sp,4554,1143,3155,4298
Thailand,2002,sp,5564,1307,2556,3863
Thailand,2002,sp,65,1769,3077,4846
Thailand,2003,sp,014,49,41,90
Thailand,2003,sp,1524,944,1636,2580
Thailand,2003,sp,2534,1678,4615,6293
Thailand,2003,sp,3544,1350,4259,5609
Thailand,2003,sp,4554,1279,3497,4776
Thailand,2003,sp,5564,1264,2740,4004
Thailand,2003,sp,65,1866,3241,5107
Thailand,2004,sp,014,50,46,96
Thailand,2004,sp,1524,951,1421,2372
Thailand,2004,sp,2534,1602,4211,5813
Thailand,2004,sp,3544,1335,4542,5877
Thailand,2004,sp,4554,1217,3831,5048
Thailand,2004,sp,5564,1203,2787,3990
Thailand,2004,sp,65,1846,3379,5225
Thailand,2005,sp,014,57,44,101
Thailand,2005,sp,1524,907,1344,2251
Thailand,2005,sp,2534,1662,3814,5476
Thailand,2005,sp,3544,1334,4393,5727
Thailand,2005,sp,4554,1367,4003,5370
Thailand,2005,sp,5564,1259,2831,4090
Thailand,2005,sp,65,1938,3407,5345
Thailand,2006,sp,014,65,43,108
Thailand,2006,sp,1524,884,1276,2160
Thailand,2006,sp,2534,1542,3732,5274
Thailand,2006,sp,3544,1379,4664,6043
Thailand,2006,sp,4554,1349,4055,5404
Thailand,2006,sp,5564,1287,3084,4371
Thailand,2006,sp,65,1989,3732,5721
Thailand,2007,sp,014,50,48,98
Thailand,2007,sp,1524,885,1261,2146
Thailand,2007,sp,2534,1481,3398,4879
Thailand,2007,sp,3544,1418,4487,5905
Thailand,2007,sp,4554,1302,4168,5470
Thailand,2007,sp,5564,1281,3122,4403
Thailand,2007,sp,65,1938,3748,5686
Thailand,2008,sp,014,77,66,143
Thailand,2008,sp,1524,865,1222,2087
Thailand,2008,sp,2534,1513,3374,4887
Thailand,2008,sp,3544,1345,4425,5770
Thailand,2008,sp,4554,1407,4164,5571
Thailand,2008,sp,5564,1276,3167,4443
Thailand,2008,sp,65,2051,3836,5887
Thailand,2009,sp,014,80,43,123
Thailand,2009,sp,1524,1137,1348,2485
Thailand,2009,sp,2534,2032,3484,5516
Thailand,2009,sp,3544,1781,4692,6473
Thailand,2009,sp,4554,1633,4921,6554
Thailand,2009,sp,5564,1493,3597,5090
Thailand,2009,sp,65,2287,4282,6569
Thailand,2010,sp,014,82,55,137
Thailand,2010,sp,1524,1087,1506,2593
Thailand,2010,sp,2534,1930,3695,5625
Thailand,2010,sp,3544,1749,5253,7002
Thailand,2010,sp,4554,1467,5042,6509
Thailand,2010,sp,5564,1494,3625,5119
Thailand,2010,sp,65,2276,4189,6465
Thailand,2011,sp,014,76,38,114
Thailand,2011,sp,1524,1214,1546,2760
Thailand,2011,sp,2534,1773,3650,5423
Thailand,2011,sp,3544,1658,5139,6797
Thailand,2011,sp,4554,1586,5140,6726
Thailand,2011,sp,5564,1402,3734,5136
Thailand,2011,sp,65,2133,4080,6213
Thailand,2012,sp,014,82,35,117
Thailand,2012,sp,1524,995,1444,2439
Thailand,2012,sp,2534,1491,3277,4768
Thailand,2012,sp,3544,1613,4705,6318
Thailand,2012,sp,4554,1424,4867,6291
Thailand,2012,sp,5564,1364,3780,5144
Thailand,2012,sp,65,2058,3863,5921
The Former Yugoslav Republic of Macedonia,1995,sp,014,2,2,4
The Former Yugoslav Republic of Macedonia,1995,sp,1524,32,15,47
The Former Yugoslav Republic of Macedonia,1995,sp,2534,30,42,72
The Former Yugoslav Republic of Macedonia,1995,sp,3544,20,45,65
The Former Yugoslav Republic of Macedonia,1995,sp,4554,11,33,44
The Former Yugoslav Republic of Macedonia,1995,sp,5564,17,29,46
The Former Yugoslav Republic of Macedonia,1995,sp,65,17,24,41
The Former Yugoslav Republic of Macedonia,1996,sp,014,3,5,8
The Former Yugoslav Republic of Macedonia,1996,sp,1524,15,17,32
The Former Yugoslav Republic of Macedonia,1996,sp,2534,25,20,45
The Former Yugoslav Republic of Macedonia,1996,sp,3544,17,35,52
The Former Yugoslav Republic of Macedonia,1996,sp,4554,9,16,25
The Former Yugoslav Republic of Macedonia,1996,sp,5564,19,25,44
The Former Yugoslav Republic of Macedonia,1996,sp,65,12,22,34
The Former Yugoslav Republic of Macedonia,1997,sp,014,1,1,2
The Former Yugoslav Republic of Macedonia,1997,sp,1524,14,8,22
The Former Yugoslav Republic of Macedonia,1997,sp,2534,19,21,40
The Former Yugoslav Republic of Macedonia,1997,sp,3544,13,25,38
The Former Yugoslav Republic of Macedonia,1997,sp,4554,6,24,30
The Former Yugoslav Republic of Macedonia,1997,sp,5564,7,21,28
The Former Yugoslav Republic of Macedonia,1997,sp,65,11,21,32
The Former Yugoslav Republic of Macedonia,1998,sp,014,5,3,8
The Former Yugoslav Republic of Macedonia,1998,sp,1524,16,14,30
The Former Yugoslav Republic of Macedonia,1998,sp,2534,18,19,37
The Former Yugoslav Republic of Macedonia,1998,sp,3544,8,56,64
The Former Yugoslav Republic of Macedonia,1998,sp,4554,8,18,26
The Former Yugoslav Republic of Macedonia,1998,sp,5564,6,21,27
The Former Yugoslav Republic of Macedonia,1998,sp,65,4,13,17
The Former Yugoslav Republic of Macedonia,1999,sp,014,1,1,2
The Former Yugoslav Republic of Macedonia,1999,sp,1524,7,11,18
The Former Yugoslav Republic of Macedonia,1999,sp,2534,9,10,19
The Former Yugoslav Republic of Macedonia,1999,sp,3544,5,19,24
The Former Yugoslav Republic of Macedonia,1999,sp,4554,1,27,28
The Former Yugoslav Republic of Macedonia,1999,sp,5564,10,15,25
The Former Yugoslav Republic of Macedonia,1999,sp,65,1,5,6
The Former Yugoslav Republic of Macedonia,2000,sp,014,1,5,6
The Former Yugoslav Republic of Macedonia,2000,sp,1524,15,8,23
The Former Yugoslav Republic of Macedonia,2000,sp,2534,14,14,28
The Former Yugoslav Republic of Macedonia,2000,sp,3544,17,20,37
The Former Yugoslav Republic of Macedonia,2000,sp,4554,5,19,24
The Former Yugoslav Republic of Macedonia,2000,sp,5564,5,20,25
The Former Yugoslav Republic of Macedonia,2000,sp,65,10,14,24
The Former Yugoslav Republic of Macedonia,2001,sp,014,1,1,2
The Former Yugoslav Republic of Macedonia,2001,sp,1524,17,10,27
The Former Yugoslav Republic of Macedonia,2001,sp,2534,18,17,35
The Former Yugoslav Republic of Macedonia,2001,sp,3544,14,17,31
The Former Yugoslav Republic of Macedonia,2001,sp,4554,7,15,22
The Former Yugoslav Republic of Macedonia,2001,sp,5564,3,21,24
The Former Yugoslav Republic of Macedonia,2001,sp,65,7,16,23
The Former Yugoslav Republic of Macedonia,2002,sp,014,3,2,5
The Former Yugoslav Republic of Macedonia,2002,sp,1524,18,20,38
The Former Yugoslav Republic of Macedonia,2002,sp,2534,24,17,41
The Former Yugoslav Republic of Macedonia,2002,sp,3544,12,28,40
The Former Yugoslav Republic of Macedonia,2002,sp,4554,4,31,35
The Former Yugoslav Republic of Macedonia,2002,sp,5564,6,22,28
The Former Yugoslav Republic of Macedonia,2002,sp,65,6,7,13
The Former Yugoslav Republic of Macedonia,2003,sp,014,0,1,1
The Former Yugoslav Republic of Macedonia,2003,sp,1524,16,20,36
The Former Yugoslav Republic of Macedonia,2003,sp,2534,16,23,39
The Former Yugoslav Republic of Macedonia,2003,sp,3544,9,35,44
The Former Yugoslav Republic of Macedonia,2003,sp,4554,9,28,37
The Former Yugoslav Republic of Macedonia,2003,sp,5564,1,17,18
The Former Yugoslav Republic of Macedonia,2003,sp,65,8,17,25
The Former Yugoslav Republic of Macedonia,2004,sp,014,0,2,2
The Former Yugoslav Republic of Macedonia,2004,sp,1524,15,12,27
The Former Yugoslav Republic of Macedonia,2004,sp,2534,20,18,38
The Former Yugoslav Republic of Macedonia,2004,sp,3544,19,19,38
The Former Yugoslav Republic of Macedonia,2004,sp,4554,6,33,39
The Former Yugoslav Republic of Macedonia,2004,sp,5564,3,21,24
The Former Yugoslav Republic of Macedonia,2004,sp,65,17,15,32
The Former Yugoslav Republic of Macedonia,2005,sp,014,2,2,4
The Former Yugoslav Republic of Macedonia,2005,sp,1524,17,14,31
The Former Yugoslav Republic of Macedonia,2005,sp,2534,13,20,33
The Former Yugoslav Republic of Macedonia,2005,sp,3544,10,23,33
The Former Yugoslav Republic of Macedonia,2005,sp,4554,7,20,27
The Former Yugoslav Republic of Macedonia,2005,sp,5564,5,18,23
The Former Yugoslav Republic of Macedonia,2005,sp,65,13,13,26
The Former Yugoslav Republic of Macedonia,2006,ep,014,8,6,14
The Former Yugoslav Republic of Macedonia,2006,ep,1524,11,10,21
The Former Yugoslav Republic of Macedonia,2006,ep,2534,11,8,19
The Former Yugoslav Republic of Macedonia,2006,ep,3544,18,6,24
The Former Yugoslav Republic of Macedonia,2006,ep,4554,8,7,15
The Former Yugoslav Republic of Macedonia,2006,ep,5564,12,7,19
The Former Yugoslav Republic of Macedonia,2006,ep,65,14,7,21
The Former Yugoslav Republic of Macedonia,2006,sn,014,29,32,61
The Former Yugoslav Republic of Macedonia,2006,sn,1524,13,20,33
The Former Yugoslav Republic of Macedonia,2006,sn,2534,7,7,14
The Former Yugoslav Republic of Macedonia,2006,sn,3544,8,13,21
The Former Yugoslav Republic of Macedonia,2006,sn,4554,8,23,31
The Former Yugoslav Republic of Macedonia,2006,sn,5564,6,12,18
The Former Yugoslav Republic of Macedonia,2006,sn,65,11,29,40
The Former Yugoslav Republic of Macedonia,2006,sp,014,3,0,3
The Former Yugoslav Republic of Macedonia,2006,sp,1524,16,15,31
The Former Yugoslav Republic of Macedonia,2006,sp,2534,9,15,24
The Former Yugoslav Republic of Macedonia,2006,sp,3544,9,25,34
The Former Yugoslav Republic of Macedonia,2006,sp,4554,6,37,43
The Former Yugoslav Republic of Macedonia,2006,sp,5564,7,18,25
The Former Yugoslav Republic of Macedonia,2006,sp,65,11,7,18
The Former Yugoslav Republic of Macedonia,2007,ep,014,6,5,11
The Former Yugoslav Republic of Macedonia,2007,ep,1524,8,12,20
The Former Yugoslav Republic of Macedonia,2007,ep,2534,14,7,21
The Former Yugoslav Republic of Macedonia,2007,ep,3544,11,6,17
The Former Yugoslav Republic of Macedonia,2007,ep,4554,8,8,16
The Former Yugoslav Republic of Macedonia,2007,ep,5564,5,5,10
The Former Yugoslav Republic of Macedonia,2007,ep,65,13,9,22
The Former Yugoslav Republic of Macedonia,2007,sn,014,7,32,39
The Former Yugoslav Republic of Macedonia,2007,sn,1524,10,12,22
The Former Yugoslav Republic of Macedonia,2007,sn,2534,6,14,20
The Former Yugoslav Republic of Macedonia,2007,sn,3544,6,15,21
The Former Yugoslav Republic of Macedonia,2007,sn,4554,7,21,28
The Former Yugoslav Republic of Macedonia,2007,sn,5564,6,16,22
The Former Yugoslav Republic of Macedonia,2007,sn,65,9,16,25
The Former Yugoslav Republic of Macedonia,2007,sp,014,4,1,5
The Former Yugoslav Republic of Macedonia,2007,sp,1524,11,12,23
The Former Yugoslav Republic of Macedonia,2007,sp,2534,12,22,34
The Former Yugoslav Republic of Macedonia,2007,sp,3544,9,27,36
The Former Yugoslav Republic of Macedonia,2007,sp,4554,4,46,50
The Former Yugoslav Republic of Macedonia,2007,sp,5564,4,21,25
The Former Yugoslav Republic of Macedonia,2007,sp,65,8,19,27
The Former Yugoslav Republic of Macedonia,2008,ep,014,2,3,5
The Former Yugoslav Republic of Macedonia,2008,ep,1524,5,16,21
The Former Yugoslav Republic of Macedonia,2008,ep,2534,11,11,22
The Former Yugoslav Republic of Macedonia,2008,ep,3544,9,6,15
The Former Yugoslav Republic of Macedonia,2008,ep,4554,5,5,10
The Former Yugoslav Republic of Macedonia,2008,ep,5564,11,7,18
The Former Yugoslav Republic of Macedonia,2008,ep,65,8,8,16
The Former Yugoslav Republic of Macedonia,2008,sn,014,19,13,32
The Former Yugoslav Republic of Macedonia,2008,sn,1524,11,12,23
The Former Yugoslav Republic of Macedonia,2008,sn,2534,3,9,12
The Former Yugoslav Republic of Macedonia,2008,sn,3544,5,8,13
The Former Yugoslav Republic of Macedonia,2008,sn,4554,5,8,13
The Former Yugoslav Republic of Macedonia,2008,sn,5564,6,10,16
The Former Yugoslav Republic of Macedonia,2008,sn,65,8,16,24
The Former Yugoslav Republic of Macedonia,2008,sp,014,2,1,3
The Former Yugoslav Republic of Macedonia,2008,sp,1524,24,18,42
The Former Yugoslav Republic of Macedonia,2008,sp,2534,15,21,36
The Former Yugoslav Republic of Macedonia,2008,sp,3544,14,13,27
The Former Yugoslav Republic of Macedonia,2008,sp,4554,8,25,33
The Former Yugoslav Republic of Macedonia,2008,sp,5564,7,15,22
The Former Yugoslav Republic of Macedonia,2008,sp,65,10,15,25
The Former Yugoslav Republic of Macedonia,2009,ep,014,5,4,9
The Former Yugoslav Republic of Macedonia,2009,ep,1524,14,15,29
The Former Yugoslav Republic of Macedonia,2009,ep,2534,10,9,19
The Former Yugoslav Republic of Macedonia,2009,ep,3544,5,6,11
The Former Yugoslav Republic of Macedonia,2009,ep,4554,11,7,18
The Former Yugoslav Republic of Macedonia,2009,ep,5564,9,1,10
The Former Yugoslav Republic of Macedonia,2009,ep,65,11,9,20
The Former Yugoslav Republic of Macedonia,2009,sn,014,11,8,19
The Former Yugoslav Republic of Macedonia,2009,sn,1524,9,6,15
The Former Yugoslav Republic of Macedonia,2009,sn,2534,9,9,18
The Former Yugoslav Republic of Macedonia,2009,sn,3544,6,11,17
The Former Yugoslav Republic of Macedonia,2009,sn,4554,2,6,8
The Former Yugoslav Republic of Macedonia,2009,sn,5564,5,3,8
The Former Yugoslav Republic of Macedonia,2009,sn,65,7,11,18
The Former Yugoslav Republic of Macedonia,2009,sp,014,2,1,3
The Former Yugoslav Republic of Macedonia,2009,sp,1524,14,28,42
The Former Yugoslav Republic of Macedonia,2009,sp,2534,16,24,40
The Former Yugoslav Republic of Macedonia,2009,sp,3544,10,30,40
The Former Yugoslav Republic of Macedonia,2009,sp,4554,4,23,27
The Former Yugoslav Republic of Macedonia,2009,sp,5564,5,13,18
The Former Yugoslav Republic of Macedonia,2009,sp,65,14,14,28
The Former Yugoslav Republic of Macedonia,2010,ep,014,4,9,13
The Former Yugoslav Republic of Macedonia,2010,ep,1524,4,8,12
The Former Yugoslav Republic of Macedonia,2010,ep,2534,9,6,15
The Former Yugoslav Republic of Macedonia,2010,ep,3544,7,7,14
The Former Yugoslav Republic of Macedonia,2010,ep,4554,7,3,10
The Former Yugoslav Republic of Macedonia,2010,ep,5564,10,1,11
The Former Yugoslav Republic of Macedonia,2010,ep,65,8,9,17
The Former Yugoslav Republic of Macedonia,2010,sn,014,14,6,20
The Former Yugoslav Republic of Macedonia,2010,sn,1524,9,10,19
The Former Yugoslav Republic of Macedonia,2010,sn,2534,7,12,19
The Former Yugoslav Republic of Macedonia,2010,sn,3544,5,10,15
The Former Yugoslav Republic of Macedonia,2010,sn,4554,8,17,25
The Former Yugoslav Republic of Macedonia,2010,sn,5564,4,12,16
The Former Yugoslav Republic of Macedonia,2010,sn,65,7,14,21
The Former Yugoslav Republic of Macedonia,2010,sp,014,0,0,0
The Former Yugoslav Republic of Macedonia,2010,sp,1524,9,6,15
The Former Yugoslav Republic of Macedonia,2010,sp,2534,12,19,31
The Former Yugoslav Republic of Macedonia,2010,sp,3544,7,24,31
The Former Yugoslav Republic of Macedonia,2010,sp,4554,7,24,31
The Former Yugoslav Republic of Macedonia,2010,sp,5564,4,12,16
The Former Yugoslav Republic of Macedonia,2010,sp,65,6,11,17
The Former Yugoslav Republic of Macedonia,2011,ep,014,6,3,9
The Former Yugoslav Republic of Macedonia,2011,ep,1524,4,8,12
The Former Yugoslav Republic of Macedonia,2011,ep,2534,6,0,6
The Former Yugoslav Republic of Macedonia,2011,ep,3544,5,3,8
The Former Yugoslav Republic of Macedonia,2011,ep,4554,6,9,15
The Former Yugoslav Republic of Macedonia,2011,ep,5564,8,2,10
The Former Yugoslav Republic of Macedonia,2011,ep,65,9,7,16
The Former Yugoslav Republic of Macedonia,2011,sn,014,8,12,20
The Former Yugoslav Republic of Macedonia,2011,sn,1524,7,5,12
The Former Yugoslav Republic of Macedonia,2011,sn,2534,10,5,15
The Former Yugoslav Republic of Macedonia,2011,sn,3544,1,4,5
The Former Yugoslav Republic of Macedonia,2011,sn,4554,3,8,11
The Former Yugoslav Republic of Macedonia,2011,sn,5564,7,8,15
The Former Yugoslav Republic of Macedonia,2011,sn,65,10,11,21
The Former Yugoslav Republic of Macedonia,2011,sp,014,1,3,4
The Former Yugoslav Republic of Macedonia,2011,sp,1524,14,17,31
The Former Yugoslav Republic of Macedonia,2011,sp,2534,9,11,20
The Former Yugoslav Republic of Macedonia,2011,sp,3544,6,19,25
The Former Yugoslav Republic of Macedonia,2011,sp,4554,3,21,24
The Former Yugoslav Republic of Macedonia,2011,sp,5564,1,10,11
The Former Yugoslav Republic of Macedonia,2011,sp,65,11,6,17
The Former Yugoslav Republic of Macedonia,2012,ep,014,3,3,6
The Former Yugoslav Republic of Macedonia,2012,ep,1524,8,11,19
The Former Yugoslav Republic of Macedonia,2012,ep,2534,4,3,7
The Former Yugoslav Republic of Macedonia,2012,ep,3544,4,6,10
The Former Yugoslav Republic of Macedonia,2012,ep,4554,3,8,11
The Former Yugoslav Republic of Macedonia,2012,ep,5564,0,8,8
The Former Yugoslav Republic of Macedonia,2012,ep,65,8,9,17
The Former Yugoslav Republic of Macedonia,2012,sn,014,13,10,23
The Former Yugoslav Republic of Macedonia,2012,sn,1524,7,3,10
The Former Yugoslav Republic of Macedonia,2012,sn,2534,3,8,11
The Former Yugoslav Republic of Macedonia,2012,sn,3544,3,5,8
The Former Yugoslav Republic of Macedonia,2012,sn,4554,6,12,18
The Former Yugoslav Republic of Macedonia,2012,sn,5564,1,7,8
The Former Yugoslav Republic of Macedonia,2012,sn,65,5,12,17
The Former Yugoslav Republic of Macedonia,2012,sp,014,0,0,0
The Former Yugoslav Republic of Macedonia,2012,sp,1524,12,16,28
The Former Yugoslav Republic of Macedonia,2012,sp,2534,14,14,28
The Former Yugoslav Republic of Macedonia,2012,sp,3544,9,12,21
The Former Yugoslav Republic of Macedonia,2012,sp,4554,6,19,25
The Former Yugoslav Republic of Macedonia,2012,sp,5564,10,15,25
The Former Yugoslav Republic of Macedonia,2012,sp,65,7,13,20
The Former Yugoslav Republic of Macedonia,2013,rel,014,11,12,23
The Former Yugoslav Republic of Macedonia,2013,rel,1524,12,14,26
The Former Yugoslav Republic of Macedonia,2013,rel,2534,15,30,45
The Former Yugoslav Republic of Macedonia,2013,rel,3544,14,32,46
The Former Yugoslav Republic of Macedonia,2013,rel,4554,15,46,61
The Former Yugoslav Republic of Macedonia,2013,rel,5564,17,39,56
The Former Yugoslav Republic of Macedonia,2013,rel,65,20,41,61
Timor-Leste,2002,sp,014,20,13,33
Timor-Leste,2002,sp,1524,118,119,237
Timor-Leste,2002,sp,2534,124,145,269
Timor-Leste,2002,sp,3544,88,119,207
Timor-Leste,2002,sp,4554,91,107,198
Timor-Leste,2002,sp,5564,40,58,98
Timor-Leste,2002,sp,65,13,35,48
Timor-Leste,2003,sp,014,13,5,18
Timor-Leste,2003,sp,1524,98,130,228
Timor-Leste,2003,sp,2534,116,135,251
Timor-Leste,2003,sp,3544,76,107,183
Timor-Leste,2003,sp,4554,76,98,174
Timor-Leste,2003,sp,5564,43,66,109
Timor-Leste,2003,sp,65,17,41,58
Timor-Leste,2004,sp,014,19,5,24
Timor-Leste,2004,sp,1524,109,133,242
Timor-Leste,2004,sp,2534,116,134,250
Timor-Leste,2004,sp,3544,83,95,178
Timor-Leste,2004,sp,4554,51,99,150
Timor-Leste,2004,sp,5564,27,65,92
Timor-Leste,2004,sp,65,16,48,64
Timor-Leste,2005,sp,014,8,8,16
Timor-Leste,2005,sp,1524,127,136,263
Timor-Leste,2005,sp,2534,90,149,239
Timor-Leste,2005,sp,3544,76,116,192
Timor-Leste,2005,sp,4554,60,119,179
Timor-Leste,2005,sp,5564,18,52,70
Timor-Leste,2005,sp,65,29,47,76
Timor-Leste,2006,sp,014,8,1,9
Timor-Leste,2006,sp,1524,102,128,230
Timor-Leste,2006,sp,2534,76,115,191
Timor-Leste,2006,sp,3544,82,103,185
Timor-Leste,2006,sp,4554,63,75,138
Timor-Leste,2006,sp,5564,34,48,82
Timor-Leste,2006,sp,65,23,49,72
Timor-Leste,2007,sp,014,10,4,14
Timor-Leste,2007,sp,1524,120,128,248
Timor-Leste,2007,sp,2534,98,129,227
Timor-Leste,2007,sp,3544,89,89,178
Timor-Leste,2007,sp,4554,76,77,153
Timor-Leste,2007,sp,5564,36,69,105
Timor-Leste,2007,sp,65,31,65,96
Timor-Leste,2008,sp,014,4,6,10
Timor-Leste,2008,sp,1524,87,115,202
Timor-Leste,2008,sp,2534,72,88,160
Timor-Leste,2008,sp,3544,85,93,178
Timor-Leste,2008,sp,4554,67,73,140
Timor-Leste,2008,sp,5564,35,52,87
Timor-Leste,2008,sp,65,36,54,90
Timor-Leste,2009,sp,014,9,8,17
Timor-Leste,2009,sp,1524,124,158,282
Timor-Leste,2009,sp,2534,127,120,247
Timor-Leste,2009,sp,3544,105,94,199
Timor-Leste,2009,sp,4554,69,88,157
Timor-Leste,2009,sp,5564,63,75,138
Timor-Leste,2009,sp,65,60,106,166
Timor-Leste,2011,ep,014,55,51,106
Timor-Leste,2011,sn,014,282,366,648
Timor-Leste,2011,sp,014,16,14,30
Timor-Leste,2011,sp,1524,176,199,375
Timor-Leste,2011,sp,2534,182,177,359
Timor-Leste,2011,sp,3544,113,137,250
Timor-Leste,2011,sp,4554,85,114,199
Timor-Leste,2011,sp,5564,77,99,176
Timor-Leste,2011,sp,65,75,146,221
Timor-Leste,2012,ep,014,56,62,118
Timor-Leste,2012,sn,014,163,171,334
Timor-Leste,2012,sp,014,12,7,19
Timor-Leste,2012,sp,1524,154,196,350
Timor-Leste,2012,sp,2534,143,172,315
Timor-Leste,2012,sp,3544,120,128,248
Timor-Leste,2012,sp,4554,75,119,194
Timor-Leste,2012,sp,5564,84,114,198
Timor-Leste,2012,sp,65,92,129,221
Timor-Leste,2013,rel,014,173,167,340
Togo,1995,sp,014,9,7,16
Togo,1995,sp,1524,80,95,175
Togo,1995,sp,2534,96,151,247
Togo,1995,sp,3544,45,123,168
Togo,1995,sp,4554,38,82,120
Togo,1995,sp,5564,23,64,87
Togo,1995,sp,65,15,49,64
Togo,1996,sp,014,12,11,23
Togo,1996,sp,1524,89,95,184
Togo,1996,sp,2534,117,153,270
Togo,1996,sp,3544,45,134,179
Togo,1996,sp,4554,45,89,134
Togo,1996,sp,5564,15,37,52
Togo,1996,sp,65,19,50,69
Togo,1998,sp,014,15,13,28
Togo,1998,sp,1524,95,85,180
Togo,1998,sp,2534,113,177,290
Togo,1998,sp,3544,52,136,188
Togo,1998,sp,4554,36,86,122
Togo,1998,sp,5564,17,48,65
Togo,1998,sp,65,18,36,54
Togo,1999,sp,014,7,11,18
Togo,1999,sp,1524,88,92,180
Togo,1999,sp,2534,123,169,292
Togo,1999,sp,3544,64,124,188
Togo,1999,sp,4554,32,80,112
Togo,1999,sp,5564,25,42,67
Togo,1999,sp,65,10,37,47
Togo,2000,sp,014,13,4,17
Togo,2000,sp,1524,107,101,208
Togo,2000,sp,2534,124,168,292
Togo,2000,sp,3544,50,144,194
Togo,2000,sp,4554,36,109,145
Togo,2000,sp,5564,24,48,72
Togo,2000,sp,65,15,39,54
Togo,2002,sp,014,12,10,22
Togo,2002,sp,1524,125,140,265
Togo,2002,sp,2534,148,239,387
Togo,2002,sp,3544,79,166,245
Togo,2002,sp,4554,43,104,147
Togo,2002,sp,5564,29,55,84
Togo,2002,sp,65,13,40,53
Togo,2003,sp,014,15,10,25
Togo,2003,sp,1524,102,126,228
Togo,2003,sp,2534,149,229,378
Togo,2003,sp,3544,80,192,272
Togo,2003,sp,4554,55,120,175
Togo,2003,sp,5564,26,66,92
Togo,2003,sp,65,28,57,85
Togo,2004,sp,014,12,9,21
Togo,2004,sp,1524,150,145,295
Togo,2004,sp,2534,205,286,491
Togo,2004,sp,3544,103,233,336
Togo,2004,sp,4554,55,143,198
Togo,2004,sp,5564,37,69,106
Togo,2004,sp,65,28,66,94
Togo,2005,sp,014,23,11,34
Togo,2005,sp,1524,157,177,334
Togo,2005,sp,2534,236,320,556
Togo,2005,sp,3544,146,283,429
Togo,2005,sp,4554,67,125,192
Togo,2005,sp,5564,41,79,120
Togo,2005,sp,65,32,69,101
Togo,2006,sp,014,29,15,44
Togo,2006,sp,1524,214,174,388
Togo,2006,sp,2534,268,358,626
Togo,2006,sp,3544,170,344,514
Togo,2006,sp,4554,96,183,279
Togo,2006,sp,5564,58,94,152
Togo,2006,sp,65,49,79,128
Togo,2007,ep,014,NA,356,NA
Togo,2007,sn,014,NA,194,NA
Togo,2007,sp,014,17,7,24
Togo,2007,sp,1524,184,156,340
Togo,2007,sp,2534,256,309,565
Togo,2007,sp,3544,150,276,426
Togo,2007,sp,4554,67,170,237
Togo,2007,sp,5564,35,73,108
Togo,2007,sp,65,30,66,96
Togo,2008,sp,014,29,15,44
Togo,2008,sp,1524,202,194,396
Togo,2008,sp,2534,302,379,681
Togo,2008,sp,3544,170,338,508
Togo,2008,sp,4554,94,214,308
Togo,2008,sp,5564,47,113,160
Togo,2008,sp,65,59,78,137
Togo,2009,ep,014,17,17,34
Togo,2009,ep,1524,20,20,40
Togo,2009,ep,2534,21,40,61
Togo,2009,ep,3544,30,41,71
Togo,2009,ep,4554,33,36,69
Togo,2009,ep,5564,15,22,37
Togo,2009,ep,65,0,13,13
Togo,2009,sn,014,11,8,19
Togo,2009,sn,1524,13,7,20
Togo,2009,sn,2534,28,19,47
Togo,2009,sn,3544,13,29,42
Togo,2009,sn,4554,15,24,39
Togo,2009,sn,5564,10,16,26
Togo,2009,sn,65,6,14,20
Togo,2009,sp,014,27,15,42
Togo,2009,sp,1524,197,168,365
Togo,2009,sp,2534,288,378,666
Togo,2009,sp,3544,166,331,497
Togo,2009,sp,4554,86,233,319
Togo,2009,sp,5564,42,130,172
Togo,2009,sp,65,46,89,135
Togo,2010,sp,014,39,21,60
Togo,2010,sp,1524,163,150,313
Togo,2010,sp,2534,285,350,635
Togo,2010,sp,3544,148,358,506
Togo,2010,sp,4554,78,217,295
Togo,2010,sp,5564,62,116,178
Togo,2010,sp,65,29,80,109
Togo,2011,sp,014,11,15,26
Togo,2011,sp,1524,167,169,336
Togo,2011,sp,2534,277,340,617
Togo,2011,sp,3544,146,350,496
Togo,2011,sp,4554,89,234,323
Togo,2011,sp,5564,50,123,173
Togo,2011,sp,65,38,85,123
Togo,2012,sp,014,17,9,26
Togo,2012,sp,1524,165,171,336
Togo,2012,sp,2534,287,338,625
Togo,2012,sp,3544,154,341,495
Togo,2012,sp,4554,109,237,346
Togo,2012,sp,5564,48,121,169
Togo,2012,sp,65,28,87,115
Togo,2013,rel,014,44,41,85
Togo,2013,rel,1524,191,216,407
Togo,2013,rel,2534,300,401,701
Togo,2013,rel,3544,190,412,602
Togo,2013,rel,4554,125,307,432
Togo,2013,rel,5564,70,158,228
Togo,2013,rel,65,53,92,145
Tokelau,2007,ep,014,0,0,0
Tokelau,2007,ep,1524,0,0,0
Tokelau,2007,ep,2534,0,0,0
Tokelau,2007,ep,3544,0,0,0
Tokelau,2007,ep,4554,0,0,0
Tokelau,2007,ep,5564,0,0,0
Tokelau,2007,ep,65,0,0,0
Tokelau,2007,sn,014,0,0,0
Tokelau,2007,sn,1524,0,0,0
Tokelau,2007,sn,2534,0,0,0
Tokelau,2007,sn,3544,0,0,0
Tokelau,2007,sn,4554,0,0,0
Tokelau,2007,sn,5564,0,0,0
Tokelau,2007,sn,65,0,0,0
Tokelau,2007,sp,014,0,0,0
Tokelau,2007,sp,1524,0,0,0
Tokelau,2007,sp,2534,0,0,0
Tokelau,2007,sp,3544,0,0,0
Tokelau,2007,sp,4554,0,0,0
Tokelau,2007,sp,5564,0,0,0
Tokelau,2007,sp,65,0,0,0
Tokelau,2008,sn,014,0,NA,NA
Tokelau,2008,sn,1524,0,0,0
Tokelau,2008,sn,2534,0,0,0
Tokelau,2008,sn,3544,0,0,0
Tokelau,2008,sn,4554,0,0,0
Tokelau,2008,sn,5564,0,0,0
Tokelau,2008,sn,65,0,0,0
Tokelau,2008,sp,1524,0,0,0
Tokelau,2008,sp,2534,0,0,0
Tokelau,2008,sp,3544,0,0,0
Tokelau,2008,sp,4554,0,0,0
Tokelau,2008,sp,5564,0,0,0
Tokelau,2008,sp,65,0,NA,NA
Tokelau,2010,ep,014,0,0,0
Tokelau,2010,ep,1524,0,0,0
Tokelau,2010,ep,2534,0,0,0
Tokelau,2010,ep,3544,0,0,0
Tokelau,2010,ep,4554,0,0,0
Tokelau,2010,ep,5564,0,0,0
Tokelau,2010,ep,65,0,0,0
Tokelau,2010,sn,014,0,0,0
Tokelau,2010,sn,1524,0,0,0
Tokelau,2010,sn,2534,0,0,0
Tokelau,2010,sn,3544,0,0,0
Tokelau,2010,sn,4554,0,0,0
Tokelau,2010,sn,5564,0,0,0
Tokelau,2010,sn,65,0,0,0
Tokelau,2010,sp,014,0,0,0
Tokelau,2010,sp,1524,0,0,0
Tokelau,2010,sp,2534,0,0,0
Tokelau,2010,sp,3544,0,0,0
Tokelau,2010,sp,4554,0,0,0
Tokelau,2010,sp,5564,0,0,0
Tokelau,2010,sp,65,0,0,0
Tokelau,2013,rel,014,0,0,0
Tokelau,2013,rel,1524,0,0,0
Tokelau,2013,rel,2534,0,0,0
Tokelau,2013,rel,3544,0,0,0
Tokelau,2013,rel,4554,0,0,0
Tokelau,2013,rel,5564,0,0,0
Tokelau,2013,rel,65,0,0,0
Tonga,1995,sp,014,0,0,0
Tonga,1995,sp,1524,0,1,1
Tonga,1995,sp,2534,1,0,1
Tonga,1995,sp,3544,1,0,1
Tonga,1995,sp,4554,0,0,0
Tonga,1995,sp,5564,2,1,3
Tonga,1995,sp,65,1,2,3
Tonga,1996,sp,014,0,0,0
Tonga,1996,sp,1524,1,1,2
Tonga,1996,sp,2534,1,1,2
Tonga,1996,sp,3544,1,2,3
Tonga,1996,sp,4554,0,0,0
Tonga,1996,sp,5564,1,6,7
Tonga,1996,sp,65,2,0,2
Tonga,1997,sp,014,0,0,0
Tonga,1997,sp,1524,4,2,6
Tonga,1997,sp,2534,0,1,1
Tonga,1997,sp,3544,0,1,1
Tonga,1997,sp,4554,1,0,1
Tonga,1997,sp,5564,0,1,1
Tonga,1997,sp,65,0,2,2
Tonga,1998,sp,014,1,0,1
Tonga,1998,sp,1524,1,2,3
Tonga,1998,sp,2534,0,3,3
Tonga,1998,sp,3544,0,1,1
Tonga,1998,sp,4554,0,2,2
Tonga,1998,sp,5564,1,1,2
Tonga,1998,sp,65,2,2,4
Tonga,1999,sp,014,0,0,0
Tonga,1999,sp,1524,1,1,2
Tonga,1999,sp,2534,0,0,0
Tonga,1999,sp,3544,0,0,0
Tonga,1999,sp,4554,0,1,1
Tonga,1999,sp,5564,2,3,5
Tonga,1999,sp,65,0,2,2
Tonga,2000,sp,1524,1,2,3
Tonga,2000,sp,2534,1,1,2
Tonga,2000,sp,3544,1,1,2
Tonga,2000,sp,5564,1,1,2
Tonga,2000,sp,65,1,5,6
Tonga,2001,sp,014,0,0,0
Tonga,2001,sp,1524,0,0,0
Tonga,2001,sp,2534,2,1,3
Tonga,2001,sp,3544,1,0,1
Tonga,2001,sp,4554,1,0,1
Tonga,2001,sp,5564,0,2,2
Tonga,2001,sp,65,0,1,1
Tonga,2002,sp,1524,1,1,2
Tonga,2002,sp,2534,1,NA,NA
Tonga,2002,sp,3544,1,NA,NA
Tonga,2002,sp,4554,NA,4,NA
Tonga,2002,sp,5564,1,NA,NA
Tonga,2002,sp,65,4,10,14
Tonga,2003,sp,014,0,0,0
Tonga,2003,sp,1524,1,1,2
Tonga,2003,sp,2534,0,1,1
Tonga,2003,sp,3544,1,1,2
Tonga,2003,sp,4554,1,1,2
Tonga,2003,sp,5564,2,0,2
Tonga,2003,sp,65,0,2,2
Tonga,2005,sp,014,0,0,0
Tonga,2005,sp,1524,2,2,4
Tonga,2005,sp,2534,1,1,2
Tonga,2005,sp,3544,0,0,0
Tonga,2005,sp,4554,0,2,2
Tonga,2005,sp,5564,2,1,3
Tonga,2005,sp,65,0,0,0
Tonga,2006,ep,014,0,0,0
Tonga,2006,ep,1524,0,0,0
Tonga,2006,ep,2534,0,0,0
Tonga,2006,ep,3544,0,0,0
Tonga,2006,ep,4554,0,1,1
Tonga,2006,ep,5564,0,0,0
Tonga,2006,ep,65,0,0,0
Tonga,2006,sn,014,0,1,1
Tonga,2006,sn,1524,0,0,0
Tonga,2006,sn,2534,2,0,2
Tonga,2006,sn,3544,0,0,0
Tonga,2006,sn,4554,0,0,0
Tonga,2006,sn,5564,0,0,0
Tonga,2006,sn,65,0,0,0
Tonga,2006,sp,014,0,0,0
Tonga,2006,sp,1524,1,1,2
Tonga,2006,sp,2534,1,0,1
Tonga,2006,sp,3544,2,0,2
Tonga,2006,sp,4554,0,1,1
Tonga,2006,sp,5564,0,2,2
Tonga,2006,sp,65,2,4,6
Tonga,2007,ep,014,0,0,0
Tonga,2007,ep,1524,0,1,1
Tonga,2007,ep,2534,0,2,2
Tonga,2007,ep,3544,0,0,0
Tonga,2007,ep,4554,0,0,0
Tonga,2007,ep,5564,0,1,1
Tonga,2007,ep,65,0,0,0
Tonga,2007,sn,014,0,1,1
Tonga,2007,sn,1524,1,0,1
Tonga,2007,sn,2534,0,1,1
Tonga,2007,sn,3544,0,1,1
Tonga,2007,sn,4554,0,0,0
Tonga,2007,sn,5564,0,0,0
Tonga,2007,sn,65,0,1,1
Tonga,2007,sp,014,0,0,0
Tonga,2007,sp,1524,3,2,5
Tonga,2007,sp,2534,1,1,2
Tonga,2007,sp,3544,1,0,1
Tonga,2007,sp,4554,0,0,0
Tonga,2007,sp,5564,0,1,1
Tonga,2007,sp,65,0,5,5
Tonga,2008,ep,014,0,0,0
Tonga,2008,ep,1524,0,1,1
Tonga,2008,ep,2534,0,0,0
Tonga,2008,ep,3544,0,0,0
Tonga,2008,ep,4554,0,0,0
Tonga,2008,ep,5564,0,0,0
Tonga,2008,ep,65,1,0,1
Tonga,2008,sn,014,0,0,0
Tonga,2008,sn,1524,0,0,0
Tonga,2008,sn,2534,0,0,0
Tonga,2008,sn,3544,0,0,0
Tonga,2008,sn,4554,0,0,0
Tonga,2008,sn,5564,0,0,0
Tonga,2008,sn,65,0,0,0
Tonga,2008,sp,014,0,0,0
Tonga,2008,sp,1524,0,2,2
Tonga,2008,sp,2534,0,0,0
Tonga,2008,sp,3544,0,2,2
Tonga,2008,sp,4554,1,2,3
Tonga,2008,sp,5564,2,1,3
Tonga,2008,sp,65,0,1,1
Tonga,2009,ep,014,0,0,0
Tonga,2009,ep,1524,0,0,0
Tonga,2009,ep,2534,0,1,1
Tonga,2009,ep,3544,0,0,0
Tonga,2009,ep,4554,0,0,0
Tonga,2009,ep,5564,0,0,0
Tonga,2009,ep,65,0,0,0
Tonga,2009,sn,014,0,0,0
Tonga,2009,sn,1524,0,0,0
Tonga,2009,sn,2534,0,0,0
Tonga,2009,sn,3544,0,0,0
Tonga,2009,sn,4554,0,0,0
Tonga,2009,sn,5564,0,0,0
Tonga,2009,sn,65,1,0,1
Tonga,2009,sp,014,0,0,0
Tonga,2009,sp,1524,0,0,0
Tonga,2009,sp,2534,1,0,1
Tonga,2009,sp,3544,0,1,1
Tonga,2009,sp,4554,0,1,1
Tonga,2009,sp,5564,2,0,2
Tonga,2009,sp,65,1,0,1
Tonga,2010,ep,014,1,0,1
Tonga,2010,ep,1524,0,0,0
Tonga,2010,ep,2534,0,0,0
Tonga,2010,ep,3544,0,0,0
Tonga,2010,ep,4554,0,1,1
Tonga,2010,ep,5564,0,0,0
Tonga,2010,ep,65,0,0,0
Tonga,2010,sn,014,1,1,2
Tonga,2010,sn,1524,1,0,1
Tonga,2010,sn,2534,0,0,0
Tonga,2010,sn,3544,0,0,0
Tonga,2010,sn,4554,0,0,0
Tonga,2010,sn,5564,0,0,0
Tonga,2010,sn,65,0,0,0
Tonga,2010,sp,014,0,0,0
Tonga,2010,sp,1524,0,0,0
Tonga,2010,sp,2534,0,0,0
Tonga,2010,sp,3544,0,1,1
Tonga,2010,sp,4554,1,0,1
Tonga,2010,sp,5564,0,1,1
Tonga,2010,sp,65,0,3,3
Tonga,2011,ep,014,0,0,0
Tonga,2011,ep,1524,0,0,0
Tonga,2011,ep,2534,0,0,0
Tonga,2011,ep,3544,0,0,0
Tonga,2011,ep,4554,0,0,0
Tonga,2011,ep,5564,0,0,0
Tonga,2011,ep,65,0,0,0
Tonga,2011,sn,014,0,0,0
Tonga,2011,sn,1524,0,0,0
Tonga,2011,sn,2534,0,2,2
Tonga,2011,sn,3544,0,0,0
Tonga,2011,sn,4554,0,0,0
Tonga,2011,sn,5564,0,1,1
Tonga,2011,sn,65,0,0,0
Tonga,2011,sp,014,2,0,2
Tonga,2011,sp,1524,0,0,0
Tonga,2011,sp,2534,1,1,2
Tonga,2011,sp,3544,1,0,1
Tonga,2011,sp,4554,0,0,0
Tonga,2011,sp,5564,0,0,0
Tonga,2011,sp,65,0,1,1
Tonga,2012,ep,014,0,0,0
Tonga,2012,ep,1524,0,0,0
Tonga,2012,ep,2534,0,0,0
Tonga,2012,ep,3544,0,0,0
Tonga,2012,ep,4554,1,0,1
Tonga,2012,ep,5564,0,0,0
Tonga,2012,ep,65,0,0,0
Tonga,2012,sn,014,0,0,0
Tonga,2012,sn,1524,0,0,0
Tonga,2012,sn,2534,0,0,0
Tonga,2012,sn,3544,0,1,1
Tonga,2012,sn,4554,0,0,0
Tonga,2012,sn,5564,0,0,0
Tonga,2012,sn,65,0,0,0
Tonga,2012,sp,014,0,0,0
Tonga,2012,sp,1524,2,0,2
Tonga,2012,sp,2534,0,0,0
Tonga,2012,sp,3544,0,0,0
Tonga,2012,sp,4554,1,2,3
Tonga,2012,sp,5564,1,0,1
Tonga,2012,sp,65,1,2,3
Tonga,2013,rel,014,1,0,1
Tonga,2013,rel,1524,0,0,0
Tonga,2013,rel,2534,0,0,0
Tonga,2013,rel,3544,0,2,2
Tonga,2013,rel,4554,3,0,3
Tonga,2013,rel,5564,1,0,1
Tonga,2013,rel,65,2,1,3
Trinidad and Tobago,1995,sp,014,0,2,2
Trinidad and Tobago,1995,sp,1524,6,6,12
Trinidad and Tobago,1995,sp,2534,4,15,19
Trinidad and Tobago,1995,sp,3544,2,10,12
Trinidad and Tobago,1995,sp,4554,5,12,17
Trinidad and Tobago,1995,sp,5564,3,7,10
Trinidad and Tobago,1995,sp,65,0,4,4
Trinidad and Tobago,1996,sp,014,0,0,0
Trinidad and Tobago,1996,sp,1524,5,4,9
Trinidad and Tobago,1996,sp,2534,5,7,12
Trinidad and Tobago,1996,sp,3544,5,9,14
Trinidad and Tobago,1996,sp,4554,1,9,10
Trinidad and Tobago,1996,sp,5564,1,6,7
Trinidad and Tobago,1996,sp,65,1,6,7
Trinidad and Tobago,1998,sp,014,1,0,1
Trinidad and Tobago,1998,sp,1524,5,9,14
Trinidad and Tobago,1998,sp,2534,3,12,15
Trinidad and Tobago,1998,sp,3544,5,21,26
Trinidad and Tobago,1998,sp,4554,2,14,16
Trinidad and Tobago,1998,sp,5564,5,9,14
Trinidad and Tobago,1998,sp,65,4,8,12
Trinidad and Tobago,1999,sp,014,0,0,0
Trinidad and Tobago,1999,sp,1524,4,11,15
Trinidad and Tobago,1999,sp,2534,6,18,24
Trinidad and Tobago,1999,sp,3544,7,13,20
Trinidad and Tobago,1999,sp,4554,3,8,11
Trinidad and Tobago,1999,sp,5564,4,5,9
Trinidad and Tobago,1999,sp,65,1,6,7
Trinidad and Tobago,2000,sp,014,0,0,0
Trinidad and Tobago,2000,sp,1524,5,7,12
Trinidad and Tobago,2000,sp,2534,7,18,25
Trinidad and Tobago,2000,sp,3544,9,27,36
Trinidad and Tobago,2000,sp,4554,5,17,22
Trinidad and Tobago,2000,sp,5564,2,7,9
Trinidad and Tobago,2000,sp,65,4,7,11
Trinidad and Tobago,2001,sp,014,5,5,10
Trinidad and Tobago,2001,sp,1524,10,10,20
Trinidad and Tobago,2001,sp,2534,11,21,32
Trinidad and Tobago,2001,sp,3544,15,36,51
Trinidad and Tobago,2001,sp,4554,9,24,33
Trinidad and Tobago,2001,sp,5564,9,17,26
Trinidad and Tobago,2001,sp,65,8,18,26
Trinidad and Tobago,2002,sp,014,0,0,0
Trinidad and Tobago,2002,sp,1524,4,8,12
Trinidad and Tobago,2002,sp,2534,11,13,24
Trinidad and Tobago,2002,sp,3544,3,20,23
Trinidad and Tobago,2002,sp,4554,2,12,14
Trinidad and Tobago,2002,sp,5564,0,12,12
Trinidad and Tobago,2002,sp,65,7,3,10
Trinidad and Tobago,2003,sp,014,1,0,1
Trinidad and Tobago,2003,sp,1524,2,9,11
Trinidad and Tobago,2003,sp,2534,2,13,15
Trinidad and Tobago,2003,sp,3544,0,10,10
Trinidad and Tobago,2003,sp,4554,8,13,21
Trinidad and Tobago,2003,sp,5564,1,10,11
Trinidad and Tobago,2003,sp,65,2,6,8
Trinidad and Tobago,2004,sp,014,2,NA,NA
Trinidad and Tobago,2004,sp,1524,3,3,6
Trinidad and Tobago,2004,sp,2534,8,10,18
Trinidad and Tobago,2004,sp,3544,1,24,25
Trinidad and Tobago,2004,sp,4554,5,7,12
Trinidad and Tobago,2004,sp,5564,1,10,11
Trinidad and Tobago,2004,sp,65,NA,7,NA
Trinidad and Tobago,2005,sp,014,0,0,0
Trinidad and Tobago,2005,sp,1524,4,10,14
Trinidad and Tobago,2005,sp,2534,9,11,20
Trinidad and Tobago,2005,sp,3544,3,13,16
Trinidad and Tobago,2005,sp,4554,5,21,26
Trinidad and Tobago,2005,sp,5564,4,10,14
Trinidad and Tobago,2005,sp,65,3,3,6
Trinidad and Tobago,2006,ep,2534,3,3,6
Trinidad and Tobago,2006,ep,3544,1,5,6
Trinidad and Tobago,2006,ep,4554,NA,3,NA
Trinidad and Tobago,2006,ep,65,NA,2,NA
Trinidad and Tobago,2006,sn,014,3,3,6
Trinidad and Tobago,2006,sn,1524,1,2,3
Trinidad and Tobago,2006,sn,2534,1,10,11
Trinidad and Tobago,2006,sn,3544,3,11,14
Trinidad and Tobago,2006,sn,4554,2,14,16
Trinidad and Tobago,2006,sn,5564,NA,8,NA
Trinidad and Tobago,2006,sn,65,1,1,2
Trinidad and Tobago,2006,sp,014,1,2,3
Trinidad and Tobago,2006,sp,1524,3,7,10
Trinidad and Tobago,2006,sp,2534,10,27,37
Trinidad and Tobago,2006,sp,3544,5,23,28
Trinidad and Tobago,2006,sp,4554,4,20,24
Trinidad and Tobago,2006,sp,5564,8,16,24
Trinidad and Tobago,2006,sp,65,23,12,35
Trinidad and Tobago,2007,ep,014,0,1,1
Trinidad and Tobago,2007,ep,1524,0,2,2
Trinidad and Tobago,2007,ep,2534,0,2,2
Trinidad and Tobago,2007,ep,3544,2,4,6
Trinidad and Tobago,2007,ep,4554,2,2,4
Trinidad and Tobago,2007,ep,5564,1,3,4
Trinidad and Tobago,2007,ep,65,0,0,0
Trinidad and Tobago,2007,sn,014,3,2,5
Trinidad and Tobago,2007,sn,1524,2,2,4
Trinidad and Tobago,2007,sn,2534,1,2,3
Trinidad and Tobago,2007,sn,3544,1,9,10
Trinidad and Tobago,2007,sn,4554,2,10,12
Trinidad and Tobago,2007,sn,5564,1,9,10
Trinidad and Tobago,2007,sn,65,1,9,10
Trinidad and Tobago,2007,sp,014,0,1,1
Trinidad and Tobago,2007,sp,1524,5,10,15
Trinidad and Tobago,2007,sp,2534,7,16,23
Trinidad and Tobago,2007,sp,3544,7,21,28
Trinidad and Tobago,2007,sp,4554,4,28,32
Trinidad and Tobago,2007,sp,5564,3,18,21
Trinidad and Tobago,2007,sp,65,5,5,10
Trinidad and Tobago,2008,ep,014,0,0,0
Trinidad and Tobago,2008,ep,1524,0,0,0
Trinidad and Tobago,2008,ep,2534,1,0,1
Trinidad and Tobago,2008,ep,3544,0,4,4
Trinidad and Tobago,2008,ep,4554,1,2,3
Trinidad and Tobago,2008,ep,5564,0,0,0
Trinidad and Tobago,2008,ep,65,0,1,1
Trinidad and Tobago,2008,sn,014,1,9,10
Trinidad and Tobago,2008,sn,1524,5,4,9
Trinidad and Tobago,2008,sn,2534,6,13,19
Trinidad and Tobago,2008,sn,3544,2,7,9
Trinidad and Tobago,2008,sn,4554,5,14,19
Trinidad and Tobago,2008,sn,5564,3,12,15
Trinidad and Tobago,2008,sn,65,1,15,16
Trinidad and Tobago,2008,sp,014,1,2,3
Trinidad and Tobago,2008,sp,1524,11,9,20
Trinidad and Tobago,2008,sp,2534,12,15,27
Trinidad and Tobago,2008,sp,3544,4,19,23
Trinidad and Tobago,2008,sp,4554,8,34,42
Trinidad and Tobago,2008,sp,5564,4,29,33
Trinidad and Tobago,2008,sp,65,7,14,21
Trinidad and Tobago,2009,ep,014,2,1,3
Trinidad and Tobago,2009,ep,1524,0,0,0
Trinidad and Tobago,2009,ep,2534,1,2,3
Trinidad and Tobago,2009,ep,3544,1,1,2
Trinidad and Tobago,2009,ep,4554,1,7,8
Trinidad and Tobago,2009,ep,5564,0,2,2
Trinidad and Tobago,2009,ep,65,0,1,1
Trinidad and Tobago,2009,sn,014,7,3,10
Trinidad and Tobago,2009,sn,1524,5,3,8
Trinidad and Tobago,2009,sn,2534,2,6,8
Trinidad and Tobago,2009,sn,3544,4,10,14
Trinidad and Tobago,2009,sn,4554,4,21,25
Trinidad and Tobago,2009,sn,5564,2,7,9
Trinidad and Tobago,2009,sn,65,3,14,17
Trinidad and Tobago,2009,sp,014,2,2,4
Trinidad and Tobago,2009,sp,1524,4,6,10
Trinidad and Tobago,2009,sp,2534,11,18,29
Trinidad and Tobago,2009,sp,3544,9,26,35
Trinidad and Tobago,2009,sp,4554,9,20,29
Trinidad and Tobago,2009,sp,5564,4,25,29
Trinidad and Tobago,2009,sp,65,5,13,18
Trinidad and Tobago,2010,ep,014,0,3,3
Trinidad and Tobago,2010,ep,1524,3,1,4
Trinidad and Tobago,2010,ep,2534,2,3,5
Trinidad and Tobago,2010,ep,3544,1,1,2
Trinidad and Tobago,2010,ep,4554,2,1,3
Trinidad and Tobago,2010,ep,5564,1,2,3
Trinidad and Tobago,2010,ep,65,0,0,0
Trinidad and Tobago,2010,sn,014,0,5,5
Trinidad and Tobago,2010,sn,1524,2,2,4
Trinidad and Tobago,2010,sn,2534,4,7,11
Trinidad and Tobago,2010,sn,3544,1,6,7
Trinidad and Tobago,2010,sn,4554,3,9,12
Trinidad and Tobago,2010,sn,5564,1,10,11
Trinidad and Tobago,2010,sn,65,6,2,8
Trinidad and Tobago,2010,sp,014,0,0,0
Trinidad and Tobago,2010,sp,1524,4,11,15
Trinidad and Tobago,2010,sp,2534,7,21,28
Trinidad and Tobago,2010,sp,3544,7,17,24
Trinidad and Tobago,2010,sp,4554,5,32,37
Trinidad and Tobago,2010,sp,5564,2,20,22
Trinidad and Tobago,2010,sp,65,2,8,10
Trinidad and Tobago,2011,ep,014,0,0,0
Trinidad and Tobago,2011,ep,1524,4,2,6
Trinidad and Tobago,2011,ep,2534,0,4,4
Trinidad and Tobago,2011,ep,3544,1,2,3
Trinidad and Tobago,2011,ep,4554,2,2,4
Trinidad and Tobago,2011,ep,5564,1,0,1
Trinidad and Tobago,2011,ep,65,1,0,1
Trinidad and Tobago,2011,sn,014,1,4,5
Trinidad and Tobago,2011,sn,1524,4,3,7
Trinidad and Tobago,2011,sn,2534,2,12,14
Trinidad and Tobago,2011,sn,3544,3,11,14
Trinidad and Tobago,2011,sn,4554,9,7,16
Trinidad and Tobago,2011,sn,5564,1,9,10
Trinidad and Tobago,2011,sn,65,5,6,11
Trinidad and Tobago,2011,sp,014,1,1,2
Trinidad and Tobago,2011,sp,1524,6,14,20
Trinidad and Tobago,2011,sp,2534,7,27,34
Trinidad and Tobago,2011,sp,3544,3,13,16
Trinidad and Tobago,2011,sp,4554,4,15,19
Trinidad and Tobago,2011,sp,5564,2,16,18
Trinidad and Tobago,2011,sp,65,5,7,12
Trinidad and Tobago,2012,ep,014,1,2,3
Trinidad and Tobago,2012,ep,1524,1,2,3
Trinidad and Tobago,2012,ep,2534,3,1,4
Trinidad and Tobago,2012,ep,3544,1,1,2
Trinidad and Tobago,2012,ep,4554,0,2,2
Trinidad and Tobago,2012,ep,5564,1,2,3
Trinidad and Tobago,2012,ep,65,2,0,2
Trinidad and Tobago,2012,sn,014,0,2,2
Trinidad and Tobago,2012,sn,1524,1,2,3
Trinidad and Tobago,2012,sn,2534,5,7,12
Trinidad and Tobago,2012,sn,3544,4,9,13
Trinidad and Tobago,2012,sn,4554,4,12,16
Trinidad and Tobago,2012,sn,5564,2,14,16
Trinidad and Tobago,2012,sn,65,2,17,19
Trinidad and Tobago,2012,sp,014,2,0,2
Trinidad and Tobago,2012,sp,1524,9,7,16
Trinidad and Tobago,2012,sp,2534,11,31,42
Trinidad and Tobago,2012,sp,3544,10,22,32
Trinidad and Tobago,2012,sp,4554,8,28,36
Trinidad and Tobago,2012,sp,5564,4,12,16
Trinidad and Tobago,2012,sp,65,12,11,23
Trinidad and Tobago,2013,rel,014,7,6,13
Trinidad and Tobago,2013,rel,1524,5,14,19
Trinidad and Tobago,2013,rel,2534,14,48,62
Trinidad and Tobago,2013,rel,3544,7,41,48
Trinidad and Tobago,2013,rel,4554,5,36,41
Trinidad and Tobago,2013,rel,5564,7,26,33
Trinidad and Tobago,2013,rel,65,10,24,34
Tunisia,1998,sp,014,12,11,23
Tunisia,1998,sp,1524,80,134,214
Tunisia,1998,sp,2534,65,206,271
Tunisia,1998,sp,3544,43,155,198
Tunisia,1998,sp,4554,39,108,147
Tunisia,1998,sp,5564,43,88,131
Tunisia,1998,sp,65,26,95,121
Tunisia,1999,sp,014,15,18,33
Tunisia,1999,sp,1524,80,137,217
Tunisia,1999,sp,2534,76,221,297
Tunisia,1999,sp,3544,62,181,243
Tunisia,1999,sp,4554,40,106,146
Tunisia,1999,sp,5564,29,88,117
Tunisia,1999,sp,65,53,129,182
Tunisia,2000,sp,014,7,16,23
Tunisia,2000,sp,1524,68,139,207
Tunisia,2000,sp,2534,59,208,267
Tunisia,2000,sp,3544,43,156,199
Tunisia,2000,sp,4554,21,109,130
Tunisia,2000,sp,5564,21,65,86
Tunisia,2000,sp,65,58,101,159
Tunisia,2001,sp,014,9,23,32
Tunisia,2001,sp,1524,62,141,203
Tunisia,2001,sp,2534,42,185,227
Tunisia,2001,sp,3544,47,157,204
Tunisia,2001,sp,4554,30,103,133
Tunisia,2001,sp,5564,42,83,125
Tunisia,2001,sp,65,53,100,153
Tunisia,2002,sp,014,6,1,7
Tunisia,2002,sp,1524,55,112,167
Tunisia,2002,sp,2534,50,184,234
Tunisia,2002,sp,3544,36,153,189
Tunisia,2002,sp,4554,28,99,127
Tunisia,2002,sp,5564,34,67,101
Tunisia,2002,sp,65,37,65,102
Tunisia,2003,sp,014,7,3,10
Tunisia,2003,sp,1524,57,100,157
Tunisia,2003,sp,2534,56,164,220
Tunisia,2003,sp,3544,36,129,165
Tunisia,2003,sp,4554,34,95,129
Tunisia,2003,sp,5564,24,66,90
Tunisia,2003,sp,65,33,74,107
Tunisia,2004,sp,014,7,9,16
Tunisia,2004,sp,1524,44,100,144
Tunisia,2004,sp,2534,55,181,236
Tunisia,2004,sp,3544,39,128,167
Tunisia,2004,sp,4554,47,123,170
Tunisia,2004,sp,5564,19,62,81
Tunisia,2004,sp,65,39,91,130
Tunisia,2005,sp,014,7,5,12
Tunisia,2005,sp,1524,66,103,169
Tunisia,2005,sp,2534,61,172,233
Tunisia,2005,sp,3544,39,133,172
Tunisia,2005,sp,4554,36,115,151
Tunisia,2005,sp,5564,16,53,69
Tunisia,2005,sp,65,28,81,109
Tunisia,2006,sp,014,3,5,8
Tunisia,2006,sp,1524,53,125,178
Tunisia,2006,sp,2534,52,174,226
Tunisia,2006,sp,3544,33,119,152
Tunisia,2006,sp,4554,33,111,144
Tunisia,2006,sp,5564,33,58,91
Tunisia,2006,sp,65,38,85,123
Tunisia,2007,sp,014,11,1,12
Tunisia,2007,sp,1524,69,124,193
Tunisia,2007,sp,2534,54,171,225
Tunisia,2007,sp,3544,42,117,159
Tunisia,2007,sp,4554,28,104,132
Tunisia,2007,sp,5564,29,71,100
Tunisia,2007,sp,65,45,75,120
Tunisia,2008,sp,014,7,6,13
Tunisia,2008,sp,1524,68,130,198
Tunisia,2008,sp,2534,57,188,245
Tunisia,2008,sp,3544,35,118,153
Tunisia,2008,sp,4554,24,125,149
Tunisia,2008,sp,5564,18,80,98
Tunisia,2008,sp,65,52,59,111
Tunisia,2009,sp,014,7,6,13
Tunisia,2009,sp,1524,52,80,132
Tunisia,2009,sp,2534,55,175,230
Tunisia,2009,sp,3544,43,122,165
Tunisia,2009,sp,4554,42,134,176
Tunisia,2009,sp,5564,18,71,89
Tunisia,2009,sp,65,45,81,126
Tunisia,2010,sp,014,4,9,13
Tunisia,2010,sp,1524,64,115,179
Tunisia,2010,sp,2534,64,194,258
Tunisia,2010,sp,3544,39,170,209
Tunisia,2010,sp,4554,34,125,159
Tunisia,2010,sp,5564,40,93,133
Tunisia,2010,sp,65,52,88,140
Tunisia,2011,ep,014,67,59,126
Tunisia,2011,ep,1524,165,107,272
Tunisia,2011,ep,2534,209,127,336
Tunisia,2011,ep,3544,191,75,266
Tunisia,2011,ep,4554,155,88,243
Tunisia,2011,ep,5564,142,49,191
Tunisia,2011,ep,65,113,66,179
Tunisia,2011,sn,014,0,1,1
Tunisia,2011,sn,1524,20,24,44
Tunisia,2011,sn,2534,14,29,43
Tunisia,2011,sn,3544,17,19,36
Tunisia,2011,sn,4554,21,19,40
Tunisia,2011,sn,5564,11,23,34
Tunisia,2011,sn,65,14,34,48
Tunisia,2011,sp,014,10,6,16
Tunisia,2011,sp,1524,60,110,170
Tunisia,2011,sp,2534,60,194,254
Tunisia,2011,sp,3544,50,118,168
Tunisia,2011,sp,4554,44,126,170
Tunisia,2011,sp,5564,35,108,143
Tunisia,2011,sp,65,47,63,110
Tunisia,2012,ep,014,94,87,181
Tunisia,2012,ep,1524,200,124,324
Tunisia,2012,ep,2534,225,123,348
Tunisia,2012,ep,3544,189,99,288
Tunisia,2012,ep,4554,186,105,291
Tunisia,2012,ep,5564,162,74,236
Tunisia,2012,ep,65,105,80,185
Tunisia,2012,sn,014,4,2,6
Tunisia,2012,sn,1524,13,19,32
Tunisia,2012,sn,2534,16,39,55
Tunisia,2012,sn,3544,18,35,53
Tunisia,2012,sn,4554,16,23,39
Tunisia,2012,sn,5564,16,30,46
Tunisia,2012,sn,65,20,31,51
Tunisia,2012,sp,014,7,10,17
Tunisia,2012,sp,1524,51,88,139
Tunisia,2012,sp,2534,56,191,247
Tunisia,2012,sp,3544,46,149,195
Tunisia,2012,sp,4554,48,114,162
Tunisia,2012,sp,5564,46,93,139
Tunisia,2012,sp,65,72,88,160
Tunisia,2013,rel,014,105,91,196
Tunisia,2013,rel,1524,239,210,449
Tunisia,2013,rel,2534,349,360,709
Tunisia,2013,rel,3544,230,288,518
Tunisia,2013,rel,4554,228,216,444
Tunisia,2013,rel,5564,189,182,371
Tunisia,2013,rel,65,171,177,348
Turkey,2004,sp,014,2,0,2
Turkey,2004,sp,1524,24,50,74
Turkey,2004,sp,2534,21,38,59
Turkey,2004,sp,3544,8,50,58
Turkey,2004,sp,4554,4,41,45
Turkey,2004,sp,5564,7,28,35
Turkey,2004,sp,65,6,19,25
Turkey,2005,sp,014,50,33,83
Turkey,2005,sp,1524,699,1148,1847
Turkey,2005,sp,2534,474,1295,1769
Turkey,2005,sp,3544,243,1028,1271
Turkey,2005,sp,4554,175,963,1138
Turkey,2005,sp,5564,166,534,700
Turkey,2005,sp,65,213,429,642
Turkey,2006,ep,014,247,227,474
Turkey,2006,ep,1524,610,759,1369
Turkey,2006,ep,2534,576,581,1157
Turkey,2006,ep,3544,446,349,795
Turkey,2006,ep,4554,386,265,651
Turkey,2006,ep,5564,339,210,549
Turkey,2006,ep,65,348,266,614
Turkey,2006,sn,014,272,271,543
Turkey,2006,sn,1524,531,727,1258
Turkey,2006,sn,2534,365,693,1058
Turkey,2006,sn,3544,194,511,705
Turkey,2006,sn,4554,120,426,546
Turkey,2006,sn,5564,122,321,443
Turkey,2006,sn,65,170,346,516
Turkey,2006,sp,014,56,40,96
Turkey,2006,sp,1524,769,1212,1981
Turkey,2006,sp,2534,507,1391,1898
Turkey,2006,sp,3544,235,1003,1238
Turkey,2006,sp,4554,155,1045,1200
Turkey,2006,sp,5564,149,575,724
Turkey,2006,sp,65,256,473,729
Turkey,2007,ep,014,192,201,393
Turkey,2007,ep,1524,597,735,1332
Turkey,2007,ep,2534,613,601,1214
Turkey,2007,ep,3544,466,347,813
Turkey,2007,ep,4554,473,267,740
Turkey,2007,ep,5564,415,212,627
Turkey,2007,ep,65,383,288,671
Turkey,2007,sn,014,207,239,446
Turkey,2007,sn,1524,516,649,1165
Turkey,2007,sn,2534,332,636,968
Turkey,2007,sn,3544,172,419,591
Turkey,2007,sn,4554,135,390,525
Turkey,2007,sn,5564,96,251,347
Turkey,2007,sn,65,149,301,450
Turkey,2007,sp,014,63,50,113
Turkey,2007,sp,1524,708,1091,1799
Turkey,2007,sp,2534,531,1245,1776
Turkey,2007,sp,3544,246,984,1230
Turkey,2007,sp,4554,165,978,1143
Turkey,2007,sp,5564,128,571,699
Turkey,2007,sp,65,255,512,767
Turkey,2008,ep,014,180,211,391
Turkey,2008,ep,1524,510,591,1101
Turkey,2008,ep,2534,588,535,1123
Turkey,2008,ep,3544,461,319,780
Turkey,2008,ep,4554,431,278,709
Turkey,2008,ep,5564,409,232,641
Turkey,2008,ep,65,423,274,697
Turkey,2008,sn,014,226,227,453
Turkey,2008,sn,1524,459,617,1076
Turkey,2008,sn,2534,339,600,939
Turkey,2008,sn,3544,170,379,549
Turkey,2008,sn,4554,121,344,465
Turkey,2008,sn,5564,109,287,396
Turkey,2008,sn,65,166,281,447
Turkey,2008,sp,014,57,48,105
Turkey,2008,sp,1524,653,940,1593
Turkey,2008,sp,2534,485,1090,1575
Turkey,2008,sp,3544,233,953,1186
Turkey,2008,sp,4554,152,947,1099
Turkey,2008,sp,5564,139,607,746
Turkey,2008,sp,65,236,453,689
Turkey,2009,ep,014,201,210,411
Turkey,2009,ep,1524,545,563,1108
Turkey,2009,ep,2534,586,505,1091
Turkey,2009,ep,3544,458,321,779
Turkey,2009,ep,4554,513,288,801
Turkey,2009,ep,5564,463,232,695
Turkey,2009,ep,65,467,295,762
Turkey,2009,sn,014,248,211,459
Turkey,2009,sn,1524,452,554,1006
Turkey,2009,sn,2534,341,558,899
Turkey,2009,sn,3544,174,375,549
Turkey,2009,sn,4554,137,384,521
Turkey,2009,sn,5564,121,260,381
Turkey,2009,sn,65,164,310,474
Turkey,2009,sp,014,36,34,70
Turkey,2009,sp,1524,479,817,1296
Turkey,2009,sp,2534,469,986,1455
Turkey,2009,sp,3544,171,729,900
Turkey,2009,sp,4554,137,865,1002
Turkey,2009,sp,5564,127,500,627
Turkey,2009,sp,65,225,432,657
Turkey,2010,ep,014,150,205,355
Turkey,2010,ep,1524,490,502,992
Turkey,2010,ep,2534,587,478,1065
Turkey,2010,ep,3544,458,363,821
Turkey,2010,ep,4554,509,301,810
Turkey,2010,ep,5564,475,275,750
Turkey,2010,ep,65,489,335,824
Turkey,2010,sn,014,222,246,468
Turkey,2010,sn,1524,450,476,926
Turkey,2010,sn,2534,359,500,859
Turkey,2010,sn,3544,140,362,502
Turkey,2010,sn,4554,138,367,505
Turkey,2010,sn,5564,147,273,420
Turkey,2010,sn,65,198,313,511
Turkey,2010,sp,014,33,23,56
Turkey,2010,sp,1524,485,631,1116
Turkey,2010,sp,2534,384,779,1163
Turkey,2010,sp,3544,193,703,896
Turkey,2010,sp,4554,141,778,919
Turkey,2010,sp,5564,101,514,615
Turkey,2010,sp,65,203,407,610
Turkey,2011,ep,014,133,140,273
Turkey,2011,ep,1524,426,519,945
Turkey,2011,ep,2534,602,468,1070
Turkey,2011,ep,3544,496,311,807
Turkey,2011,ep,4554,501,307,808
Turkey,2011,ep,5564,493,325,818
Turkey,2011,ep,65,491,353,844
Turkey,2011,sn,014,212,212,424
Turkey,2011,sn,1524,380,441,821
Turkey,2011,sn,2534,298,452,750
Turkey,2011,sn,3544,150,343,493
Turkey,2011,sn,4554,127,331,458
Turkey,2011,sn,5564,159,314,473
Turkey,2011,sn,65,196,310,506
Turkey,2011,sp,014,25,22,47
Turkey,2011,sp,1524,409,550,959
Turkey,2011,sp,2534,385,693,1078
Turkey,2011,sp,3544,195,608,803
Turkey,2011,sp,4554,117,696,813
Turkey,2011,sp,5564,121,482,603
Turkey,2011,sp,65,212,412,624
Turkey,2012,ep,014,127,151,278
Turkey,2012,ep,1524,364,449,813
Turkey,2012,ep,2534,544,462,1006
Turkey,2012,ep,3544,419,346,765
Turkey,2012,ep,4554,474,298,772
Turkey,2012,ep,5564,442,261,703
Turkey,2012,ep,65,491,293,784
Turkey,2012,sn,014,174,170,344
Turkey,2012,sn,1524,349,396,745
Turkey,2012,sn,2534,288,434,722
Turkey,2012,sn,3544,175,330,505
Turkey,2012,sn,4554,118,334,452
Turkey,2012,sn,5564,133,340,473
Turkey,2012,sn,65,225,363,588
Turkey,2012,sp,014,30,20,50
Turkey,2012,sp,1524,369,507,876
Turkey,2012,sp,2534,308,655,963
Turkey,2012,sp,3544,168,575,743
Turkey,2012,sp,4554,97,650,747
Turkey,2012,sp,5564,105,476,581
Turkey,2012,sp,65,227,398,625
Turkey,2013,rel,014,299,282,581
Turkey,2013,rel,1524,998,1276,2274
Turkey,2013,rel,2534,1136,1313,2449
Turkey,2013,rel,3544,743,1175,1918
Turkey,2013,rel,4554,663,1378,2041
Turkey,2013,rel,5564,682,1114,1796
Turkey,2013,rel,65,960,1151,2111
Turkmenistan,1995,sp,014,2,1,3
Turkmenistan,1995,sp,1524,15,11,26
Turkmenistan,1995,sp,2534,146,188,334
Turkmenistan,1995,sp,3544,0,0,0
Turkmenistan,1995,sp,4554,47,79,126
Turkmenistan,1995,sp,5564,25,30,55
Turkmenistan,1995,sp,65,0,0,0
Turkmenistan,1996,sp,014,2,0,2
Turkmenistan,1996,sp,1524,12,15,27
Turkmenistan,1996,sp,2534,75,114,189
Turkmenistan,1996,sp,3544,72,101,173
Turkmenistan,1996,sp,4554,25,44,69
Turkmenistan,1996,sp,5564,19,37,56
Turkmenistan,1996,sp,65,18,23,41
Turkmenistan,1997,sp,014,0,2,2
Turkmenistan,1997,sp,1524,10,14,24
Turkmenistan,1997,sp,2534,95,208,303
Turkmenistan,1997,sp,3544,75,77,152
Turkmenistan,1997,sp,4554,47,90,137
Turkmenistan,1997,sp,5564,45,69,114
Turkmenistan,1997,sp,65,22,10,32
Turkmenistan,1998,sp,014,2,0,2
Turkmenistan,1998,sp,1524,59,100,159
Turkmenistan,1998,sp,2534,69,210,279
Turkmenistan,1998,sp,3544,43,131,174
Turkmenistan,1998,sp,4554,28,64,92
Turkmenistan,1998,sp,5564,16,48,64
Turkmenistan,1998,sp,65,8,12,20
Turkmenistan,1999,sp,014,2,5,7
Turkmenistan,1999,sp,1524,51,129,180
Turkmenistan,1999,sp,2534,103,225,328
Turkmenistan,1999,sp,3544,65,174,239
Turkmenistan,1999,sp,4554,32,77,109
Turkmenistan,1999,sp,5564,27,43,70
Turkmenistan,1999,sp,65,14,17,31
Turkmenistan,2000,sp,014,19,16,35
Turkmenistan,2000,sp,1524,73,103,176
Turkmenistan,2000,sp,2534,140,185,325
Turkmenistan,2000,sp,3544,76,144,220
Turkmenistan,2000,sp,4554,31,127,158
Turkmenistan,2000,sp,5564,34,31,65
Turkmenistan,2000,sp,65,17,21,38
Turkmenistan,2001,sp,014,3,1,4
Turkmenistan,2001,sp,1524,113,169,282
Turkmenistan,2001,sp,2534,137,295,432
Turkmenistan,2001,sp,3544,70,196,266
Turkmenistan,2001,sp,4554,40,93,133
Turkmenistan,2001,sp,5564,32,46,78
Turkmenistan,2001,sp,65,27,21,48
Turkmenistan,2002,sp,014,3,2,5
Turkmenistan,2002,sp,1524,113,164,277
Turkmenistan,2002,sp,2534,143,249,392
Turkmenistan,2002,sp,3544,74,224,298
Turkmenistan,2002,sp,4554,57,112,169
Turkmenistan,2002,sp,5564,34,38,72
Turkmenistan,2002,sp,65,20,21,41
Turkmenistan,2003,sp,014,5,3,8
Turkmenistan,2003,sp,1524,94,148,242
Turkmenistan,2003,sp,2534,139,265,404
Turkmenistan,2003,sp,3544,84,212,296
Turkmenistan,2003,sp,4554,42,112,154
Turkmenistan,2003,sp,5564,21,37,58
Turkmenistan,2003,sp,65,21,14,35
Turkmenistan,2004,sp,014,2,0,2
Turkmenistan,2004,sp,1524,90,129,219
Turkmenistan,2004,sp,2534,128,250,378
Turkmenistan,2004,sp,3544,68,174,242
Turkmenistan,2004,sp,4554,45,123,168
Turkmenistan,2004,sp,5564,26,37,63
Turkmenistan,2004,sp,65,19,12,31
Turkmenistan,2005,sp,014,3,2,5
Turkmenistan,2005,sp,1524,100,148,248
Turkmenistan,2005,sp,2534,101,181,282
Turkmenistan,2005,sp,3544,72,146,218
Turkmenistan,2005,sp,4554,46,97,143
Turkmenistan,2005,sp,5564,27,51,78
Turkmenistan,2005,sp,65,8,13,21
Turkmenistan,2006,ep,014,9,9,18
Turkmenistan,2006,ep,1524,18,38,56
Turkmenistan,2006,ep,2534,23,42,65
Turkmenistan,2006,ep,3544,30,28,58
Turkmenistan,2006,ep,4554,12,15,27
Turkmenistan,2006,ep,5564,10,14,24
Turkmenistan,2006,ep,65,4,4,8
Turkmenistan,2006,sn,014,7,8,15
Turkmenistan,2006,sn,1524,87,140,227
Turkmenistan,2006,sn,2534,100,180,280
Turkmenistan,2006,sn,3544,62,126,188
Turkmenistan,2006,sn,4554,24,71,95
Turkmenistan,2006,sn,5564,24,35,59
Turkmenistan,2006,sn,65,12,12,24
Turkmenistan,2006,sp,014,5,0,5
Turkmenistan,2006,sp,1524,107,140,247
Turkmenistan,2006,sp,2534,115,273,388
Turkmenistan,2006,sp,3544,72,191,263
Turkmenistan,2006,sp,4554,34,120,154
Turkmenistan,2006,sp,5564,24,33,57
Turkmenistan,2006,sp,65,23,18,41
Turkmenistan,2007,ep,014,0,0,0
Turkmenistan,2007,ep,1524,0,0,0
Turkmenistan,2007,ep,2534,0,0,0
Turkmenistan,2007,ep,3544,0,0,0
Turkmenistan,2007,ep,4554,0,0,0
Turkmenistan,2007,ep,5564,0,0,0
Turkmenistan,2007,ep,65,0,0,0
Turkmenistan,2007,sn,014,0,0,0
Turkmenistan,2007,sn,1524,0,0,0
Turkmenistan,2007,sn,2534,0,0,0
Turkmenistan,2007,sn,3544,0,0,0
Turkmenistan,2007,sn,4554,0,0,0
Turkmenistan,2007,sn,5564,0,0,0
Turkmenistan,2007,sn,65,0,0,0
Turkmenistan,2007,sp,014,6,2,8
Turkmenistan,2007,sp,1524,129,176,305
Turkmenistan,2007,sp,2534,132,272,404
Turkmenistan,2007,sp,3544,81,224,305
Turkmenistan,2007,sp,4554,69,137,206
Turkmenistan,2007,sp,5564,36,56,92
Turkmenistan,2007,sp,65,35,23,58
Turkmenistan,2008,sp,014,4,3,7
Turkmenistan,2008,sp,1524,126,176,302
Turkmenistan,2008,sp,2534,146,235,381
Turkmenistan,2008,sp,3544,81,201,282
Turkmenistan,2008,sp,4554,56,164,220
Turkmenistan,2008,sp,5564,29,56,85
Turkmenistan,2008,sp,65,30,24,54
Turkmenistan,2009,sp,014,5,0,5
Turkmenistan,2009,sp,1524,146,178,324
Turkmenistan,2009,sp,2534,119,223,342
Turkmenistan,2009,sp,3544,90,221,311
Turkmenistan,2009,sp,4554,65,155,220
Turkmenistan,2009,sp,5564,47,59,106
Turkmenistan,2009,sp,65,30,32,62
Turkmenistan,2010,sp,014,2,1,3
Turkmenistan,2010,sp,1524,112,130,242
Turkmenistan,2010,sp,2534,112,212,324
Turkmenistan,2010,sp,3544,74,183,257
Turkmenistan,2010,sp,4554,46,141,187
Turkmenistan,2010,sp,5564,38,51,89
Turkmenistan,2010,sp,65,25,26,51
Turkmenistan,2011,sn,014,24,26,50
Turkmenistan,2011,sn,1524,103,93,196
Turkmenistan,2011,sn,2534,95,151,246
Turkmenistan,2011,sn,3544,79,149,228
Turkmenistan,2011,sn,4554,42,123,165
Turkmenistan,2011,sn,5564,20,71,91
Turkmenistan,2011,sn,65,12,15,27
Turkmenistan,2011,sp,014,1,0,1
Turkmenistan,2011,sp,1524,113,117,230
Turkmenistan,2011,sp,2534,115,179,294
Turkmenistan,2011,sp,3544,94,167,261
Turkmenistan,2011,sp,4554,50,134,184
Turkmenistan,2011,sp,5564,33,91,124
Turkmenistan,2011,sp,65,20,23,43
Turkmenistan,2012,sn,014,21,22,43
Turkmenistan,2012,sn,1524,112,204,316
Turkmenistan,2012,sn,2534,142,170,312
Turkmenistan,2012,sn,3544,61,131,192
Turkmenistan,2012,sn,4554,63,93,156
Turkmenistan,2012,sn,5564,37,43,80
Turkmenistan,2012,sn,65,7,11,18
Turkmenistan,2012,sp,014,0,1,1
Turkmenistan,2012,sp,1524,137,111,248
Turkmenistan,2012,sp,2534,120,200,320
Turkmenistan,2012,sp,3544,56,171,227
Turkmenistan,2012,sp,4554,64,135,199
Turkmenistan,2012,sp,5564,37,62,99
Turkmenistan,2012,sp,65,33,20,53
Turks and Caicos Islands,2002,sp,2534,1,NA,NA
Turks and Caicos Islands,2002,sp,3544,NA,1,NA
Turks and Caicos Islands,2003,sp,014,0,0,0
Turks and Caicos Islands,2003,sp,1524,0,0,0
Turks and Caicos Islands,2003,sp,2534,2,2,4
Turks and Caicos Islands,2003,sp,3544,0,0,0
Turks and Caicos Islands,2003,sp,4554,2,0,2
Turks and Caicos Islands,2003,sp,5564,0,0,0
Turks and Caicos Islands,2003,sp,65,0,0,0
Turks and Caicos Islands,2006,ep,014,0,0,0
Turks and Caicos Islands,2006,ep,1524,0,0,0
Turks and Caicos Islands,2006,ep,2534,0,0,0
Turks and Caicos Islands,2006,ep,3544,0,0,0
Turks and Caicos Islands,2006,ep,4554,0,0,0
Turks and Caicos Islands,2006,ep,5564,0,0,0
Turks and Caicos Islands,2006,ep,65,0,0,0
Turks and Caicos Islands,2006,sn,014,0,0,0
Turks and Caicos Islands,2006,sn,1524,0,0,0
Turks and Caicos Islands,2006,sn,2534,0,0,0
Turks and Caicos Islands,2006,sn,3544,0,0,0
Turks and Caicos Islands,2006,sn,4554,0,0,0
Turks and Caicos Islands,2006,sn,5564,0,0,0
Turks and Caicos Islands,2006,sn,65,0,0,0
Turks and Caicos Islands,2006,sp,014,0,0,0
Turks and Caicos Islands,2006,sp,1524,1,1,2
Turks and Caicos Islands,2006,sp,2534,1,1,2
Turks and Caicos Islands,2006,sp,3544,1,0,1
Turks and Caicos Islands,2006,sp,4554,1,0,1
Turks and Caicos Islands,2006,sp,5564,1,0,1
Turks and Caicos Islands,2006,sp,65,0,0,0
Turks and Caicos Islands,2010,ep,014,0,0,0
Turks and Caicos Islands,2010,ep,1524,0,0,0
Turks and Caicos Islands,2010,ep,2534,0,1,1
Turks and Caicos Islands,2010,ep,3544,0,0,0
Turks and Caicos Islands,2010,ep,4554,0,0,0
Turks and Caicos Islands,2010,ep,5564,0,0,0
Turks and Caicos Islands,2010,ep,65,0,0,0
Turks and Caicos Islands,2010,sn,014,0,0,0
Turks and Caicos Islands,2010,sn,1524,1,0,1
Turks and Caicos Islands,2010,sn,2534,0,0,0
Turks and Caicos Islands,2010,sn,3544,0,0,0
Turks and Caicos Islands,2010,sn,4554,0,0,0
Turks and Caicos Islands,2010,sn,5564,0,NA,NA
Turks and Caicos Islands,2010,sn,65,0,0,0
Turks and Caicos Islands,2010,sp,014,0,0,0
Turks and Caicos Islands,2010,sp,1524,0,0,0
Turks and Caicos Islands,2010,sp,2534,0,0,0
Turks and Caicos Islands,2010,sp,3544,1,1,2
Turks and Caicos Islands,2010,sp,4554,1,0,1
Turks and Caicos Islands,2010,sp,5564,0,0,0
Turks and Caicos Islands,2010,sp,65,0,0,0
Turks and Caicos Islands,2011,ep,014,0,0,0
Turks and Caicos Islands,2011,ep,1524,0,0,0
Turks and Caicos Islands,2011,ep,2534,0,0,0
Turks and Caicos Islands,2011,ep,3544,0,0,0
Turks and Caicos Islands,2011,ep,4554,0,0,0
Turks and Caicos Islands,2011,ep,5564,0,0,0
Turks and Caicos Islands,2011,ep,65,0,0,0
Turks and Caicos Islands,2011,sn,014,0,0,0
Turks and Caicos Islands,2011,sn,1524,0,0,0
Turks and Caicos Islands,2011,sn,2534,0,0,0
Turks and Caicos Islands,2011,sn,3544,0,0,0
Turks and Caicos Islands,2011,sn,4554,0,0,0
Turks and Caicos Islands,2011,sn,5564,0,0,0
Turks and Caicos Islands,2011,sn,65,0,0,0
Turks and Caicos Islands,2011,sp,014,0,0,0
Turks and Caicos Islands,2011,sp,1524,0,2,2
Turks and Caicos Islands,2011,sp,2534,0,3,3
Turks and Caicos Islands,2011,sp,3544,0,2,2
Turks and Caicos Islands,2011,sp,4554,0,0,0
Turks and Caicos Islands,2011,sp,5564,0,1,1
Turks and Caicos Islands,2011,sp,65,0,0,0
Turks and Caicos Islands,2012,ep,014,0,0,0
Turks and Caicos Islands,2012,ep,1524,0,0,0
Turks and Caicos Islands,2012,ep,2534,0,0,0
Turks and Caicos Islands,2012,ep,3544,1,0,1
Turks and Caicos Islands,2012,ep,4554,0,0,0
Turks and Caicos Islands,2012,ep,5564,0,0,0
Turks and Caicos Islands,2012,ep,65,0,0,0
Turks and Caicos Islands,2012,sn,014,0,0,0
Turks and Caicos Islands,2012,sn,1524,0,0,0
Turks and Caicos Islands,2012,sn,2534,0,0,0
Turks and Caicos Islands,2012,sn,3544,1,0,1
Turks and Caicos Islands,2012,sn,4554,0,0,0
Turks and Caicos Islands,2012,sn,5564,0,1,1
Turks and Caicos Islands,2012,sn,65,0,0,0
Turks and Caicos Islands,2012,sp,014,0,0,0
Turks and Caicos Islands,2012,sp,1524,0,0,0
Turks and Caicos Islands,2012,sp,2534,2,NA,NA
Turks and Caicos Islands,2012,sp,3544,0,2,2
Turks and Caicos Islands,2012,sp,4554,1,0,1
Turks and Caicos Islands,2012,sp,5564,0,0,0
Turks and Caicos Islands,2012,sp,65,0,0,0
Turks and Caicos Islands,2013,rel,1524,1,NA,NA
Turks and Caicos Islands,2013,rel,3544,1,NA,NA
Tuvalu,1995,sp,014,0,1,1
Tuvalu,1995,sp,1524,1,0,1
Tuvalu,1995,sp,2534,1,1,2
Tuvalu,1995,sp,3544,0,0,0
Tuvalu,1995,sp,4554,0,0,0
Tuvalu,1995,sp,5564,1,1,2
Tuvalu,1995,sp,65,0,0,0
Tuvalu,1998,sp,014,6,1,7
Tuvalu,1998,sp,2534,1,3,4
Tuvalu,1998,sp,3544,1,2,3
Tuvalu,1998,sp,4554,1,NA,NA
Tuvalu,1998,sp,5564,NA,1,NA
Tuvalu,1998,sp,65,1,1,2
Tuvalu,2003,sp,014,0,4,4
Tuvalu,2003,sp,1524,3,2,5
Tuvalu,2003,sp,2534,0,0,0
Tuvalu,2003,sp,3544,1,1,2
Tuvalu,2003,sp,4554,0,6,6
Tuvalu,2003,sp,5564,0,0,0
Tuvalu,2003,sp,65,0,0,0
Tuvalu,2005,sp,1524,1,NA,NA
Tuvalu,2005,sp,4554,NA,1,NA
Tuvalu,2005,sp,5564,2,1,3
Tuvalu,2006,ep,014,0,1,1
Tuvalu,2006,ep,1524,0,0,0
Tuvalu,2006,ep,2534,0,1,1
Tuvalu,2006,ep,3544,0,0,0
Tuvalu,2006,ep,4554,0,0,0
Tuvalu,2006,ep,5564,0,0,0
Tuvalu,2006,ep,65,0,0,0
Tuvalu,2006,sn,014,0,0,0
Tuvalu,2006,sn,1524,0,0,0
Tuvalu,2006,sn,2534,0,0,0
Tuvalu,2006,sn,3544,0,0,0
Tuvalu,2006,sn,4554,0,1,1
Tuvalu,2006,sn,5564,0,0,0
Tuvalu,2006,sn,65,2,0,2
Tuvalu,2006,sp,014,0,0,0
Tuvalu,2006,sp,1524,1,1,2
Tuvalu,2006,sp,2534,0,0,0
Tuvalu,2006,sp,3544,1,0,1
Tuvalu,2006,sp,4554,1,0,1
Tuvalu,2006,sp,5564,0,0,0
Tuvalu,2006,sp,65,0,0,0
Tuvalu,2007,ep,014,NA,2,NA
Tuvalu,2007,sn,1524,1,NA,NA
Tuvalu,2007,sp,014,2,1,3
Tuvalu,2007,sp,1524,0,1,1
Tuvalu,2007,sp,2534,0,0,0
Tuvalu,2007,sp,3544,0,2,2
Tuvalu,2007,sp,4554,1,0,1
Tuvalu,2007,sp,5564,3,0,3
Tuvalu,2007,sp,65,0,2,2
Tuvalu,2008,ep,014,1,0,1
Tuvalu,2008,ep,1524,0,1,1
Tuvalu,2008,ep,2534,0,1,1
Tuvalu,2008,ep,3544,0,0,0
Tuvalu,2008,ep,4554,0,0,0
Tuvalu,2008,ep,5564,0,0,0
Tuvalu,2008,ep,65,0,0,0
Tuvalu,2008,sn,014,1,0,1
Tuvalu,2008,sn,1524,0,0,0
Tuvalu,2008,sn,2534,0,1,1
Tuvalu,2008,sn,3544,1,1,2
Tuvalu,2008,sn,4554,0,1,1
Tuvalu,2008,sn,5564,0,0,0
Tuvalu,2008,sn,65,0,0,0
Tuvalu,2008,sp,014,0,2,2
Tuvalu,2008,sp,1524,1,2,3
Tuvalu,2008,sp,2534,2,1,3
Tuvalu,2008,sp,3544,2,0,2
Tuvalu,2008,sp,4554,1,1,2
Tuvalu,2008,sp,5564,0,0,0
Tuvalu,2008,sp,65,0,0,0
Tuvalu,2009,ep,014,1,3,4
Tuvalu,2009,ep,1524,1,2,3
Tuvalu,2009,ep,3544,1,1,2
Tuvalu,2009,sp,014,1,NA,NA
Tuvalu,2009,sp,1524,NA,1,NA
Tuvalu,2009,sp,3544,1,1,2
Tuvalu,2009,sp,4554,2,NA,NA
Tuvalu,2009,sp,5564,1,NA,NA
Tuvalu,2009,sp,65,1,NA,NA
Tuvalu,2010,ep,014,0,5,5
Tuvalu,2010,ep,1524,0,0,0
Tuvalu,2010,ep,2534,0,0,0
Tuvalu,2010,ep,3544,0,0,0
Tuvalu,2010,ep,4554,0,0,0
Tuvalu,2010,ep,5564,0,0,0
Tuvalu,2010,ep,65,1,1,2
Tuvalu,2010,sn,014,0,0,0
Tuvalu,2010,sn,1524,2,0,2
Tuvalu,2010,sn,2534,0,0,0
Tuvalu,2010,sn,3544,0,0,0
Tuvalu,2010,sn,4554,0,0,0
Tuvalu,2010,sn,5564,0,0,0
Tuvalu,2010,sn,65,0,0,0
Tuvalu,2010,sp,014,0,0,0
Tuvalu,2010,sp,1524,0,1,1
Tuvalu,2010,sp,2534,1,0,1
Tuvalu,2010,sp,3544,0,0,0
Tuvalu,2010,sp,4554,0,1,1
Tuvalu,2010,sp,5564,0,2,2
Tuvalu,2010,sp,65,0,0,0
Tuvalu,2011,ep,014,1,1,2
Tuvalu,2011,ep,1524,NA,1,NA
Tuvalu,2011,ep,2534,NA,1,NA
Tuvalu,2011,sn,014,1,NA,NA
Tuvalu,2011,sn,3544,NA,2,NA
Tuvalu,2011,sn,4554,NA,1,NA
Tuvalu,2011,sp,014,NA,1,NA
Tuvalu,2011,sp,1524,NA,1,NA
Tuvalu,2011,sp,4554,1,NA,NA
Tuvalu,2011,sp,5564,NA,1,NA
Tuvalu,2012,ep,014,NA,2,NA
Tuvalu,2012,ep,1524,NA,1,NA
Tuvalu,2012,ep,2534,1,1,2
Tuvalu,2012,ep,3544,NA,1,NA
Tuvalu,2012,ep,4554,NA,1,NA
Tuvalu,2012,ep,5564,1,NA,NA
Tuvalu,2012,ep,65,NA,1,NA
Tuvalu,2012,sn,4554,NA,1,NA
Tuvalu,2012,sn,65,NA,1,NA
Tuvalu,2012,sp,014,2,NA,NA
Tuvalu,2012,sp,1524,1,1,2
Tuvalu,2012,sp,3544,NA,1,NA
Tuvalu,2012,sp,4554,2,1,3
Tuvalu,2013,rel,014,1,0,1
Tuvalu,2013,rel,1524,2,4,6
Tuvalu,2013,rel,2534,1,1,2
Tuvalu,2013,rel,3544,0,0,0
Tuvalu,2013,rel,4554,3,2,5
Tuvalu,2013,rel,5564,0,2,2
Tuvalu,2013,rel,65,0,2,2
Uganda,1995,sp,014,402,370,772
Uganda,1995,sp,1524,1376,1193,2569
Uganda,1995,sp,2534,1845,2491,4336
Uganda,1995,sp,3544,1104,1797,2901
Uganda,1995,sp,4554,635,1115,1750
Uganda,1995,sp,5564,312,602,914
Uganda,1995,sp,65,113,323,436
Uganda,1996,sp,014,455,372,827
Uganda,1996,sp,1524,1482,1271,2753
Uganda,1996,sp,2534,2099,2706,4805
Uganda,1996,sp,3544,1246,2026,3272
Uganda,1996,sp,4554,728,1252,1980
Uganda,1996,sp,5564,379,646,1025
Uganda,1996,sp,65,160,353,513
Uganda,1997,sp,014,375,340,715
Uganda,1997,sp,1524,1700,1485,3185
Uganda,1997,sp,2534,2489,3278,5767
Uganda,1997,sp,3544,1368,2919,4287
Uganda,1997,sp,4554,812,1439,2251
Uganda,1997,sp,5564,379,733,1112
Uganda,1997,sp,65,131,353,484
Uganda,1998,sp,014,467,334,801
Uganda,1998,sp,1524,1682,1512,3194
Uganda,1998,sp,2534,2760,3672,6432
Uganda,1998,sp,3544,1441,2491,3932
Uganda,1998,sp,4554,744,1429,2173
Uganda,1998,sp,5564,395,676,1071
Uganda,1998,sp,65,191,428,619
Uganda,1999,sp,014,434,310,744
Uganda,1999,sp,1524,1654,1510,3164
Uganda,1999,sp,2534,2591,3475,6066
Uganda,1999,sp,3544,1415,2526,3941
Uganda,1999,sp,4554,680,1354,2034
Uganda,1999,sp,5564,331,613,944
Uganda,1999,sp,65,162,413,575
Uganda,2000,sp,014,400,283,683
Uganda,2000,sp,1524,1649,1511,3160
Uganda,2000,sp,2534,2782,3497,6279
Uganda,2000,sp,3544,1510,2479,3989
Uganda,2000,sp,4554,671,1279,1950
Uganda,2000,sp,5564,316,607,923
Uganda,2000,sp,65,163,395,558
Uganda,2001,sp,014,334,231,565
Uganda,2001,sp,1524,1603,1461,3064
Uganda,2001,sp,2534,2656,3483,6139
Uganda,2001,sp,3544,1528,2540,4068
Uganda,2001,sp,4554,703,1242,1945
Uganda,2001,sp,5564,292,638,930
Uganda,2001,sp,65,180,392,572
Uganda,2002,sp,014,371,259,630
Uganda,2002,sp,1524,1689,1503,3192
Uganda,2002,sp,2534,3011,3783,6794
Uganda,2002,sp,3544,1708,2865,4573
Uganda,2002,sp,4554,765,1399,2164
Uganda,2002,sp,5564,374,723,1097
Uganda,2002,sp,65,184,465,649
Uganda,2003,sp,014,377,261,638
Uganda,2003,sp,1524,1770,1643,3413
Uganda,2003,sp,2534,3176,4142,7318
Uganda,2003,sp,3544,1815,3011,4826
Uganda,2003,sp,4554,749,1578,2327
Uganda,2003,sp,5564,356,719,1075
Uganda,2003,sp,65,214,501,715
Uganda,2004,sp,014,371,284,655
Uganda,2004,sp,1524,1803,1803,3606
Uganda,2004,sp,2534,3110,4222,7332
Uganda,2004,sp,3544,1780,3269,5049
Uganda,2004,sp,4554,812,1599,2411
Uganda,2004,sp,5564,358,810,1168
Uganda,2004,sp,65,193,525,718
Uganda,2005,sp,014,371,257,628
Uganda,2005,sp,1524,1811,1598,3409
Uganda,2005,sp,2534,3099,4075,7174
Uganda,2005,sp,3544,1800,3209,5009
Uganda,2005,sp,4554,818,1576,2394
Uganda,2005,sp,5564,389,725,1114
Uganda,2005,sp,65,257,539,796
Uganda,2006,sp,014,363,255,618
Uganda,2006,sp,1524,1792,1624,3416
Uganda,2006,sp,2534,2909,4084,6993
Uganda,2006,sp,3544,1736,3391,5127
Uganda,2006,sp,4554,812,1591,2403
Uganda,2006,sp,5564,332,718,1050
Uganda,2006,sp,65,238,511,749
Uganda,2007,sp,014,343,234,577
Uganda,2007,sp,1524,1874,1741,3615
Uganda,2007,sp,2534,3008,4406,7414
Uganda,2007,sp,3544,1742,3551,5293
Uganda,2007,sp,4554,824,1681,2505
Uganda,2007,sp,5564,382,766,1148
Uganda,2007,sp,65,246,505,751
Uganda,2008,ep,014,0,0,0
Uganda,2008,ep,1524,0,0,0
Uganda,2008,ep,2534,0,0,0
Uganda,2008,ep,3544,0,0,0
Uganda,2008,ep,4554,0,0,0
Uganda,2008,ep,5564,0,0,0
Uganda,2008,ep,65,0,0,0
Uganda,2008,sn,014,0,0,0
Uganda,2008,sn,1524,0,0,0
Uganda,2008,sn,2534,0,0,0
Uganda,2008,sn,3544,0,0,0
Uganda,2008,sn,4554,0,0,0
Uganda,2008,sn,5564,0,0,0
Uganda,2008,sn,65,0,0,0
Uganda,2008,sp,014,382,269,651
Uganda,2008,sp,1524,2006,1953,3959
Uganda,2008,sp,2534,2985,4697,7682
Uganda,2008,sp,3544,1749,3922,5671
Uganda,2008,sp,4554,862,1981,2843
Uganda,2008,sp,5564,314,875,1189
Uganda,2008,sp,65,206,565,771
Uganda,2009,sp,014,372,250,622
Uganda,2009,sp,1524,2151,1853,4004
Uganda,2009,sp,2534,2919,4816,7735
Uganda,2009,sp,3544,1673,4115,5788
Uganda,2009,sp,4554,811,2089,2900
Uganda,2009,sp,5564,369,901,1270
Uganda,2009,sp,65,216,578,794
Uganda,2010,sp,014,401,268,669
Uganda,2010,sp,1524,1964,2055,4019
Uganda,2010,sp,2534,2923,4735,7658
Uganda,2010,sp,3544,1691,4133,5824
Uganda,2010,sp,4554,924,2214,3138
Uganda,2010,sp,5564,365,905,1270
Uganda,2010,sp,65,248,613,861
Uganda,2011,sp,014,400,295,695
Uganda,2011,sp,1524,2092,2075,4167
Uganda,2011,sp,2534,2853,5044,7897
Uganda,2011,sp,3544,1809,4613,6422
Uganda,2011,sp,4554,973,2466,3439
Uganda,2011,sp,5564,409,994,1403
Uganda,2011,sp,65,313,604,917
Uganda,2012,sp,014,364,272,636
Uganda,2012,sp,1524,2194,2174,4368
Uganda,2012,sp,2534,2912,5029,7941
Uganda,2012,sp,3544,1733,4493,6226
Uganda,2012,sp,4554,864,2479,3343
Uganda,2012,sp,5564,419,1015,1434
Uganda,2012,sp,65,281,633,914
Uganda,2013,rel,014,386,263,649
Uganda,2013,rel,1524,2160,2135,4295
Uganda,2013,rel,2534,2830,5323,8153
Uganda,2013,rel,3544,1756,4624,6380
Uganda,2013,rel,4554,910,2490,3400
Uganda,2013,rel,5564,450,1026,1476
Uganda,2013,rel,65,341,714,1055
Ukraine,1995,sp,014,21,10,31
Ukraine,1995,sp,1524,314,385,699
Ukraine,1995,sp,2534,380,1076,1456
Ukraine,1995,sp,3544,327,2064,2391
Ukraine,1995,sp,4554,182,1515,1697
Ukraine,1995,sp,5564,185,1087,1272
Ukraine,1995,sp,65,280,437,717
Ukraine,1996,sp,014,13,9,22
Ukraine,1996,sp,1524,379,569,948
Ukraine,1996,sp,2534,410,1199,1609
Ukraine,1996,sp,3544,397,2318,2715
Ukraine,1996,sp,4554,196,1704,1900
Ukraine,1996,sp,5564,192,1264,1456
Ukraine,1996,sp,65,370,544,914
Ukraine,1997,sp,014,22,12,34
Ukraine,1997,sp,1524,383,623,1006
Ukraine,1997,sp,2534,474,1310,1784
Ukraine,1997,sp,3544,359,2107,2466
Ukraine,1997,sp,4554,256,1718,1974
Ukraine,1997,sp,5564,126,1141,1267
Ukraine,1997,sp,65,377,555,932
Ukraine,1998,sp,014,36,24,60
Ukraine,1998,sp,1524,468,687,1155
Ukraine,1998,sp,2534,556,1500,2056
Ukraine,1998,sp,3544,431,2460,2891
Ukraine,1998,sp,4554,248,1873,2121
Ukraine,1998,sp,5564,194,1140,1334
Ukraine,1998,sp,65,393,576,969
Ukraine,1999,sp,014,25,11,36
Ukraine,1999,sp,1524,485,661,1146
Ukraine,1999,sp,2534,577,1463,2040
Ukraine,1999,sp,3544,478,2351,2829
Ukraine,1999,sp,4554,297,1825,2122
Ukraine,1999,sp,5564,222,1067,1289
Ukraine,1999,sp,65,393,557,950
Ukraine,2000,sp,014,41,21,62
Ukraine,2000,sp,1524,487,693,1180
Ukraine,2000,sp,2534,590,1552,2142
Ukraine,2000,sp,3544,447,2385,2832
Ukraine,2000,sp,4554,298,2007,2305
Ukraine,2000,sp,5564,218,1062,1280
Ukraine,2000,sp,65,405,532,937
Ukraine,2001,sp,014,18,9,27
Ukraine,2001,sp,1524,544,757,1301
Ukraine,2001,sp,2534,649,1721,2370
Ukraine,2001,sp,3544,525,2720,3245
Ukraine,2001,sp,4554,354,2393,2747
Ukraine,2001,sp,5564,235,1050,1285
Ukraine,2001,sp,65,418,559,977
Ukraine,2003,sp,014,29,10,39
Ukraine,2003,sp,1524,514,850,1364
Ukraine,2003,sp,2534,745,2033,2778
Ukraine,2003,sp,3544,557,2808,3365
Ukraine,2003,sp,4554,363,2634,2997
Ukraine,2003,sp,5564,221,983,1204
Ukraine,2003,sp,65,421,617,1038
Ukraine,2006,ep,014,183,256,439
Ukraine,2006,ep,1524,295,398,693
Ukraine,2006,ep,2534,359,553,912
Ukraine,2006,ep,3544,280,474,754
Ukraine,2006,ep,4554,283,379,662
Ukraine,2006,ep,5564,173,216,389
Ukraine,2006,ep,65,254,191,445
Ukraine,2006,sp,014,16,8,24
Ukraine,2006,sp,1524,600,926,1526
Ukraine,2006,sp,2534,909,2522,3431
Ukraine,2006,sp,3544,704,2979,3683
Ukraine,2006,sp,4554,446,2714,3160
Ukraine,2006,sp,5564,246,1087,1333
Ukraine,2006,sp,65,481,568,1049
Ukraine,2007,sp,014,7,14,21
Ukraine,2007,sp,1524,982,1556,2538
Ukraine,2007,sp,2534,1661,4507,6168
Ukraine,2007,sp,3544,1314,5206,6520
Ukraine,2007,sp,4554,855,5024,5879
Ukraine,2007,sp,5564,438,2130,2568
Ukraine,2007,sp,65,861,1090,1951
Ukraine,2008,ep,014,151,221,372
Ukraine,2008,ep,1524,199,311,510
Ukraine,2008,ep,2534,315,530,845
Ukraine,2008,ep,3544,255,427,682
Ukraine,2008,ep,4554,192,342,534
Ukraine,2008,ep,5564,156,195,351
Ukraine,2008,ep,65,212,154,366
Ukraine,2008,sn,014,104,72,176
Ukraine,2008,sn,1524,1072,1373,2445
Ukraine,2008,sn,2534,1515,2961,4476
Ukraine,2008,sn,3544,1029,2720,3749
Ukraine,2008,sn,4554,746,2722,3468
Ukraine,2008,sn,5564,391,1353,1744
Ukraine,2008,sn,65,535,912,1447
Ukraine,2008,sp,014,24,9,33
Ukraine,2008,sp,1524,585,901,1486
Ukraine,2008,sp,2534,979,2696,3675
Ukraine,2008,sp,3544,762,2859,3621
Ukraine,2008,sp,4554,544,2769,3313
Ukraine,2008,sp,5564,255,1140,1395
Ukraine,2008,sp,65,477,574,1051
Ukraine,2009,ep,014,171,176,347
Ukraine,2009,ep,1524,218,253,471
Ukraine,2009,ep,2534,327,626,953
Ukraine,2009,ep,3544,287,499,786
Ukraine,2009,ep,4554,233,353,586
Ukraine,2009,ep,5564,163,208,371
Ukraine,2009,ep,65,203,141,344
Ukraine,2009,sn,014,112,91,203
Ukraine,2009,sn,1524,991,1340,2331
Ukraine,2009,sn,2534,1433,2761,4194
Ukraine,2009,sn,3544,955,2442,3397
Ukraine,2009,sn,4554,701,2170,2871
Ukraine,2009,sn,5564,377,1251,1628
Ukraine,2009,sn,65,508,802,1310
Ukraine,2009,sp,014,15,15,30
Ukraine,2009,sp,1524,531,953,1484
Ukraine,2009,sp,2534,986,2506,3492
Ukraine,2009,sp,3544,717,2656,3373
Ukraine,2009,sp,4554,470,2384,2854
Ukraine,2009,sp,5564,254,1073,1327
Ukraine,2009,sp,65,502,570,1072
Ukraine,2010,ep,014,127,175,302
Ukraine,2010,ep,1524,183,233,416
Ukraine,2010,ep,2534,327,509,836
Ukraine,2010,ep,3544,246,439,685
Ukraine,2010,ep,4554,186,289,475
Ukraine,2010,ep,5564,161,178,339
Ukraine,2010,ep,65,164,138,302
Ukraine,2011,sp,014,11,8,19
Ukraine,2011,sp,1524,348,539,887
Ukraine,2011,sp,2534,741,1991,2732
Ukraine,2011,sp,3544,603,2209,2812
Ukraine,2011,sp,4554,388,1796,2184
Ukraine,2011,sp,5564,230,881,1111
Ukraine,2011,sp,65,380,377,757
Ukraine,2012,sn,014,105,99,204
Ukraine,2012,sn,1524,891,1020,1911
Ukraine,2012,sn,2534,1617,2949,4566
Ukraine,2012,sn,3544,1162,2713,3875
Ukraine,2012,sn,4554,722,2190,2912
Ukraine,2012,sn,5564,440,1310,1750
Ukraine,2012,sn,65,492,749,1241
Ukraine,2012,sp,014,10,9,19
Ukraine,2012,sp,1524,334,546,880
Ukraine,2012,sp,2534,771,2028,2799
Ukraine,2012,sp,3544,609,2393,3002
Ukraine,2012,sp,4554,401,1926,2327
Ukraine,2012,sp,5564,218,965,1183
Ukraine,2012,sp,65,431,389,820
Ukraine,2013,rel,014,314,324,638
Ukraine,2013,rel,1524,1274,1500,2774
Ukraine,2013,rel,2534,2906,5578,8484
Ukraine,2013,rel,3544,2309,6555,8864
Ukraine,2013,rel,4554,1506,5255,6761
Ukraine,2013,rel,5564,953,2994,3947
Ukraine,2013,rel,65,1241,1435,2676
United Arab Emirates,1999,sp,014,9,4,13
United Arab Emirates,1999,sp,1524,11,9,20
United Arab Emirates,1999,sp,2534,5,3,8
United Arab Emirates,1999,sp,3544,3,2,5
United Arab Emirates,1999,sp,4554,0,4,4
United Arab Emirates,1999,sp,5564,3,6,9
United Arab Emirates,1999,sp,65,2,5,7
United Arab Emirates,2000,sp,014,3,2,5
United Arab Emirates,2000,sp,1524,16,4,20
United Arab Emirates,2000,sp,2534,1,4,5
United Arab Emirates,2000,sp,3544,3,6,9
United Arab Emirates,2000,sp,4554,0,5,5
United Arab Emirates,2000,sp,5564,0,12,12
United Arab Emirates,2000,sp,65,4,10,14
United Arab Emirates,2002,sp,014,3,1,4
United Arab Emirates,2002,sp,1524,3,2,5
United Arab Emirates,2002,sp,2534,8,0,8
United Arab Emirates,2002,sp,3544,3,6,9
United Arab Emirates,2002,sp,4554,4,6,10
United Arab Emirates,2002,sp,5564,10,10,20
United Arab Emirates,2002,sp,65,1,0,1
United Arab Emirates,2003,sp,014,4,2,6
United Arab Emirates,2003,sp,1524,9,10,19
United Arab Emirates,2003,sp,2534,5,8,13
United Arab Emirates,2003,sp,3544,3,12,15
United Arab Emirates,2003,sp,4554,3,3,6
United Arab Emirates,2003,sp,5564,2,2,4
United Arab Emirates,2003,sp,65,4,10,14
United Arab Emirates,2004,sp,014,3,1,4
United Arab Emirates,2004,sp,1524,6,7,13
United Arab Emirates,2004,sp,2534,2,6,8
United Arab Emirates,2004,sp,3544,7,7,14
United Arab Emirates,2004,sp,4554,2,3,5
United Arab Emirates,2004,sp,5564,2,1,3
United Arab Emirates,2004,sp,65,3,7,10
United Arab Emirates,2006,ep,014,3,0,3
United Arab Emirates,2006,ep,1524,0,0,0
United Arab Emirates,2006,ep,2534,3,4,7
United Arab Emirates,2006,ep,3544,0,0,0
United Arab Emirates,2006,ep,4554,1,0,1
United Arab Emirates,2006,ep,5564,1,2,3
United Arab Emirates,2006,ep,65,1,1,2
United Arab Emirates,2006,sn,014,5,2,7
United Arab Emirates,2006,sn,1524,1,1,2
United Arab Emirates,2006,sn,2534,1,0,1
United Arab Emirates,2006,sn,3544,2,3,5
United Arab Emirates,2006,sn,4554,0,1,1
United Arab Emirates,2006,sn,5564,1,1,2
United Arab Emirates,2006,sn,65,0,0,0
United Arab Emirates,2006,sp,014,2,0,2
United Arab Emirates,2006,sp,1524,6,5,11
United Arab Emirates,2006,sp,2534,4,3,7
United Arab Emirates,2006,sp,3544,5,7,12
United Arab Emirates,2006,sp,4554,3,3,6
United Arab Emirates,2006,sp,5564,4,1,5
United Arab Emirates,2006,sp,65,5,4,9
United Arab Emirates,2007,ep,014,4,1,5
United Arab Emirates,2007,ep,1524,2,1,3
United Arab Emirates,2007,ep,2534,1,1,2
United Arab Emirates,2007,ep,3544,2,0,2
United Arab Emirates,2007,ep,4554,1,1,2
United Arab Emirates,2007,ep,5564,0,0,0
United Arab Emirates,2007,ep,65,1,1,2
United Arab Emirates,2007,sn,014,2,1,3
United Arab Emirates,2007,sn,1524,1,2,3
United Arab Emirates,2007,sn,2534,2,0,2
United Arab Emirates,2007,sn,3544,1,0,1
United Arab Emirates,2007,sn,4554,1,0,1
United Arab Emirates,2007,sn,5564,1,3,4
United Arab Emirates,2007,sn,65,1,5,6
United Arab Emirates,2007,sp,014,1,2,3
United Arab Emirates,2007,sp,1524,8,5,13
United Arab Emirates,2007,sp,2534,6,6,12
United Arab Emirates,2007,sp,3544,3,3,6
United Arab Emirates,2007,sp,4554,2,4,6
United Arab Emirates,2007,sp,5564,0,3,3
United Arab Emirates,2007,sp,65,0,10,10
United Arab Emirates,2008,ep,014,1,4,5
United Arab Emirates,2008,ep,1524,1,4,5
United Arab Emirates,2008,ep,2534,4,0,4
United Arab Emirates,2008,ep,3544,0,1,1
United Arab Emirates,2008,ep,4554,3,0,3
United Arab Emirates,2008,ep,5564,1,3,4
United Arab Emirates,2008,ep,65,3,0,3
United Arab Emirates,2008,sn,014,3,1,4
United Arab Emirates,2008,sn,1524,1,2,3
United Arab Emirates,2008,sn,2534,2,2,4
United Arab Emirates,2008,sn,3544,0,0,0
United Arab Emirates,2008,sn,4554,1,0,1
United Arab Emirates,2008,sn,5564,1,0,1
United Arab Emirates,2008,sn,65,3,1,4
United Arab Emirates,2008,sp,014,0,0,0
United Arab Emirates,2008,sp,1524,10,6,16
United Arab Emirates,2008,sp,2534,4,1,5
United Arab Emirates,2008,sp,3544,1,7,8
United Arab Emirates,2008,sp,4554,1,5,6
United Arab Emirates,2008,sp,5564,3,3,6
United Arab Emirates,2008,sp,65,3,6,9
United Arab Emirates,2009,ep,014,2,5,7
United Arab Emirates,2009,ep,1524,3,2,5
United Arab Emirates,2009,ep,2534,4,3,7
United Arab Emirates,2009,ep,3544,0,2,2
United Arab Emirates,2009,ep,4554,2,3,5
United Arab Emirates,2009,ep,5564,0,0,0
United Arab Emirates,2009,ep,65,3,1,4
United Arab Emirates,2009,sn,014,4,3,7
United Arab Emirates,2009,sn,1524,0,0,0
United Arab Emirates,2009,sn,2534,2,0,2
United Arab Emirates,2009,sn,3544,0,2,2
United Arab Emirates,2009,sn,4554,0,1,1
United Arab Emirates,2009,sn,5564,0,1,1
United Arab Emirates,2009,sn,65,1,1,2
United Arab Emirates,2009,sp,014,0,2,2
United Arab Emirates,2009,sp,1524,8,8,16
United Arab Emirates,2009,sp,2534,5,9,14
United Arab Emirates,2009,sp,3544,2,8,10
United Arab Emirates,2009,sp,4554,7,6,13
United Arab Emirates,2009,sp,5564,0,4,4
United Arab Emirates,2009,sp,65,6,4,10
United Arab Emirates,2010,ep,014,6,3,9
United Arab Emirates,2010,ep,1524,6,3,9
United Arab Emirates,2010,ep,2534,8,4,12
United Arab Emirates,2010,ep,3544,4,4,8
United Arab Emirates,2010,ep,4554,0,0,0
United Arab Emirates,2010,ep,5564,0,4,4
United Arab Emirates,2010,ep,65,3,2,5
United Arab Emirates,2010,sn,014,4,3,7
United Arab Emirates,2010,sn,1524,4,1,5
United Arab Emirates,2010,sn,2534,0,5,5
United Arab Emirates,2010,sn,3544,0,0,0
United Arab Emirates,2010,sn,4554,0,2,2
United Arab Emirates,2010,sn,5564,0,3,3
United Arab Emirates,2010,sn,65,3,3,6
United Arab Emirates,2010,sp,014,1,1,2
United Arab Emirates,2010,sp,1524,2,7,9
United Arab Emirates,2010,sp,2534,4,13,17
United Arab Emirates,2010,sp,3544,1,7,8
United Arab Emirates,2010,sp,4554,5,3,8
United Arab Emirates,2010,sp,5564,1,4,5
United Arab Emirates,2010,sp,65,3,4,7
United Arab Emirates,2011,ep,014,0,2,2
United Arab Emirates,2011,ep,1524,5,4,9
United Arab Emirates,2011,ep,2534,0,3,3
United Arab Emirates,2011,ep,3544,2,2,4
United Arab Emirates,2011,ep,4554,2,1,3
United Arab Emirates,2011,ep,5564,1,2,3
United Arab Emirates,2011,ep,65,2,4,6
United Arab Emirates,2011,sn,014,1,2,3
United Arab Emirates,2011,sn,1524,1,5,6
United Arab Emirates,2011,sn,2534,2,5,7
United Arab Emirates,2011,sn,3544,0,3,3
United Arab Emirates,2011,sn,4554,0,3,3
United Arab Emirates,2011,sn,5564,0,1,1
United Arab Emirates,2011,sn,65,2,2,4
United Arab Emirates,2011,sp,014,4,0,4
United Arab Emirates,2011,sp,1524,6,3,9
United Arab Emirates,2011,sp,2534,6,7,13
United Arab Emirates,2011,sp,3544,3,3,6
United Arab Emirates,2011,sp,4554,2,5,7
United Arab Emirates,2011,sp,5564,1,1,2
United Arab Emirates,2011,sp,65,2,3,5
United Arab Emirates,2012,ep,014,0,2,2
United Arab Emirates,2012,ep,1524,4,1,5
United Arab Emirates,2012,ep,2534,2,3,5
United Arab Emirates,2012,ep,3544,1,3,4
United Arab Emirates,2012,ep,4554,1,0,1
United Arab Emirates,2012,ep,5564,0,0,0
United Arab Emirates,2012,ep,65,1,2,3
United Arab Emirates,2012,sn,014,1,0,1
United Arab Emirates,2012,sn,1524,4,0,4
United Arab Emirates,2012,sn,2534,0,3,3
United Arab Emirates,2012,sn,3544,0,1,1
United Arab Emirates,2012,sn,4554,1,1,2
United Arab Emirates,2012,sn,5564,0,1,1
United Arab Emirates,2012,sn,65,1,2,3
United Arab Emirates,2012,sp,014,0,0,0
United Arab Emirates,2012,sp,1524,5,2,7
United Arab Emirates,2012,sp,2534,2,4,6
United Arab Emirates,2012,sp,3544,2,4,6
United Arab Emirates,2012,sp,4554,3,5,8
United Arab Emirates,2012,sp,5564,4,5,9
United Arab Emirates,2012,sp,65,4,2,6
United Arab Emirates,2013,rel,014,5,4,9
United Arab Emirates,2013,rel,1524,4,8,12
United Arab Emirates,2013,rel,2534,9,9,18
United Arab Emirates,2013,rel,3544,3,9,12
United Arab Emirates,2013,rel,4554,3,6,9
United Arab Emirates,2013,rel,5564,1,5,6
United Arab Emirates,2013,rel,65,6,10,16
United Kingdom of Great Britain and Northern Ireland,1997,sp,014,8,2,10
United Kingdom of Great Britain and Northern Ireland,1997,sp,1524,67,68,135
United Kingdom of Great Britain and Northern Ireland,1997,sp,2534,64,87,151
United Kingdom of Great Britain and Northern Ireland,1997,sp,3544,43,90,133
United Kingdom of Great Britain and Northern Ireland,1997,sp,4554,34,84,118
United Kingdom of Great Britain and Northern Ireland,1997,sp,5564,24,60,84
United Kingdom of Great Britain and Northern Ireland,1997,sp,65,51,107,158
United Kingdom of Great Britain and Northern Ireland,1998,sp,014,9,11,20
United Kingdom of Great Britain and Northern Ireland,1998,sp,1524,105,103,208
United Kingdom of Great Britain and Northern Ireland,1998,sp,2534,103,164,267
United Kingdom of Great Britain and Northern Ireland,1998,sp,3544,71,141,212
United Kingdom of Great Britain and Northern Ireland,1998,sp,4554,44,108,152
United Kingdom of Great Britain and Northern Ireland,1998,sp,5564,39,105,144
United Kingdom of Great Britain and Northern Ireland,1998,sp,65,114,225,339
United Kingdom of Great Britain and Northern Ireland,1999,sp,014,6,8,14
United Kingdom of Great Britain and Northern Ireland,1999,sp,1524,55,68,123
United Kingdom of Great Britain and Northern Ireland,1999,sp,2534,80,93,173
United Kingdom of Great Britain and Northern Ireland,1999,sp,3544,60,68,128
United Kingdom of Great Britain and Northern Ireland,1999,sp,4554,29,53,82
United Kingdom of Great Britain and Northern Ireland,1999,sp,5564,30,51,81
United Kingdom of Great Britain and Northern Ireland,1999,sp,65,69,126,195
United Kingdom of Great Britain and Northern Ireland,2000,sp,014,9,8,17
United Kingdom of Great Britain and Northern Ireland,2000,sp,1524,95,86,181
United Kingdom of Great Britain and Northern Ireland,2000,sp,2534,114,130,244
United Kingdom of Great Britain and Northern Ireland,2000,sp,3544,60,96,156
United Kingdom of Great Britain and Northern Ireland,2000,sp,4554,31,87,118
United Kingdom of Great Britain and Northern Ireland,2000,sp,5564,31,75,106
United Kingdom of Great Britain and Northern Ireland,2000,sp,65,67,138,205
United Kingdom of Great Britain and Northern Ireland,2001,sp,014,15,10,25
United Kingdom of Great Britain and Northern Ireland,2001,sp,1524,74,99,173
United Kingdom of Great Britain and Northern Ireland,2001,sp,2534,104,135,239
United Kingdom of Great Britain and Northern Ireland,2001,sp,3544,57,105,162
United Kingdom of Great Britain and Northern Ireland,2001,sp,4554,54,96,150
United Kingdom of Great Britain and Northern Ireland,2001,sp,5564,38,81,119
United Kingdom of Great Britain and Northern Ireland,2001,sp,65,105,117,222
United Kingdom of Great Britain and Northern Ireland,2002,sp,014,6,6,12
United Kingdom of Great Britain and Northern Ireland,2002,sp,1524,82,94,176
United Kingdom of Great Britain and Northern Ireland,2002,sp,2534,131,142,273
United Kingdom of Great Britain and Northern Ireland,2002,sp,3544,66,132,198
United Kingdom of Great Britain and Northern Ireland,2002,sp,4554,44,98,142
United Kingdom of Great Britain and Northern Ireland,2002,sp,5564,33,90,123
United Kingdom of Great Britain and Northern Ireland,2002,sp,65,93,153,246
United Kingdom of Great Britain and Northern Ireland,2003,sp,014,14,13,27
United Kingdom of Great Britain and Northern Ireland,2003,sp,1524,108,101,209
United Kingdom of Great Britain and Northern Ireland,2003,sp,2534,148,182,330
United Kingdom of Great Britain and Northern Ireland,2003,sp,3544,88,128,216
United Kingdom of Great Britain and Northern Ireland,2003,sp,4554,47,81,128
United Kingdom of Great Britain and Northern Ireland,2003,sp,5564,17,59,76
United Kingdom of Great Britain and Northern Ireland,2003,sp,65,55,92,147
United Kingdom of Great Britain and Northern Ireland,2004,sp,014,13,10,23
United Kingdom of Great Britain and Northern Ireland,2004,sp,1524,126,118,244
United Kingdom of Great Britain and Northern Ireland,2004,sp,2534,176,203,379
United Kingdom of Great Britain and Northern Ireland,2004,sp,3544,85,148,233
United Kingdom of Great Britain and Northern Ireland,2004,sp,4554,47,103,150
United Kingdom of Great Britain and Northern Ireland,2004,sp,5564,33,85,118
United Kingdom of Great Britain and Northern Ireland,2004,sp,65,65,94,159
United Kingdom of Great Britain and Northern Ireland,2005,sp,014,14,9,23
United Kingdom of Great Britain and Northern Ireland,2005,sp,1524,115,135,250
United Kingdom of Great Britain and Northern Ireland,2005,sp,2534,163,200,363
United Kingdom of Great Britain and Northern Ireland,2005,sp,3544,80,166,246
United Kingdom of Great Britain and Northern Ireland,2005,sp,4554,39,95,134
United Kingdom of Great Britain and Northern Ireland,2005,sp,5564,28,95,123
United Kingdom of Great Britain and Northern Ireland,2005,sp,65,83,124,207
United Kingdom of Great Britain and Northern Ireland,2006,ep,014,81,48,129
United Kingdom of Great Britain and Northern Ireland,2006,ep,1524,261,266,527
United Kingdom of Great Britain and Northern Ireland,2006,ep,2534,502,589,1091
United Kingdom of Great Britain and Northern Ireland,2006,ep,3544,310,382,692
United Kingdom of Great Britain and Northern Ireland,2006,ep,4554,220,186,406
United Kingdom of Great Britain and Northern Ireland,2006,ep,5564,155,141,296
United Kingdom of Great Britain and Northern Ireland,2006,ep,65,236,176,412
United Kingdom of Great Britain and Northern Ireland,2006,sn,014,113,103,216
United Kingdom of Great Britain and Northern Ireland,2006,sn,1524,223,230,453
United Kingdom of Great Britain and Northern Ireland,2006,sn,2534,292,391,683
United Kingdom of Great Britain and Northern Ireland,2006,sn,3544,184,240,424
United Kingdom of Great Britain and Northern Ireland,2006,sn,4554,117,175,292
United Kingdom of Great Britain and Northern Ireland,2006,sn,5564,86,153,239
United Kingdom of Great Britain and Northern Ireland,2006,sn,65,198,320,518
United Kingdom of Great Britain and Northern Ireland,2006,sp,014,22,9,31
United Kingdom of Great Britain and Northern Ireland,2006,sp,1524,168,173,341
United Kingdom of Great Britain and Northern Ireland,2006,sp,2534,192,244,436
United Kingdom of Great Britain and Northern Ireland,2006,sp,3544,112,213,325
United Kingdom of Great Britain and Northern Ireland,2006,sp,4554,60,148,208
United Kingdom of Great Britain and Northern Ireland,2006,sp,5564,42,88,130
United Kingdom of Great Britain and Northern Ireland,2006,sp,65,97,191,288
United Kingdom of Great Britain and Northern Ireland,2007,ep,014,225,202,427
United Kingdom of Great Britain and Northern Ireland,2007,ep,1524,432,548,980
United Kingdom of Great Britain and Northern Ireland,2007,ep,2534,782,1000,1782
United Kingdom of Great Britain and Northern Ireland,2007,ep,3544,478,590,1068
United Kingdom of Great Britain and Northern Ireland,2007,ep,4554,303,366,669
United Kingdom of Great Britain and Northern Ireland,2007,ep,5564,248,261,509
United Kingdom of Great Britain and Northern Ireland,2007,ep,65,402,457,859
United Kingdom of Great Britain and Northern Ireland,2007,sn,014,142,145,287
United Kingdom of Great Britain and Northern Ireland,2007,sn,1524,210,224,434
United Kingdom of Great Britain and Northern Ireland,2007,sn,2534,322,379,701
United Kingdom of Great Britain and Northern Ireland,2007,sn,3544,180,248,428
United Kingdom of Great Britain and Northern Ireland,2007,sn,4554,113,204,317
United Kingdom of Great Britain and Northern Ireland,2007,sn,5564,133,218,351
United Kingdom of Great Britain and Northern Ireland,2007,sn,65,198,274,472
United Kingdom of Great Britain and Northern Ireland,2007,sp,014,20,13,33
United Kingdom of Great Britain and Northern Ireland,2007,sp,1524,145,183,328
United Kingdom of Great Britain and Northern Ireland,2007,sp,2534,222,286,508
United Kingdom of Great Britain and Northern Ireland,2007,sp,3544,91,223,314
United Kingdom of Great Britain and Northern Ireland,2007,sp,4554,58,169,227
United Kingdom of Great Britain and Northern Ireland,2007,sp,5564,45,97,142
United Kingdom of Great Britain and Northern Ireland,2007,sp,65,138,202,340
United Kingdom of Great Britain and Northern Ireland,2008,ep,014,80,64,144
United Kingdom of Great Britain and Northern Ireland,2008,ep,1524,172,222,394
United Kingdom of Great Britain and Northern Ireland,2008,ep,2534,426,513,939
United Kingdom of Great Britain and Northern Ireland,2008,ep,3544,277,330,607
United Kingdom of Great Britain and Northern Ireland,2008,ep,4554,211,186,397
United Kingdom of Great Britain and Northern Ireland,2008,ep,5564,118,92,210
United Kingdom of Great Britain and Northern Ireland,2008,ep,65,177,154,331
United Kingdom of Great Britain and Northern Ireland,2008,sn,014,104,108,212
United Kingdom of Great Britain and Northern Ireland,2008,sn,1524,154,172,326
United Kingdom of Great Britain and Northern Ireland,2008,sn,2534,245,317,562
United Kingdom of Great Britain and Northern Ireland,2008,sn,3544,145,192,337
United Kingdom of Great Britain and Northern Ireland,2008,sn,4554,108,143,251
United Kingdom of Great Britain and Northern Ireland,2008,sn,5564,65,110,175
United Kingdom of Great Britain and Northern Ireland,2008,sn,65,146,202,348
United Kingdom of Great Britain and Northern Ireland,2008,sp,014,16,5,21
United Kingdom of Great Britain and Northern Ireland,2008,sp,1524,134,125,259
United Kingdom of Great Britain and Northern Ireland,2008,sp,2534,181,188,369
United Kingdom of Great Britain and Northern Ireland,2008,sp,3544,90,155,245
United Kingdom of Great Britain and Northern Ireland,2008,sp,4554,27,111,138
United Kingdom of Great Britain and Northern Ireland,2008,sp,5564,28,61,89
United Kingdom of Great Britain and Northern Ireland,2008,sp,65,62,99,161
United Kingdom of Great Britain and Northern Ireland,2009,ep,014,50,63,113
United Kingdom of Great Britain and Northern Ireland,2009,ep,1524,198,202,400
United Kingdom of Great Britain and Northern Ireland,2009,ep,2534,438,528,966
United Kingdom of Great Britain and Northern Ireland,2009,ep,3544,299,390,689
United Kingdom of Great Britain and Northern Ireland,2009,ep,4554,206,203,409
United Kingdom of Great Britain and Northern Ireland,2009,ep,5564,152,114,266
United Kingdom of Great Britain and Northern Ireland,2009,ep,65,181,177,358
United Kingdom of Great Britain and Northern Ireland,2009,sn,014,114,93,207
United Kingdom of Great Britain and Northern Ireland,2009,sn,1524,179,261,440
United Kingdom of Great Britain and Northern Ireland,2009,sn,2534,257,343,600
United Kingdom of Great Britain and Northern Ireland,2009,sn,3544,156,246,402
United Kingdom of Great Britain and Northern Ireland,2009,sn,4554,131,167,298
United Kingdom of Great Britain and Northern Ireland,2009,sn,5564,84,135,219
United Kingdom of Great Britain and Northern Ireland,2009,sn,65,162,239,401
United Kingdom of Great Britain and Northern Ireland,2009,sp,014,18,4,22
United Kingdom of Great Britain and Northern Ireland,2009,sp,1524,111,136,247
United Kingdom of Great Britain and Northern Ireland,2009,sp,2534,159,207,366
United Kingdom of Great Britain and Northern Ireland,2009,sp,3544,77,142,219
United Kingdom of Great Britain and Northern Ireland,2009,sp,4554,39,96,135
United Kingdom of Great Britain and Northern Ireland,2009,sp,5564,24,64,88
United Kingdom of Great Britain and Northern Ireland,2009,sp,65,48,95,143
United Kingdom of Great Britain and Northern Ireland,2010,ep,014,57,53,110
United Kingdom of Great Britain and Northern Ireland,2010,ep,1524,204,242,446
United Kingdom of Great Britain and Northern Ireland,2010,ep,2534,423,619,1042
United Kingdom of Great Britain and Northern Ireland,2010,ep,3544,296,426,722
United Kingdom of Great Britain and Northern Ireland,2010,ep,4554,209,206,415
United Kingdom of Great Britain and Northern Ireland,2010,ep,5564,142,126,268
United Kingdom of Great Britain and Northern Ireland,2010,ep,65,174,174,348
United Kingdom of Great Britain and Northern Ireland,2010,sn,014,106,95,201
United Kingdom of Great Britain and Northern Ireland,2010,sn,1524,193,237,430
United Kingdom of Great Britain and Northern Ireland,2010,sn,2534,266,372,638
United Kingdom of Great Britain and Northern Ireland,2010,sn,3544,166,226,392
United Kingdom of Great Britain and Northern Ireland,2010,sn,4554,110,176,286
United Kingdom of Great Britain and Northern Ireland,2010,sn,5564,85,168,253
United Kingdom of Great Britain and Northern Ireland,2010,sn,65,176,232,408
United Kingdom of Great Britain and Northern Ireland,2010,sp,014,15,7,22
United Kingdom of Great Britain and Northern Ireland,2010,sp,1524,112,132,244
United Kingdom of Great Britain and Northern Ireland,2010,sp,2534,128,170,298
United Kingdom of Great Britain and Northern Ireland,2010,sp,3544,82,132,214
United Kingdom of Great Britain and Northern Ireland,2010,sp,4554,43,109,152
United Kingdom of Great Britain and Northern Ireland,2010,sp,5564,39,59,98
United Kingdom of Great Britain and Northern Ireland,2010,sp,65,55,106,161
United Kingdom of Great Britain and Northern Ireland,2011,ep,014,70,65,135
United Kingdom of Great Britain and Northern Ireland,2011,ep,1524,200,288,488
United Kingdom of Great Britain and Northern Ireland,2011,ep,2534,503,695,1198
United Kingdom of Great Britain and Northern Ireland,2011,ep,3544,345,410,755
United Kingdom of Great Britain and Northern Ireland,2011,ep,4554,231,236,467
United Kingdom of Great Britain and Northern Ireland,2011,ep,5564,149,146,295
United Kingdom of Great Britain and Northern Ireland,2011,ep,65,177,195,372
United Kingdom of Great Britain and Northern Ireland,2011,sn,014,115,100,215
United Kingdom of Great Britain and Northern Ireland,2011,sn,1524,179,279,458
United Kingdom of Great Britain and Northern Ireland,2011,sn,2534,300,388,688
United Kingdom of Great Britain and Northern Ireland,2011,sn,3544,165,266,431
United Kingdom of Great Britain and Northern Ireland,2011,sn,4554,111,202,313
United Kingdom of Great Britain and Northern Ireland,2011,sn,5564,114,145,259
United Kingdom of Great Britain and Northern Ireland,2011,sn,65,170,295,465
United Kingdom of Great Britain and Northern Ireland,2011,sp,014,19,3,22
United Kingdom of Great Britain and Northern Ireland,2011,sp,1524,136,146,282
United Kingdom of Great Britain and Northern Ireland,2011,sp,2534,139,205,344
United Kingdom of Great Britain and Northern Ireland,2011,sp,3544,78,147,225
United Kingdom of Great Britain and Northern Ireland,2011,sp,4554,48,110,158
United Kingdom of Great Britain and Northern Ireland,2011,sp,5564,27,79,106
United Kingdom of Great Britain and Northern Ireland,2011,sp,65,50,102,152
United Kingdom of Great Britain and Northern Ireland,2012,ep,014,68,49,117
United Kingdom of Great Britain and Northern Ireland,2012,ep,1524,191,260,451
United Kingdom of Great Britain and Northern Ireland,2012,ep,2534,505,702,1207
United Kingdom of Great Britain and Northern Ireland,2012,ep,3544,315,464,779
United Kingdom of Great Britain and Northern Ireland,2012,ep,4554,215,230,445
United Kingdom of Great Britain and Northern Ireland,2012,ep,5564,152,144,296
United Kingdom of Great Britain and Northern Ireland,2012,ep,65,215,166,381
United Kingdom of Great Britain and Northern Ireland,2012,sn,014,112,121,233
United Kingdom of Great Britain and Northern Ireland,2012,sn,1524,181,272,453
United Kingdom of Great Britain and Northern Ireland,2012,sn,2534,259,401,660
United Kingdom of Great Britain and Northern Ireland,2012,sn,3544,179,230,409
United Kingdom of Great Britain and Northern Ireland,2012,sn,4554,120,199,319
United Kingdom of Great Britain and Northern Ireland,2012,sn,5564,91,150,241
United Kingdom of Great Britain and Northern Ireland,2012,sn,65,177,259,436
United Kingdom of Great Britain and Northern Ireland,2012,sp,014,17,8,25
United Kingdom of Great Britain and Northern Ireland,2012,sp,1524,109,156,265
United Kingdom of Great Britain and Northern Ireland,2012,sp,2534,141,184,325
United Kingdom of Great Britain and Northern Ireland,2012,sp,3544,81,137,218
United Kingdom of Great Britain and Northern Ireland,2012,sp,4554,55,118,173
United Kingdom of Great Britain and Northern Ireland,2012,sp,5564,17,88,105
United Kingdom of Great Britain and Northern Ireland,2012,sp,65,52,88,140
United Kingdom of Great Britain and Northern Ireland,2013,rel,014,156,155,311
United Kingdom of Great Britain and Northern Ireland,2013,rel,1524,404,588,992
United Kingdom of Great Britain and Northern Ireland,2013,rel,2534,839,1158,1997
United Kingdom of Great Britain and Northern Ireland,2013,rel,3544,552,858,1410
United Kingdom of Great Britain and Northern Ireland,2013,rel,4554,406,590,996
United Kingdom of Great Britain and Northern Ireland,2013,rel,5564,280,378,658
United Kingdom of Great Britain and Northern Ireland,2013,rel,65,462,558,1020
United Republic of Tanzania,1995,sp,014,201,183,384
United Republic of Tanzania,1995,sp,1524,1904,2108,4012
United Republic of Tanzania,1995,sp,2534,2532,4091,6623
United Republic of Tanzania,1995,sp,3544,1324,2916,4240
United Republic of Tanzania,1995,sp,4554,735,1754,2489
United Republic of Tanzania,1995,sp,5564,380,1007,1387
United Republic of Tanzania,1995,sp,65,179,640,819
United Republic of Tanzania,1996,sp,014,221,171,392
United Republic of Tanzania,1996,sp,1524,2087,2176,4263
United Republic of Tanzania,1996,sp,2534,2885,4275,7160
United Republic of Tanzania,1996,sp,3544,1461,3107,4568
United Republic of Tanzania,1996,sp,4554,806,1843,2649
United Republic of Tanzania,1996,sp,5564,472,1109,1581
United Republic of Tanzania,1996,sp,65,203,656,859
United Republic of Tanzania,1997,sp,014,251,188,439
United Republic of Tanzania,1997,sp,1524,2146,2210,4356
United Republic of Tanzania,1997,sp,2534,2876,4538,7414
United Republic of Tanzania,1997,sp,3544,1502,3066,4568
United Republic of Tanzania,1997,sp,4554,908,1090,1998
United Republic of Tanzania,1997,sp,5564,501,1134,1635
United Republic of Tanzania,1997,sp,65,198,699,897
United Republic of Tanzania,1998,sp,014,240,198,438
United Republic of Tanzania,1998,sp,1524,2234,2528,4762
United Republic of Tanzania,1998,sp,2534,3243,4910,8153
United Republic of Tanzania,1998,sp,3544,1686,3400,5086
United Republic of Tanzania,1998,sp,4554,835,1973,2808
United Republic of Tanzania,1998,sp,5564,466,1112,1578
United Republic of Tanzania,1998,sp,65,241,767,1008
United Republic of Tanzania,1999,sp,014,230,170,400
United Republic of Tanzania,1999,sp,1524,2160,2422,4582
United Republic of Tanzania,1999,sp,2534,3469,4887,8356
United Republic of Tanzania,1999,sp,3544,1724,3401,5125
United Republic of Tanzania,1999,sp,4554,876,2068,2944
United Republic of Tanzania,1999,sp,5564,501,1160,1661
United Republic of Tanzania,1999,sp,65,232,823,1055
United Republic of Tanzania,2000,sp,014,257,200,457
United Republic of Tanzania,2000,sp,1524,2106,2357,4463
United Republic of Tanzania,2000,sp,2534,3426,4836,8262
United Republic of Tanzania,2000,sp,3544,1738,3430,5168
United Republic of Tanzania,2000,sp,4554,868,2022,2890
United Republic of Tanzania,2000,sp,5564,494,1202,1696
United Republic of Tanzania,2000,sp,65,269,834,1103
United Republic of Tanzania,2001,sp,014,312,212,524
United Republic of Tanzania,2001,sp,1524,2117,2302,4419
United Republic of Tanzania,2001,sp,2534,3609,4912,8521
United Republic of Tanzania,2001,sp,3544,1847,3545,5392
United Republic of Tanzania,2001,sp,4554,891,2031,2922
United Republic of Tanzania,2001,sp,5564,522,1136,1658
United Republic of Tanzania,2001,sp,65,319,930,1249
United Republic of Tanzania,2002,sp,014,241,187,428
United Republic of Tanzania,2002,sp,1524,1927,2309,4236
United Republic of Tanzania,2002,sp,2534,3511,4814,8325
United Republic of Tanzania,2002,sp,3544,1706,3525,5231
United Republic of Tanzania,2002,sp,4554,907,2075,2982
United Republic of Tanzania,2002,sp,5564,475,1211,1686
United Republic of Tanzania,2002,sp,65,304,944,1248
United Republic of Tanzania,2003,sp,014,244,181,425
United Republic of Tanzania,2003,sp,1524,2063,2172,4235
United Republic of Tanzania,2003,sp,2534,3504,4964,8468
United Republic of Tanzania,2003,sp,3544,1833,3728,5561
United Republic of Tanzania,2003,sp,4554,929,2166,3095
United Republic of Tanzania,2003,sp,5564,509,1237,1746
United Republic of Tanzania,2003,sp,65,344,1025,1369
United Republic of Tanzania,2004,sp,014,280,208,488
United Republic of Tanzania,2004,sp,1524,1996,2216,4212
United Republic of Tanzania,2004,sp,2534,3537,5203,8740
United Republic of Tanzania,2004,sp,3544,1960,3884,5844
United Republic of Tanzania,2004,sp,4554,1011,2254,3265
United Republic of Tanzania,2004,sp,5564,544,1272,1816
United Republic of Tanzania,2004,sp,65,329,1129,1458
United Republic of Tanzania,2005,sp,014,271,190,461
United Republic of Tanzania,2005,sp,1524,1852,2062,3914
United Republic of Tanzania,2005,sp,2534,3521,4939,8460
United Republic of Tanzania,2005,sp,3544,1892,4025,5917
United Republic of Tanzania,2005,sp,4554,968,2310,3278
United Republic of Tanzania,2005,sp,5564,547,1279,1826
United Republic of Tanzania,2005,sp,65,354,1054,1408
United Republic of Tanzania,2006,sp,014,293,204,497
United Republic of Tanzania,2006,sp,1524,1745,2060,3805
United Republic of Tanzania,2006,sp,2534,3326,4926,8252
United Republic of Tanzania,2006,sp,3544,1970,3832,5802
United Republic of Tanzania,2006,sp,4554,995,2154,3149
United Republic of Tanzania,2006,sp,5564,507,1348,1855
United Republic of Tanzania,2006,sp,65,335,1029,1364
United Republic of Tanzania,2007,sp,014,238,189,427
United Republic of Tanzania,2007,sp,1524,1735,2021,3756
United Republic of Tanzania,2007,sp,2534,3388,4665,8053
United Republic of Tanzania,2007,sp,3544,1945,3855,5800
United Republic of Tanzania,2007,sp,4554,947,2231,3178
United Republic of Tanzania,2007,sp,5564,535,1317,1852
United Republic of Tanzania,2007,sp,65,388,1066,1454
United Republic of Tanzania,2008,ep,3544,NA,12784,NA
United Republic of Tanzania,2008,sn,2534,NA,21935,NA
United Republic of Tanzania,2008,sp,014,233,191,424
United Republic of Tanzania,2008,sp,1524,1663,1963,3626
United Republic of Tanzania,2008,sp,2534,3152,4595,7747
United Republic of Tanzania,2008,sp,3544,1901,3874,5775
United Republic of Tanzania,2008,sp,4554,964,2349,3313
United Republic of Tanzania,2008,sp,5564,564,1230,1794
United Republic of Tanzania,2008,sp,65,415,1077,1492
United Republic of Tanzania,2009,ep,014,986,1262,2248
United Republic of Tanzania,2009,ep,2534,5121,6036,11157
United Republic of Tanzania,2009,sn,014,1134,1371,2505
United Republic of Tanzania,2009,sn,2534,8281,10964,19245
United Republic of Tanzania,2009,sp,014,247,196,443
United Republic of Tanzania,2009,sp,1524,1639,2081,3720
United Republic of Tanzania,2009,sp,2534,3102,4581,7683
United Republic of Tanzania,2009,sp,3544,2080,4125,6205
United Republic of Tanzania,2009,sp,4554,1060,2388,3448
United Republic of Tanzania,2009,sp,5564,564,1293,1857
United Republic of Tanzania,2009,sp,65,416,1123,1539
United Republic of Tanzania,2010,ep,014,1103,1234,2337
United Republic of Tanzania,2010,ep,1524,5322,6056,11378
United Republic of Tanzania,2010,sn,014,1030,1369,2399
United Republic of Tanzania,2010,sn,1524,8206,10589,18795
United Republic of Tanzania,2010,sp,014,248,232,480
United Republic of Tanzania,2010,sp,1524,1689,1975,3664
United Republic of Tanzania,2010,sp,2534,2988,4493,7481
United Republic of Tanzania,2010,sp,3544,2013,4141,6154
United Republic of Tanzania,2010,sp,4554,1044,2427,3471
United Republic of Tanzania,2010,sp,5564,578,1309,1887
United Republic of Tanzania,2010,sp,65,471,1161,1632
United Republic of Tanzania,2011,ep,014,967,1188,2155
United Republic of Tanzania,2011,sn,014,1062,1255,2317
United Republic of Tanzania,2011,sp,014,221,190,411
United Republic of Tanzania,2011,sp,1524,1660,1975,3635
United Republic of Tanzania,2011,sp,2534,2896,4405,7301
United Republic of Tanzania,2011,sp,3544,2140,4073,6213
United Republic of Tanzania,2011,sp,4554,944,2402,3346
United Republic of Tanzania,2011,sp,5564,490,1211,1701
United Republic of Tanzania,2011,sp,65,381,1127,1508
United Republic of Tanzania,2012,ep,014,1070,1235,2305
United Republic of Tanzania,2012,sn,014,1138,1379,2517
United Republic of Tanzania,2012,sp,014,284,209,493
United Republic of Tanzania,2012,sp,1524,1652,2091,3743
United Republic of Tanzania,2012,sp,2534,2917,4721,7638
United Republic of Tanzania,2012,sp,3544,2115,4409,6524
United Republic of Tanzania,2012,sp,4554,1024,2462,3486
United Republic of Tanzania,2012,sp,5564,508,1304,1812
United Republic of Tanzania,2012,sp,65,424,1121,1545
United Republic of Tanzania,2013,rel,014,3069,3589,6658
United States of America,1995,sp,014,26,19,45
United States of America,1995,sp,1524,280,355,635
United States of America,1995,sp,2534,579,876,1455
United States of America,1995,sp,3544,499,1417,1916
United States of America,1995,sp,4554,285,1121,1406
United States of America,1995,sp,5564,202,742,944
United States of America,1995,sp,65,591,1099,1690
United States of America,1996,sp,014,21,15,36
United States of America,1996,sp,1524,289,333,622
United States of America,1996,sp,2534,487,815,1302
United States of America,1996,sp,3544,478,1219,1697
United States of America,1996,sp,4554,279,1073,1352
United States of America,1996,sp,5564,217,678,895
United States of America,1996,sp,65,541,1007,1548
United States of America,1997,sp,014,28,12,40
United States of America,1997,sp,1524,269,330,599
United States of America,1997,sp,2534,449,701,1150
United States of America,1997,sp,3544,447,1127,1574
United States of America,1997,sp,4554,254,979,1233
United States of America,1997,sp,5564,201,679,880
United States of America,1997,sp,65,514,944,1458
United States of America,1998,sp,014,15,10,25
United States of America,1998,sp,1524,269,321,590
United States of America,1998,sp,2534,425,663,1088
United States of America,1998,sp,3544,424,1009,1433
United States of America,1998,sp,4554,267,1007,1274
United States of America,1998,sp,5564,179,628,807
United States of America,1998,sp,65,492,914,1406
United States of America,1999,sp,014,16,18,34
United States of America,1999,sp,1524,232,331,563
United States of America,1999,sp,2534,391,616,1007
United States of America,1999,sp,3544,394,1011,1405
United States of America,1999,sp,4554,245,930,1175
United States of America,1999,sp,5564,244,601,845
United States of America,1999,sp,65,444,801,1245
United States of America,2000,sp,014,14,6,20
United States of America,2000,sp,1524,246,365,611
United States of America,2000,sp,2534,376,602,978
United States of America,2000,sp,3544,349,906,1255
United States of America,2000,sp,4554,253,904,1157
United States of America,2000,sp,5564,152,577,729
United States of America,2000,sp,65,396,738,1134
United States of America,2001,sp,014,21,17,38
United States of America,2001,sp,1524,239,320,559
United States of America,2001,sp,2534,410,613,1023
United States of America,2001,sp,3544,346,824,1170
United States of America,2001,sp,4554,247,876,1123
United States of America,2001,sp,5564,176,524,700
United States of America,2001,sp,65,389,649,1038
United States of America,2002,sp,014,15,14,29
United States of America,2002,sp,1524,233,343,576
United States of America,2002,sp,2534,423,562,985
United States of America,2002,sp,3544,362,813,1175
United States of America,2002,sp,4554,255,795,1050
United States of America,2002,sp,5564,167,490,657
United States of America,2002,sp,65,370,592,962
United States of America,2003,sp,014,12,11,23
United States of America,2003,sp,1524,277,365,642
United States of America,2003,sp,2534,353,526,879
United States of America,2003,sp,3544,310,754,1064
United States of America,2003,sp,4554,269,828,1097
United States of America,2003,sp,5564,169,487,656
United States of America,2003,sp,65,354,650,1004
United States of America,2004,sp,014,19,12,31
United States of America,2004,sp,1524,265,362,627
United States of America,2004,sp,2534,339,547,886
United States of America,2004,sp,3544,302,728,1030
United States of America,2004,sp,4554,252,829,1081
United States of America,2004,sp,5564,166,504,670
United States of America,2004,sp,65,344,582,926
United States of America,2005,sp,014,11,14,25
United States of America,2005,sp,1524,241,383,624
United States of America,2005,sp,2534,348,535,883
United States of America,2005,sp,3544,276,666,942
United States of America,2005,sp,4554,242,767,1009
United States of America,2005,sp,5564,161,499,660
United States of America,2005,sp,65,322,624,946
United States of America,2006,ep,014,102,114,216
United States of America,2006,ep,1524,143,150,293
United States of America,2006,ep,2534,290,286,576
United States of America,2006,ep,3544,245,265,510
United States of America,2006,ep,4554,212,220,432
United States of America,2006,ep,5564,174,163,337
United States of America,2006,ep,65,256,267,523
United States of America,2006,sn,014,276,292,568
United States of America,2006,sn,1524,269,331,600
United States of America,2006,sn,2534,397,476,873
United States of America,2006,sn,3544,321,541,862
United States of America,2006,sn,4554,272,655,927
United States of America,2006,sn,5564,209,499,708
United States of America,2006,sn,65,481,772,1253
United States of America,2006,sp,014,11,12,23
United States of America,2006,sp,1524,257,388,645
United States of America,2006,sp,2534,384,568,952
United States of America,2006,sp,3544,263,659,922
United States of America,2006,sp,4554,212,759,971
United States of America,2006,sp,5564,146,531,677
United States of America,2006,sp,65,303,596,899
United States of America,2007,ep,014,93,90,183
United States of America,2007,ep,1524,148,137,285
United States of America,2007,ep,2534,263,284,547
United States of America,2007,ep,3544,219,227,446
United States of America,2007,ep,4554,211,208,419
United States of America,2007,ep,5564,176,155,331
United States of America,2007,ep,65,270,215,485
United States of America,2007,sn,014,286,286,572
United States of America,2007,sn,1524,260,362,622
United States of America,2007,sn,2534,384,511,895
United States of America,2007,sn,3544,294,469,763
United States of America,2007,sn,4554,279,630,909
United States of America,2007,sn,5564,267,476,743
United States of America,2007,sn,65,497,724,1221
United States of America,2007,sp,014,12,12,24
United States of America,2007,sp,1524,257,414,671
United States of America,2007,sp,2534,338,490,828
United States of America,2007,sp,3544,260,572,832
United States of America,2007,sp,4554,225,744,969
United States of America,2007,sp,5564,135,533,668
United States of America,2007,sp,65,308,562,870
United States of America,2008,ep,014,97,82,179
United States of America,2008,ep,1524,129,146,275
United States of America,2008,ep,2534,261,284,545
United States of America,2008,ep,3544,219,242,461
United States of America,2008,ep,4554,181,225,406
United States of America,2008,ep,5564,162,147,309
United States of America,2008,ep,65,231,232,463
United States of America,2008,sn,014,260,311,571
United States of America,2008,sn,1524,246,323,569
United States of America,2008,sn,2534,334,486,820
United States of America,2008,sn,3544,303,505,808
United States of America,2008,sn,4554,283,605,888
United States of America,2008,sn,5564,233,449,682
United States of America,2008,sn,65,483,692,1175
United States of America,2008,sp,014,22,11,33
United States of America,2008,sp,1524,220,375,595
United States of America,2008,sp,2534,329,513,842
United States of America,2008,sp,3544,269,495,764
United States of America,2008,sp,4554,224,725,949
United States of America,2008,sp,5564,172,526,698
United States of America,2008,sp,65,300,561,861
United States of America,2009,ep,014,80,77,157
United States of America,2009,ep,1524,120,121,241
United States of America,2009,ep,2534,271,231,502
United States of America,2009,ep,3544,205,206,411
United States of America,2009,ep,4554,165,176,341
United States of America,2009,ep,5564,141,144,285
United States of America,2009,ep,65,210,232,442
United States of America,2009,sn,014,217,248,465
United States of America,2009,sn,1524,234,279,513
United States of America,2009,sn,2534,340,452,792
United States of America,2009,sn,3544,284,452,736
United States of America,2009,sn,4554,258,489,747
United States of America,2009,sn,5564,225,428,653
United States of America,2009,sn,65,413,662,1075
United States of America,2009,sp,014,6,11,17
United States of America,2009,sp,1524,203,299,502
United States of America,2009,sp,2534,288,446,734
United States of America,2009,sp,3544,221,431,652
United States of America,2009,sp,4554,211,564,775
United States of America,2009,sp,5564,135,452,587
United States of America,2009,sp,65,247,496,743
United States of America,2010,ep,014,70,62,132
United States of America,2010,ep,1524,104,114,218
United States of America,2010,ep,2534,214,233,447
United States of America,2010,ep,3544,162,204,366
United States of America,2010,ep,4554,133,140,273
United States of America,2010,ep,5564,126,123,249
United States of America,2010,ep,65,177,166,343
United States of America,2010,sn,014,203,243,446
United States of America,2010,sn,1524,202,245,447
United States of America,2010,sn,2534,278,428,706
United States of America,2010,sn,3544,245,436,681
United States of America,2010,sn,4554,270,533,803
United States of America,2010,sn,5564,193,425,618
United States of America,2010,sn,65,410,640,1050
United States of America,2010,sp,014,9,5,14
United States of America,2010,sp,1524,195,246,441
United States of America,2010,sp,2534,265,360,625
United States of America,2010,sp,3544,183,371,554
United States of America,2010,sp,4554,165,505,670
United States of America,2010,sp,5564,130,403,533
United States of America,2010,sp,65,223,466,689
United States of America,2011,ep,014,64,69,133
United States of America,2011,ep,1524,93,94,187
United States of America,2011,ep,2534,198,203,401
United States of America,2011,ep,3544,195,176,371
United States of America,2011,ep,4554,167,184,351
United States of America,2011,ep,5564,132,163,295
United States of America,2011,ep,65,205,208,413
United States of America,2011,sn,014,185,227,412
United States of America,2011,sn,1524,195,231,426
United States of America,2011,sn,2534,303,365,668
United States of America,2011,sn,3544,245,376,621
United States of America,2011,sn,4554,214,437,651
United States of America,2011,sn,5564,212,459,671
United States of America,2011,sn,65,426,607,1033
United States of America,2011,sp,014,15,12,27
United States of America,2011,sp,1524,160,235,395
United States of America,2011,sp,2534,254,403,657
United States of America,2011,sp,3544,199,374,573
United States of America,2011,sp,4554,150,557,707
United States of America,2011,sp,5564,138,434,572
United States of America,2011,sp,65,269,486,755
United States of America,2012,ep,014,54,53,107
United States of America,2012,ep,1524,100,88,188
United States of America,2012,ep,2534,226,217,443
United States of America,2012,ep,3544,180,169,349
United States of America,2012,ep,4554,156,163,319
United States of America,2012,ep,5564,127,141,268
United States of America,2012,ep,65,212,214,426
United States of America,2012,sn,014,173,180,353
United States of America,2012,sn,1524,198,225,423
United States of America,2012,sn,2534,295,378,673
United States of America,2012,sn,3544,218,346,564
United States of America,2012,sn,4554,216,383,599
United States of America,2012,sn,5564,200,443,643
United States of America,2012,sn,65,373,628,1001
United States of America,2012,sp,014,14,10,24
United States of America,2012,sp,1524,161,239,400
United States of America,2012,sp,2534,262,322,584
United States of America,2012,sp,3544,169,333,502
United States of America,2012,sp,4554,175,502,677
United States of America,2012,sp,5564,148,455,603
United States of America,2012,sp,65,243,529,772
United States of America,2013,rel,014,229,249,478
United States of America,2013,rel,1524,415,529,944
United States of America,2013,rel,2534,693,829,1522
United States of America,2013,rel,3544,528,793,1321
United States of America,2013,rel,4554,470,937,1407
United States of America,2013,rel,5564,463,926,1389
United States of America,2013,rel,65,786,1259,2045
Uruguay,1995,sp,014,2,4,6
Uruguay,1995,sp,1524,21,28,49
Uruguay,1995,sp,2534,26,40,66
Uruguay,1995,sp,3544,18,35,53
Uruguay,1995,sp,4554,12,49,61
Uruguay,1995,sp,5564,9,38,47
Uruguay,1995,sp,65,17,50,67
Uruguay,1996,sp,014,4,4,8
Uruguay,1996,sp,1524,24,34,58
Uruguay,1996,sp,2534,35,43,78
Uruguay,1996,sp,3544,17,58,75
Uruguay,1996,sp,4554,21,59,80
Uruguay,1996,sp,5564,10,53,63
Uruguay,1996,sp,65,22,42,64
Uruguay,1997,sp,014,5,3,8
Uruguay,1997,sp,1524,26,37,63
Uruguay,1997,sp,2534,28,44,72
Uruguay,1997,sp,3544,29,53,82
Uruguay,1997,sp,4554,12,53,65
Uruguay,1997,sp,5564,8,55,63
Uruguay,1997,sp,65,17,53,70
Uruguay,1998,sp,014,2,2,4
Uruguay,1998,sp,1524,30,30,60
Uruguay,1998,sp,2534,29,47,76
Uruguay,1998,sp,3544,15,52,67
Uruguay,1998,sp,4554,14,47,61
Uruguay,1998,sp,5564,6,38,44
Uruguay,1998,sp,65,23,39,62
Uruguay,1999,sp,014,4,1,5
Uruguay,1999,sp,1524,20,45,65
Uruguay,1999,sp,2534,25,48,73
Uruguay,1999,sp,3544,33,42,75
Uruguay,1999,sp,4554,14,46,60
Uruguay,1999,sp,5564,11,48,59
Uruguay,1999,sp,65,14,41,55
Uruguay,2000,sp,014,2,0,2
Uruguay,2000,sp,1524,28,36,64
Uruguay,2000,sp,2534,22,48,70
Uruguay,2000,sp,3544,21,45,66
Uruguay,2000,sp,4554,13,41,54
Uruguay,2000,sp,5564,12,30,42
Uruguay,2000,sp,65,16,34,50
Uruguay,2001,sp,014,4,2,6
Uruguay,2001,sp,1524,25,33,58
Uruguay,2001,sp,2534,31,38,69
Uruguay,2001,sp,3544,7,49,56
Uruguay,2001,sp,4554,15,42,57
Uruguay,2001,sp,5564,3,31,34
Uruguay,2001,sp,65,16,44,60
Uruguay,2002,sp,014,1,1,2
Uruguay,2002,sp,1524,25,33,58
Uruguay,2002,sp,2534,25,33,58
Uruguay,2002,sp,3544,20,37,57
Uruguay,2002,sp,4554,10,36,46
Uruguay,2002,sp,5564,11,23,34
Uruguay,2002,sp,65,21,32,53
Uruguay,2003,sp,014,1,3,4
Uruguay,2003,sp,1524,28,46,74
Uruguay,2003,sp,2534,24,50,74
Uruguay,2003,sp,3544,13,35,48
Uruguay,2003,sp,4554,13,42,55
Uruguay,2003,sp,5564,6,38,44
Uruguay,2003,sp,65,14,26,40
Uruguay,2004,sp,014,2,1,3
Uruguay,2004,sp,1524,34,38,72
Uruguay,2004,sp,2534,25,59,84
Uruguay,2004,sp,3544,12,53,65
Uruguay,2004,sp,4554,17,48,65
Uruguay,2004,sp,5564,11,26,37
Uruguay,2004,sp,65,7,40,47
Uruguay,2005,sp,014,1,1,2
Uruguay,2005,sp,1524,33,42,75
Uruguay,2005,sp,2534,30,48,78
Uruguay,2005,sp,3544,17,39,56
Uruguay,2005,sp,4554,9,45,54
Uruguay,2005,sp,5564,8,34,42
Uruguay,2005,sp,65,12,36,48
Uruguay,2006,ep,014,4,2,6
Uruguay,2006,ep,1524,2,10,12
Uruguay,2006,ep,2534,4,6,10
Uruguay,2006,ep,3544,5,6,11
Uruguay,2006,ep,4554,4,6,10
Uruguay,2006,ep,5564,2,8,10
Uruguay,2006,ep,65,9,2,11
Uruguay,2006,sn,014,4,1,5
Uruguay,2006,sn,1524,7,9,16
Uruguay,2006,sn,2534,10,23,33
Uruguay,2006,sn,3544,4,20,24
Uruguay,2006,sn,4554,10,17,27
Uruguay,2006,sn,5564,4,11,15
Uruguay,2006,sn,65,11,21,32
Uruguay,2006,sp,014,4,1,5
Uruguay,2006,sp,1524,21,38,59
Uruguay,2006,sp,2534,19,53,72
Uruguay,2006,sp,3544,11,34,45
Uruguay,2006,sp,4554,6,30,36
Uruguay,2006,sp,5564,11,38,49
Uruguay,2006,sp,65,10,29,39
Uruguay,2007,ep,014,1,3,4
Uruguay,2007,ep,1524,1,5,6
Uruguay,2007,ep,2534,8,8,16
Uruguay,2007,ep,3544,1,4,5
Uruguay,2007,ep,4554,4,4,8
Uruguay,2007,ep,5564,1,5,6
Uruguay,2007,ep,65,5,7,12
Uruguay,2007,sn,014,3,4,7
Uruguay,2007,sn,1524,9,7,16
Uruguay,2007,sn,2534,10,20,30
Uruguay,2007,sn,3544,8,11,19
Uruguay,2007,sn,4554,6,20,26
Uruguay,2007,sn,5564,0,12,12
Uruguay,2007,sn,65,9,13,22
Uruguay,2007,sp,014,1,1,2
Uruguay,2007,sp,1524,23,39,62
Uruguay,2007,sp,2534,26,69,95
Uruguay,2007,sp,3544,22,37,59
Uruguay,2007,sp,4554,14,50,64
Uruguay,2007,sp,5564,7,39,46
Uruguay,2007,sp,65,13,39,52
Uruguay,2008,ep,014,3,1,4
Uruguay,2008,ep,1524,8,6,14
Uruguay,2008,ep,2534,5,12,17
Uruguay,2008,ep,3544,6,8,14
Uruguay,2008,ep,4554,5,3,8
Uruguay,2008,ep,5564,3,0,3
Uruguay,2008,ep,65,5,4,9
Uruguay,2008,sn,014,5,4,9
Uruguay,2008,sn,1524,10,9,19
Uruguay,2008,sn,2534,15,20,35
Uruguay,2008,sn,3544,8,15,23
Uruguay,2008,sn,4554,16,13,29
Uruguay,2008,sn,5564,3,14,17
Uruguay,2008,sn,65,11,16,27
Uruguay,2008,sp,014,4,1,5
Uruguay,2008,sp,1524,26,49,75
Uruguay,2008,sp,2534,35,71,106
Uruguay,2008,sp,3544,26,64,90
Uruguay,2008,sp,4554,15,45,60
Uruguay,2008,sp,5564,13,28,41
Uruguay,2008,sp,65,13,34,47
Uruguay,2009,ep,014,1,6,7
Uruguay,2009,ep,1524,2,4,6
Uruguay,2009,ep,2534,4,9,13
Uruguay,2009,ep,3544,5,8,13
Uruguay,2009,ep,4554,4,6,10
Uruguay,2009,ep,5564,2,2,4
Uruguay,2009,ep,65,5,8,13
Uruguay,2009,sn,014,5,11,16
Uruguay,2009,sn,1524,10,11,21
Uruguay,2009,sn,2534,12,26,38
Uruguay,2009,sn,3544,12,19,31
Uruguay,2009,sn,4554,12,22,34
Uruguay,2009,sn,5564,10,15,25
Uruguay,2009,sn,65,10,17,27
Uruguay,2009,sp,014,4,1,5
Uruguay,2009,sp,1524,21,43,64
Uruguay,2009,sp,2534,32,64,96
Uruguay,2009,sp,3544,22,50,72
Uruguay,2009,sp,4554,14,57,71
Uruguay,2009,sp,5564,6,42,48
Uruguay,2009,sp,65,15,38,53
Uruguay,2010,ep,014,4,3,7
Uruguay,2010,ep,1524,4,6,10
Uruguay,2010,ep,2534,8,9,17
Uruguay,2010,ep,3544,2,5,7
Uruguay,2010,ep,4554,5,5,10
Uruguay,2010,ep,5564,3,6,9
Uruguay,2010,ep,65,6,4,10
Uruguay,2010,sn,014,9,12,21
Uruguay,2010,sn,1524,8,4,12
Uruguay,2010,sn,2534,5,11,16
Uruguay,2010,sn,3544,17,15,32
Uruguay,2010,sn,4554,7,19,26
Uruguay,2010,sn,5564,9,7,16
Uruguay,2010,sn,65,16,15,31
Uruguay,2010,sp,014,3,1,4
Uruguay,2010,sp,1524,24,46,70
Uruguay,2010,sp,2534,36,70,106
Uruguay,2010,sp,3544,12,35,47
Uruguay,2010,sp,4554,10,46,56
Uruguay,2010,sp,5564,5,33,38
Uruguay,2010,sp,65,16,31,47
Uruguay,2011,ep,014,3,1,4
Uruguay,2011,ep,1524,2,3,5
Uruguay,2011,ep,2534,3,11,14
Uruguay,2011,ep,3544,1,5,6
Uruguay,2011,ep,4554,5,1,6
Uruguay,2011,ep,5564,1,4,5
Uruguay,2011,ep,65,5,3,8
Uruguay,2011,sn,014,28,17,45
Uruguay,2011,sn,1524,8,19,27
Uruguay,2011,sn,2534,18,31,49
Uruguay,2011,sn,3544,9,28,37
Uruguay,2011,sn,4554,9,17,26
Uruguay,2011,sn,5564,14,20,34
Uruguay,2011,sn,65,12,19,31
Uruguay,2011,sp,014,1,0,1
Uruguay,2011,sp,1524,29,58,87
Uruguay,2011,sp,2534,55,93,148
Uruguay,2011,sp,3544,19,55,74
Uruguay,2011,sp,4554,12,45,57
Uruguay,2011,sp,5564,11,36,47
Uruguay,2011,sp,65,16,37,53
Uruguay,2012,ep,014,1,2,3
Uruguay,2012,ep,1524,2,1,3
Uruguay,2012,ep,2534,5,8,13
Uruguay,2012,ep,3544,3,10,13
Uruguay,2012,ep,4554,5,8,13
Uruguay,2012,ep,5564,3,5,8
Uruguay,2012,ep,65,5,1,6
Uruguay,2012,sn,014,18,22,40
Uruguay,2012,sn,1524,19,20,39
Uruguay,2012,sn,2534,18,28,46
Uruguay,2012,sn,3544,9,30,39
Uruguay,2012,sn,4554,12,30,42
Uruguay,2012,sn,5564,12,13,25
Uruguay,2012,sn,65,16,22,38
Uruguay,2012,sp,014,2,3,5
Uruguay,2012,sp,1524,25,38,63
Uruguay,2012,sp,2534,26,98,124
Uruguay,2012,sp,3544,21,56,77
Uruguay,2012,sp,4554,15,52,67
Uruguay,2012,sp,5564,13,39,52
Uruguay,2012,sp,65,15,29,44
Uruguay,2013,rel,014,30,22,52
Uruguay,2013,rel,1524,35,80,115
Uruguay,2013,rel,2534,71,142,213
Uruguay,2013,rel,3544,44,102,146
Uruguay,2013,rel,4554,31,100,131
Uruguay,2013,rel,5564,40,83,123
Uruguay,2013,rel,65,35,66,101
US Virgin Islands,1995,sp,014,NA,0,NA
US Virgin Islands,1995,sp,1524,NA,0,NA
US Virgin Islands,1995,sp,2534,NA,0,NA
US Virgin Islands,1995,sp,3544,NA,1,NA
US Virgin Islands,1995,sp,4554,NA,1,NA
US Virgin Islands,1995,sp,5564,NA,0,NA
US Virgin Islands,1995,sp,65,NA,0,NA
US Virgin Islands,1996,sp,014,0,0,0
US Virgin Islands,1996,sp,1524,0,0,0
US Virgin Islands,1996,sp,2534,1,1,2
US Virgin Islands,1996,sp,3544,0,1,1
US Virgin Islands,1996,sp,4554,0,0,0
US Virgin Islands,1996,sp,5564,0,1,1
US Virgin Islands,1996,sp,65,1,0,1
Uzbekistan,1996,sp,014,5,2,7
Uzbekistan,1996,sp,1524,87,96,183
Uzbekistan,1996,sp,2534,799,1042,1841
Uzbekistan,1996,sp,3544,324,650,974
Uzbekistan,1996,sp,4554,0,0,0
Uzbekistan,1996,sp,5564,149,196,345
Uzbekistan,1996,sp,65,0,0,0
Uzbekistan,1998,sp,014,0,0,0
Uzbekistan,1998,sp,1524,9,6,15
Uzbekistan,1998,sp,2534,9,5,14
Uzbekistan,1998,sp,3544,4,0,4
Uzbekistan,1998,sp,4554,2,1,3
Uzbekistan,1998,sp,5564,1,1,2
Uzbekistan,1998,sp,65,1,0,1
Uzbekistan,1999,sp,014,11,4,15
Uzbekistan,1999,sp,1524,346,429,775
Uzbekistan,1999,sp,2534,647,926,1573
Uzbekistan,1999,sp,3544,339,519,858
Uzbekistan,1999,sp,4554,186,262,448
Uzbekistan,1999,sp,5564,136,146,282
Uzbekistan,1999,sp,65,124,100,224
Uzbekistan,2000,sp,014,11,6,17
Uzbekistan,2000,sp,1524,261,351,612
Uzbekistan,2000,sp,2534,547,749,1296
Uzbekistan,2000,sp,3544,288,510,798
Uzbekistan,2000,sp,4554,213,346,559
Uzbekistan,2000,sp,5564,112,213,325
Uzbekistan,2000,sp,65,111,107,218
Uzbekistan,2001,sp,014,21,7,28
Uzbekistan,2001,sp,1524,337,390,727
Uzbekistan,2001,sp,2534,631,905,1536
Uzbekistan,2001,sp,3544,338,523,861
Uzbekistan,2001,sp,4554,267,396,663
Uzbekistan,2001,sp,5564,216,253,469
Uzbekistan,2001,sp,65,181,133,314
Uzbekistan,2002,sp,014,18,10,28
Uzbekistan,2002,sp,1524,277,330,607
Uzbekistan,2002,sp,2534,394,481,875
Uzbekistan,2002,sp,3544,214,318,532
Uzbekistan,2002,sp,4554,127,178,305
Uzbekistan,2002,sp,5564,96,87,183
Uzbekistan,2002,sp,65,125,111,236
Uzbekistan,2003,sp,014,29,9,38
Uzbekistan,2003,sp,1524,360,487,847
Uzbekistan,2003,sp,2534,588,828,1416
Uzbekistan,2003,sp,3544,353,595,948
Uzbekistan,2003,sp,4554,210,412,622
Uzbekistan,2003,sp,5564,172,253,425
Uzbekistan,2003,sp,65,174,220,394
Uzbekistan,2004,sp,014,31,23,54
Uzbekistan,2004,sp,1524,430,512,942
Uzbekistan,2004,sp,2534,600,835,1435
Uzbekistan,2004,sp,3544,341,607,948
Uzbekistan,2004,sp,4554,274,502,776
Uzbekistan,2004,sp,5564,211,275,486
Uzbekistan,2004,sp,65,226,252,478
Uzbekistan,2005,sp,014,40,25,65
Uzbekistan,2005,sp,1524,538,596,1134
Uzbekistan,2005,sp,2534,597,831,1428
Uzbekistan,2005,sp,3544,375,723,1098
Uzbekistan,2005,sp,4554,288,522,810
Uzbekistan,2005,sp,5564,217,263,480
Uzbekistan,2005,sp,65,367,313,680
Uzbekistan,2006,ep,014,922,1385,2307
Uzbekistan,2006,ep,1524,351,595,946
Uzbekistan,2006,ep,2534,320,445,765
Uzbekistan,2006,ep,3544,297,316,613
Uzbekistan,2006,ep,4554,211,236,447
Uzbekistan,2006,ep,5564,111,106,217
Uzbekistan,2006,ep,65,144,161,305
Uzbekistan,2006,sn,014,193,273,466
Uzbekistan,2006,sn,1524,575,696,1271
Uzbekistan,2006,sn,2534,659,923,1582
Uzbekistan,2006,sn,3544,501,731,1232
Uzbekistan,2006,sn,4554,387,685,1072
Uzbekistan,2006,sn,5564,284,400,684
Uzbekistan,2006,sn,65,401,493,894
Uzbekistan,2006,sp,014,41,19,60
Uzbekistan,2006,sp,1524,544,568,1112
Uzbekistan,2006,sp,2534,597,807,1404
Uzbekistan,2006,sp,3544,346,717,1063
Uzbekistan,2006,sp,4554,327,565,892
Uzbekistan,2006,sp,5564,224,268,492
Uzbekistan,2006,sp,65,421,329,750
Uzbekistan,2007,ep,014,835,1320,2155
Uzbekistan,2007,ep,1524,307,589,896
Uzbekistan,2007,ep,2534,321,467,788
Uzbekistan,2007,ep,3544,232,301,533
Uzbekistan,2007,ep,4554,189,217,406
Uzbekistan,2007,ep,5564,124,119,243
Uzbekistan,2007,ep,65,122,137,259
Uzbekistan,2007,sn,014,198,187,385
Uzbekistan,2007,sn,1524,516,738,1254
Uzbekistan,2007,sn,2534,649,957,1606
Uzbekistan,2007,sn,3544,428,746,1174
Uzbekistan,2007,sn,4554,391,689,1080
Uzbekistan,2007,sn,5564,294,383,677
Uzbekistan,2007,sn,65,443,548,991
Uzbekistan,2007,sp,014,25,18,43
Uzbekistan,2007,sp,1524,485,569,1054
Uzbekistan,2007,sp,2534,507,768,1275
Uzbekistan,2007,sp,3544,342,579,921
Uzbekistan,2007,sp,4554,255,583,838
Uzbekistan,2007,sp,5564,235,282,517
Uzbekistan,2007,sp,65,436,380,816
Uzbekistan,2008,ep,014,674,1038,1712
Uzbekistan,2008,ep,1524,222,499,721
Uzbekistan,2008,ep,2534,262,378,640
Uzbekistan,2008,ep,3544,194,248,442
Uzbekistan,2008,ep,4554,154,164,318
Uzbekistan,2008,ep,5564,84,91,175
Uzbekistan,2008,ep,65,87,119,206
Uzbekistan,2008,sn,014,139,124,263
Uzbekistan,2008,sn,1524,477,713,1190
Uzbekistan,2008,sn,2534,590,907,1497
Uzbekistan,2008,sn,3544,397,765,1162
Uzbekistan,2008,sn,4554,333,646,979
Uzbekistan,2008,sn,5564,305,361,666
Uzbekistan,2008,sn,65,394,489,883
Uzbekistan,2008,sp,014,23,10,33
Uzbekistan,2008,sp,1524,427,515,942
Uzbekistan,2008,sp,2534,479,688,1167
Uzbekistan,2008,sp,3544,309,572,881
Uzbekistan,2008,sp,4554,273,544,817
Uzbekistan,2008,sp,5564,227,287,514
Uzbekistan,2008,sp,65,394,369,763
Uzbekistan,2009,ep,014,707,1213,1920
Uzbekistan,2009,ep,1524,236,499,735
Uzbekistan,2009,ep,2534,300,411,711
Uzbekistan,2009,ep,3544,224,264,488
Uzbekistan,2009,ep,4554,167,190,357
Uzbekistan,2009,ep,5564,120,129,249
Uzbekistan,2009,ep,65,78,129,207
Uzbekistan,2009,sn,014,141,167,308
Uzbekistan,2009,sn,1524,571,755,1326
Uzbekistan,2009,sn,2534,715,889,1604
Uzbekistan,2009,sn,3544,415,686,1101
Uzbekistan,2009,sn,4554,395,619,1014
Uzbekistan,2009,sn,5564,317,419,736
Uzbekistan,2009,sn,65,411,443,854
Uzbekistan,2009,sp,014,23,12,35
Uzbekistan,2009,sp,1524,429,541,970
Uzbekistan,2009,sp,2534,501,615,1116
Uzbekistan,2009,sp,3544,296,566,862
Uzbekistan,2009,sp,4554,227,513,740
Uzbekistan,2009,sp,5564,241,294,535
Uzbekistan,2009,sp,65,382,319,701
Uzbekistan,2010,ep,014,556,992,1548
Uzbekistan,2010,ep,1524,254,451,705
Uzbekistan,2010,ep,2534,308,393,701
Uzbekistan,2010,ep,3544,195,277,472
Uzbekistan,2010,ep,4554,203,207,410
Uzbekistan,2010,ep,5564,121,127,248
Uzbekistan,2010,ep,65,96,108,204
Uzbekistan,2010,sn,014,145,155,300
Uzbekistan,2010,sn,1524,562,733,1295
Uzbekistan,2010,sn,2534,673,861,1534
Uzbekistan,2010,sn,3544,408,664,1072
Uzbekistan,2010,sn,4554,363,597,960
Uzbekistan,2010,sn,5564,335,399,734
Uzbekistan,2010,sn,65,387,453,840
Uzbekistan,2010,sp,014,22,8,30
Uzbekistan,2010,sp,1524,365,487,852
Uzbekistan,2010,sp,2534,512,574,1086
Uzbekistan,2010,sp,3544,308,529,837
Uzbekistan,2010,sp,4554,248,479,727
Uzbekistan,2010,sp,5564,239,293,532
Uzbekistan,2010,sp,65,350,297,647
Uzbekistan,2011,ep,014,488,836,1324
Uzbekistan,2011,ep,1524,258,381,639
Uzbekistan,2011,ep,2534,267,345,612
Uzbekistan,2011,ep,3544,204,235,439
Uzbekistan,2011,ep,4554,185,173,358
Uzbekistan,2011,ep,5564,129,132,261
Uzbekistan,2011,ep,65,101,105,206
Uzbekistan,2011,sn,014,103,146,249
Uzbekistan,2011,sn,1524,434,594,1028
Uzbekistan,2011,sn,2534,543,739,1282
Uzbekistan,2011,sn,3544,348,625,973
Uzbekistan,2011,sn,4554,327,588,915
Uzbekistan,2011,sn,5564,339,414,753
Uzbekistan,2011,sn,65,333,425,758
Uzbekistan,2011,sp,014,11,8,19
Uzbekistan,2011,sp,1524,335,378,713
Uzbekistan,2011,sp,2534,418,493,911
Uzbekistan,2011,sp,3544,233,453,686
Uzbekistan,2011,sp,4554,245,440,685
Uzbekistan,2011,sp,5564,293,306,599
Uzbekistan,2011,sp,65,332,253,585
Uzbekistan,2012,ep,014,488,833,1321
Uzbekistan,2012,ep,1524,207,415,622
Uzbekistan,2012,ep,2534,289,336,625
Uzbekistan,2012,ep,3544,212,265,477
Uzbekistan,2012,ep,4554,182,243,425
Uzbekistan,2012,ep,5564,134,139,273
Uzbekistan,2012,ep,65,96,126,222
Uzbekistan,2012,sn,014,109,112,221
Uzbekistan,2012,sn,1524,421,572,993
Uzbekistan,2012,sn,2534,572,796,1368
Uzbekistan,2012,sn,3544,353,643,996
Uzbekistan,2012,sn,4554,373,588,961
Uzbekistan,2012,sn,5564,363,423,786
Uzbekistan,2012,sn,65,378,434,812
Uzbekistan,2012,sp,014,9,10,19
Uzbekistan,2012,sp,1524,319,360,679
Uzbekistan,2012,sp,2534,367,506,873
Uzbekistan,2012,sp,3544,237,403,640
Uzbekistan,2012,sp,4554,201,449,650
Uzbekistan,2012,sp,5564,261,313,574
Uzbekistan,2012,sp,65,322,273,595
Uzbekistan,2013,rel,014,766,1194,1960
Uzbekistan,2013,rel,1524,1096,1560,2656
Uzbekistan,2013,rel,2534,1617,2371,3988
Uzbekistan,2013,rel,3544,1338,2587,3925
Uzbekistan,2013,rel,4554,1127,2119,3246
Uzbekistan,2013,rel,5564,1062,1711,2773
Uzbekistan,2013,rel,65,1120,1144,2264
Vanuatu,1995,sp,014,0,0,0
Vanuatu,1995,sp,1524,5,6,11
Vanuatu,1995,sp,2534,0,2,2
Vanuatu,1995,sp,3544,2,5,7
Vanuatu,1995,sp,4554,3,3,6
Vanuatu,1995,sp,5564,0,4,4
Vanuatu,1995,sp,65,0,0,0
Vanuatu,1996,sp,014,2,2,4
Vanuatu,1996,sp,1524,10,4,14
Vanuatu,1996,sp,2534,3,2,5
Vanuatu,1996,sp,3544,5,6,11
Vanuatu,1996,sp,4554,3,4,7
Vanuatu,1996,sp,5564,4,4,8
Vanuatu,1996,sp,65,0,1,1
Vanuatu,1998,sp,014,2,2,4
Vanuatu,1998,sp,1524,5,4,9
Vanuatu,1998,sp,2534,9,5,14
Vanuatu,1998,sp,3544,4,1,5
Vanuatu,1998,sp,4554,1,0,1
Vanuatu,1998,sp,5564,0,2,2
Vanuatu,1998,sp,65,1,2,3
Vanuatu,1999,sp,014,0,0,0
Vanuatu,1999,sp,1524,2,0,2
Vanuatu,1999,sp,2534,10,4,14
Vanuatu,1999,sp,3544,4,1,5
Vanuatu,1999,sp,4554,1,2,3
Vanuatu,1999,sp,5564,0,0,0
Vanuatu,1999,sp,65,0,0,0
Vanuatu,2000,sp,014,5,2,7
Vanuatu,2000,sp,1524,3,7,10
Vanuatu,2000,sp,2534,15,5,20
Vanuatu,2000,sp,3544,7,1,8
Vanuatu,2000,sp,4554,3,10,13
Vanuatu,2000,sp,5564,3,5,8
Vanuatu,2000,sp,65,1,2,3
Vanuatu,2001,sp,014,1,1,2
Vanuatu,2001,sp,1524,10,7,17
Vanuatu,2001,sp,2534,4,5,9
Vanuatu,2001,sp,3544,3,4,7
Vanuatu,2001,sp,4554,2,8,10
Vanuatu,2001,sp,5564,1,6,7
Vanuatu,2001,sp,65,4,1,5
Vanuatu,2002,sp,014,0,0,0
Vanuatu,2002,sp,1524,3,7,10
Vanuatu,2002,sp,2534,1,2,3
Vanuatu,2002,sp,3544,5,3,8
Vanuatu,2002,sp,4554,0,10,10
Vanuatu,2002,sp,5564,3,2,5
Vanuatu,2002,sp,65,1,1,2
Vanuatu,2003,sp,014,0,1,1
Vanuatu,2003,sp,1524,4,2,6
Vanuatu,2003,sp,2534,4,4,8
Vanuatu,2003,sp,3544,3,7,10
Vanuatu,2003,sp,4554,2,5,7
Vanuatu,2003,sp,5564,1,2,3
Vanuatu,2003,sp,65,2,3,5
Vanuatu,2004,sp,014,3,1,4
Vanuatu,2004,sp,1524,5,7,12
Vanuatu,2004,sp,2534,8,11,19
Vanuatu,2004,sp,3544,2,2,4
Vanuatu,2004,sp,4554,2,6,8
Vanuatu,2004,sp,5564,2,3,5
Vanuatu,2004,sp,65,2,5,7
Vanuatu,2005,sp,014,0,1,1
Vanuatu,2005,sp,1524,5,4,9
Vanuatu,2005,sp,2534,1,5,6
Vanuatu,2005,sp,3544,2,5,7
Vanuatu,2005,sp,4554,4,0,4
Vanuatu,2005,sp,5564,1,4,5
Vanuatu,2005,sp,65,2,1,3
Vanuatu,2006,sp,014,2,1,3
Vanuatu,2006,sp,1524,7,5,12
Vanuatu,2006,sp,2534,9,3,12
Vanuatu,2006,sp,3544,2,1,3
Vanuatu,2006,sp,4554,4,4,8
Vanuatu,2006,sp,5564,0,4,4
Vanuatu,2006,sp,65,0,0,0
Vanuatu,2007,ep,014,0,0,0
Vanuatu,2007,ep,1524,0,0,0
Vanuatu,2007,ep,2534,0,0,0
Vanuatu,2007,ep,3544,0,0,0
Vanuatu,2007,ep,4554,0,0,0
Vanuatu,2007,ep,5564,0,0,0
Vanuatu,2007,ep,65,0,0,0
Vanuatu,2007,sn,014,0,0,0
Vanuatu,2007,sn,1524,0,0,0
Vanuatu,2007,sn,2534,0,0,0
Vanuatu,2007,sn,3544,0,0,0
Vanuatu,2007,sn,4554,0,0,0
Vanuatu,2007,sn,5564,0,0,0
Vanuatu,2007,sn,65,0,0,0
Vanuatu,2007,sp,014,1,1,2
Vanuatu,2007,sp,1524,6,3,9
Vanuatu,2007,sp,2534,8,2,10
Vanuatu,2007,sp,3544,1,4,5
Vanuatu,2007,sp,4554,6,2,8
Vanuatu,2007,sp,5564,1,2,3
Vanuatu,2007,sp,65,2,2,4
Vanuatu,2008,sp,1524,3,4,7
Vanuatu,2008,sp,2534,4,4,8
Vanuatu,2008,sp,3544,1,3,4
Vanuatu,2008,sp,4554,3,5,8
Vanuatu,2008,sp,5564,5,4,9
Vanuatu,2008,sp,65,1,3,4
Vanuatu,2009,ep,014,14,16,30
Vanuatu,2009,ep,1524,2,6,8
Vanuatu,2009,ep,2534,3,6,9
Vanuatu,2009,ep,3544,3,1,4
Vanuatu,2009,ep,4554,2,6,8
Vanuatu,2009,ep,5564,1,1,2
Vanuatu,2009,ep,65,0,1,1
Vanuatu,2009,sn,014,2,2,4
Vanuatu,2009,sn,1524,1,0,1
Vanuatu,2009,sn,2534,0,1,1
Vanuatu,2009,sn,3544,1,2,3
Vanuatu,2009,sn,4554,3,3,6
Vanuatu,2009,sn,5564,4,3,7
Vanuatu,2009,sn,65,1,2,3
Vanuatu,2009,sp,014,2,0,2
Vanuatu,2009,sp,1524,3,6,9
Vanuatu,2009,sp,2534,5,3,8
Vanuatu,2009,sp,3544,3,3,6
Vanuatu,2009,sp,4554,5,1,6
Vanuatu,2009,sp,5564,4,3,7
Vanuatu,2009,sp,65,1,2,3
Vanuatu,2010,ep,014,4,11,15
Vanuatu,2010,ep,1524,2,1,3
Vanuatu,2010,ep,2534,2,0,2
Vanuatu,2010,ep,3544,2,4,6
Vanuatu,2010,ep,4554,3,2,5
Vanuatu,2010,ep,5564,1,1,2
Vanuatu,2010,ep,65,0,2,2
Vanuatu,2010,sn,014,3,2,5
Vanuatu,2010,sn,1524,1,0,1
Vanuatu,2010,sn,2534,0,6,6
Vanuatu,2010,sn,3544,1,0,1
Vanuatu,2010,sn,4554,2,5,7
Vanuatu,2010,sn,5564,2,6,8
Vanuatu,2010,sn,65,3,2,5
Vanuatu,2010,sp,014,3,4,7
Vanuatu,2010,sp,1524,5,6,11
Vanuatu,2010,sp,2534,3,3,6
Vanuatu,2010,sp,3544,3,1,4
Vanuatu,2010,sp,4554,5,5,10
Vanuatu,2010,sp,5564,3,2,5
Vanuatu,2010,sp,65,1,0,1
Vanuatu,2011,ep,014,6,10,16
Vanuatu,2011,ep,1524,2,3,5
Vanuatu,2011,ep,2534,2,3,5
Vanuatu,2011,ep,3544,3,6,9
Vanuatu,2011,ep,4554,2,2,4
Vanuatu,2011,ep,5564,2,1,3
Vanuatu,2011,ep,65,1,3,4
Vanuatu,2011,sn,014,0,0,0
Vanuatu,2011,sn,1524,2,1,3
Vanuatu,2011,sn,2534,0,2,2
Vanuatu,2011,sn,3544,1,0,1
Vanuatu,2011,sn,4554,0,2,2
Vanuatu,2011,sn,5564,0,3,3
Vanuatu,2011,sn,65,2,1,3
Vanuatu,2011,sp,014,0,2,2
Vanuatu,2011,sp,1524,5,3,8
Vanuatu,2011,sp,2534,7,4,11
Vanuatu,2011,sp,3544,5,6,11
Vanuatu,2011,sp,4554,4,5,9
Vanuatu,2011,sp,5564,2,4,6
Vanuatu,2011,sp,65,0,2,2
Vanuatu,2012,ep,014,9,10,19
Vanuatu,2012,ep,1524,5,4,9
Vanuatu,2012,ep,2534,2,8,10
Vanuatu,2012,ep,3544,0,4,4
Vanuatu,2012,ep,4554,2,4,6
Vanuatu,2012,ep,5564,1,1,2
Vanuatu,2012,ep,65,0,1,1
Vanuatu,2012,sn,014,3,3,6
Vanuatu,2012,sn,1524,3,1,4
Vanuatu,2012,sn,2534,3,2,5
Vanuatu,2012,sn,3544,3,2,5
Vanuatu,2012,sn,4554,0,0,0
Vanuatu,2012,sn,5564,1,0,1
Vanuatu,2012,sn,65,0,1,1
Vanuatu,2012,sp,014,3,0,3
Vanuatu,2012,sp,1524,12,4,16
Vanuatu,2012,sp,2534,5,3,8
Vanuatu,2012,sp,3544,5,4,9
Vanuatu,2012,sp,4554,4,2,6
Vanuatu,2012,sp,5564,2,2,4
Vanuatu,2012,sp,65,3,2,5
Vanuatu,2013,rel,014,17,7,24
Vanuatu,2013,rel,1524,10,8,18
Vanuatu,2013,rel,2534,12,9,21
Vanuatu,2013,rel,3544,3,7,10
Vanuatu,2013,rel,4554,5,11,16
Vanuatu,2013,rel,5564,11,13,24
Vanuatu,2013,rel,65,7,3,10
Venezuela (Bolivarian Republic of),1999,sp,014,28,32,60
Venezuela (Bolivarian Republic of),1999,sp,1524,283,378,661
Venezuela (Bolivarian Republic of),1999,sp,2534,315,452,767
Venezuela (Bolivarian Republic of),1999,sp,3544,195,420,615
Venezuela (Bolivarian Republic of),1999,sp,4554,169,368,537
Venezuela (Bolivarian Republic of),1999,sp,5564,134,283,417
Venezuela (Bolivarian Republic of),1999,sp,65,267,346,613
Venezuela (Bolivarian Republic of),2002,sp,014,42,19,61
Venezuela (Bolivarian Republic of),2002,sp,1524,274,339,613
Venezuela (Bolivarian Republic of),2002,sp,2534,280,429,709
Venezuela (Bolivarian Republic of),2002,sp,3544,218,425,643
Venezuela (Bolivarian Republic of),2002,sp,4554,158,380,538
Venezuela (Bolivarian Republic of),2002,sp,5564,123,246,369
Venezuela (Bolivarian Republic of),2002,sp,65,198,313,511
Venezuela (Bolivarian Republic of),2003,sp,014,46,39,85
Venezuela (Bolivarian Republic of),2003,sp,1524,340,361,701
Venezuela (Bolivarian Republic of),2003,sp,2534,355,459,814
Venezuela (Bolivarian Republic of),2003,sp,3544,240,453,693
Venezuela (Bolivarian Republic of),2003,sp,4554,204,405,609
Venezuela (Bolivarian Republic of),2003,sp,5564,140,284,424
Venezuela (Bolivarian Republic of),2003,sp,65,240,316,556
Venezuela (Bolivarian Republic of),2004,sp,014,36,24,60
Venezuela (Bolivarian Republic of),2004,sp,1524,311,373,684
Venezuela (Bolivarian Republic of),2004,sp,2534,324,454,778
Venezuela (Bolivarian Republic of),2004,sp,3544,239,459,698
Venezuela (Bolivarian Republic of),2004,sp,4554,184,407,591
Venezuela (Bolivarian Republic of),2004,sp,5564,135,272,407
Venezuela (Bolivarian Republic of),2004,sp,65,242,316,558
Venezuela (Bolivarian Republic of),2005,sp,014,37,35,72
Venezuela (Bolivarian Republic of),2005,sp,1524,351,312,663
Venezuela (Bolivarian Republic of),2005,sp,2534,299,395,694
Venezuela (Bolivarian Republic of),2005,sp,3544,267,413,680
Venezuela (Bolivarian Republic of),2005,sp,4554,183,402,585
Venezuela (Bolivarian Republic of),2005,sp,5564,146,265,411
Venezuela (Bolivarian Republic of),2005,sp,65,216,332,548
Venezuela (Bolivarian Republic of),2006,ep,014,68,65,133
Venezuela (Bolivarian Republic of),2006,ep,1524,75,125,200
Venezuela (Bolivarian Republic of),2006,ep,2534,85,127,212
Venezuela (Bolivarian Republic of),2006,ep,3544,84,122,206
Venezuela (Bolivarian Republic of),2006,ep,4554,60,84,144
Venezuela (Bolivarian Republic of),2006,ep,5564,40,69,109
Venezuela (Bolivarian Republic of),2006,ep,65,69,84,153
Venezuela (Bolivarian Republic of),2006,sn,014,229,213,442
Venezuela (Bolivarian Republic of),2006,sn,1524,87,105,192
Venezuela (Bolivarian Republic of),2006,sn,2534,103,112,215
Venezuela (Bolivarian Republic of),2006,sn,3544,56,140,196
Venezuela (Bolivarian Republic of),2006,sn,4554,71,119,190
Venezuela (Bolivarian Republic of),2006,sn,5564,83,126,209
Venezuela (Bolivarian Republic of),2006,sn,65,120,180,300
Venezuela (Bolivarian Republic of),2006,sp,014,42,10,52
Venezuela (Bolivarian Republic of),2006,sp,1524,322,323,645
Venezuela (Bolivarian Republic of),2006,sp,2534,297,405,702
Venezuela (Bolivarian Republic of),2006,sp,3544,188,413,601
Venezuela (Bolivarian Republic of),2006,sp,4554,173,422,595
Venezuela (Bolivarian Republic of),2006,sp,5564,140,267,407
Venezuela (Bolivarian Republic of),2006,sp,65,225,320,545
Venezuela (Bolivarian Republic of),2007,ep,014,65,74,139
Venezuela (Bolivarian Republic of),2007,ep,1524,94,111,205
Venezuela (Bolivarian Republic of),2007,ep,2534,84,127,211
Venezuela (Bolivarian Republic of),2007,ep,3544,82,98,180
Venezuela (Bolivarian Republic of),2007,ep,4554,73,93,166
Venezuela (Bolivarian Republic of),2007,ep,5564,48,61,109
Venezuela (Bolivarian Republic of),2007,ep,65,58,80,138
Venezuela (Bolivarian Republic of),2007,sn,014,177,210,387
Venezuela (Bolivarian Republic of),2007,sn,1524,81,86,167
Venezuela (Bolivarian Republic of),2007,sn,2534,85,124,209
Venezuela (Bolivarian Republic of),2007,sn,3544,74,97,171
Venezuela (Bolivarian Republic of),2007,sn,4554,78,126,204
Venezuela (Bolivarian Republic of),2007,sn,5564,57,91,148
Venezuela (Bolivarian Republic of),2007,sn,65,101,148,249
Venezuela (Bolivarian Republic of),2007,sp,014,40,17,57
Venezuela (Bolivarian Republic of),2007,sp,1524,276,324,600
Venezuela (Bolivarian Republic of),2007,sp,2534,271,382,653
Venezuela (Bolivarian Republic of),2007,sp,3544,199,390,589
Venezuela (Bolivarian Republic of),2007,sp,4554,160,389,549
Venezuela (Bolivarian Republic of),2007,sp,5564,147,272,419
Venezuela (Bolivarian Republic of),2007,sp,65,230,295,525
Venezuela (Bolivarian Republic of),2008,ep,014,64,49,113
Venezuela (Bolivarian Republic of),2008,ep,1524,80,117,197
Venezuela (Bolivarian Republic of),2008,ep,2534,92,127,219
Venezuela (Bolivarian Republic of),2008,ep,3544,80,93,173
Venezuela (Bolivarian Republic of),2008,ep,4554,58,94,152
Venezuela (Bolivarian Republic of),2008,ep,5564,57,60,117
Venezuela (Bolivarian Republic of),2008,ep,65,59,86,145
Venezuela (Bolivarian Republic of),2008,sn,014,172,149,321
Venezuela (Bolivarian Republic of),2008,sn,1524,73,123,196
Venezuela (Bolivarian Republic of),2008,sn,2534,96,144,240
Venezuela (Bolivarian Republic of),2008,sn,3544,65,135,200
Venezuela (Bolivarian Republic of),2008,sn,4554,70,144,214
Venezuela (Bolivarian Republic of),2008,sn,5564,66,98,164
Venezuela (Bolivarian Republic of),2008,sn,65,104,160,264
Venezuela (Bolivarian Republic of),2008,sp,014,25,18,43
Venezuela (Bolivarian Republic of),2008,sp,1524,309,364,673
Venezuela (Bolivarian Republic of),2008,sp,2534,272,358,630
Venezuela (Bolivarian Republic of),2008,sp,3544,228,326,554
Venezuela (Bolivarian Republic of),2008,sp,4554,171,389,560
Venezuela (Bolivarian Republic of),2008,sp,5564,146,271,417
Venezuela (Bolivarian Republic of),2008,sp,65,182,285,467
Venezuela (Bolivarian Republic of),2009,ep,014,53,54,107
Venezuela (Bolivarian Republic of),2009,ep,1524,74,98,172
Venezuela (Bolivarian Republic of),2009,ep,2534,92,133,225
Venezuela (Bolivarian Republic of),2009,ep,3544,77,119,196
Venezuela (Bolivarian Republic of),2009,ep,4554,57,97,154
Venezuela (Bolivarian Republic of),2009,ep,5564,45,71,116
Venezuela (Bolivarian Republic of),2009,ep,65,51,91,142
Venezuela (Bolivarian Republic of),2009,sn,014,161,159,320
Venezuela (Bolivarian Republic of),2009,sn,1524,94,114,208
Venezuela (Bolivarian Republic of),2009,sn,2534,116,146,262
Venezuela (Bolivarian Republic of),2009,sn,3544,75,140,215
Venezuela (Bolivarian Republic of),2009,sn,4554,91,136,227
Venezuela (Bolivarian Republic of),2009,sn,5564,70,111,181
Venezuela (Bolivarian Republic of),2009,sn,65,127,125,252
Venezuela (Bolivarian Republic of),2009,sp,014,33,26,59
Venezuela (Bolivarian Republic of),2009,sp,1524,284,372,656
Venezuela (Bolivarian Republic of),2009,sp,2534,312,385,697
Venezuela (Bolivarian Republic of),2009,sp,3544,217,344,561
Venezuela (Bolivarian Republic of),2009,sp,4554,212,352,564
Venezuela (Bolivarian Republic of),2009,sp,5564,162,258,420
Venezuela (Bolivarian Republic of),2009,sp,65,181,298,479
Venezuela (Bolivarian Republic of),2010,ep,014,64,58,122
Venezuela (Bolivarian Republic of),2010,ep,1524,75,92,167
Venezuela (Bolivarian Republic of),2010,ep,2534,83,112,195
Venezuela (Bolivarian Republic of),2010,ep,3544,80,111,191
Venezuela (Bolivarian Republic of),2010,ep,4554,71,84,155
Venezuela (Bolivarian Republic of),2010,ep,5564,49,69,118
Venezuela (Bolivarian Republic of),2010,ep,65,57,72,129
Venezuela (Bolivarian Republic of),2010,sn,014,160,160,320
Venezuela (Bolivarian Republic of),2010,sn,1524,101,108,209
Venezuela (Bolivarian Republic of),2010,sn,2534,122,154,276
Venezuela (Bolivarian Republic of),2010,sn,3544,81,119,200
Venezuela (Bolivarian Republic of),2010,sn,4554,83,142,225
Venezuela (Bolivarian Republic of),2010,sn,5564,69,127,196
Venezuela (Bolivarian Republic of),2010,sn,65,139,193,332
Venezuela (Bolivarian Republic of),2010,sp,014,26,22,48
Venezuela (Bolivarian Republic of),2010,sp,1524,269,320,589
Venezuela (Bolivarian Republic of),2010,sp,2534,306,376,682
Venezuela (Bolivarian Republic of),2010,sp,3544,188,333,521
Venezuela (Bolivarian Republic of),2010,sp,4554,145,391,536
Venezuela (Bolivarian Republic of),2010,sp,5564,147,253,400
Venezuela (Bolivarian Republic of),2010,sp,65,188,288,476
Venezuela (Bolivarian Republic of),2011,ep,014,44,66,110
Venezuela (Bolivarian Republic of),2011,ep,1524,85,117,202
Venezuela (Bolivarian Republic of),2011,ep,2534,97,148,245
Venezuela (Bolivarian Republic of),2011,ep,3544,80,112,192
Venezuela (Bolivarian Republic of),2011,ep,4554,61,107,168
Venezuela (Bolivarian Republic of),2011,ep,5564,57,90,147
Venezuela (Bolivarian Republic of),2011,ep,65,46,86,132
Venezuela (Bolivarian Republic of),2011,sn,014,152,180,332
Venezuela (Bolivarian Republic of),2011,sn,1524,93,128,221
Venezuela (Bolivarian Republic of),2011,sn,2534,104,137,241
Venezuela (Bolivarian Republic of),2011,sn,3544,79,131,210
Venezuela (Bolivarian Republic of),2011,sn,4554,76,147,223
Venezuela (Bolivarian Republic of),2011,sn,5564,75,108,183
Venezuela (Bolivarian Republic of),2011,sn,65,100,139,239
Venezuela (Bolivarian Republic of),2011,sp,014,25,28,53
Venezuela (Bolivarian Republic of),2011,sp,1524,252,340,592
Venezuela (Bolivarian Republic of),2011,sp,2534,316,353,669
Venezuela (Bolivarian Republic of),2011,sp,3544,178,303,481
Venezuela (Bolivarian Republic of),2011,sp,4554,178,363,541
Venezuela (Bolivarian Republic of),2011,sp,5564,150,307,457
Venezuela (Bolivarian Republic of),2011,sp,65,190,241,431
Venezuela (Bolivarian Republic of),2012,ep,014,64,76,140
Venezuela (Bolivarian Republic of),2012,ep,1524,82,113,195
Venezuela (Bolivarian Republic of),2012,ep,2534,89,129,218
Venezuela (Bolivarian Republic of),2012,ep,3544,88,105,193
Venezuela (Bolivarian Republic of),2012,ep,4554,60,84,144
Venezuela (Bolivarian Republic of),2012,ep,5564,43,74,117
Venezuela (Bolivarian Republic of),2012,ep,65,65,71,136
Venezuela (Bolivarian Republic of),2012,sn,014,157,152,309
Venezuela (Bolivarian Republic of),2012,sn,1524,97,111,208
Venezuela (Bolivarian Republic of),2012,sn,2534,101,133,234
Venezuela (Bolivarian Republic of),2012,sn,3544,84,117,201
Venezuela (Bolivarian Republic of),2012,sn,4554,106,142,248
Venezuela (Bolivarian Republic of),2012,sn,5564,82,104,186
Venezuela (Bolivarian Republic of),2012,sn,65,104,127,231
Venezuela (Bolivarian Republic of),2012,sp,014,32,23,55
Venezuela (Bolivarian Republic of),2012,sp,1524,276,379,655
Venezuela (Bolivarian Republic of),2012,sp,2534,281,405,686
Venezuela (Bolivarian Republic of),2012,sp,3544,203,353,556
Venezuela (Bolivarian Republic of),2012,sp,4554,167,375,542
Venezuela (Bolivarian Republic of),2012,sp,5564,161,319,480
Venezuela (Bolivarian Republic of),2012,sp,65,199,273,472
Venezuela (Bolivarian Republic of),2013,rel,014,229,232,461
Venezuela (Bolivarian Republic of),2013,rel,1524,465,631,1096
Venezuela (Bolivarian Republic of),2013,rel,2534,537,739,1276
Venezuela (Bolivarian Republic of),2013,rel,3544,354,582,936
Venezuela (Bolivarian Republic of),2013,rel,4554,407,635,1042
Venezuela (Bolivarian Republic of),2013,rel,5564,283,536,819
Venezuela (Bolivarian Republic of),2013,rel,65,402,523,925
Viet Nam,1996,sp,014,91,92,183
Viet Nam,1996,sp,1524,1127,1994,3121
Viet Nam,1996,sp,2534,2606,5716,8322
Viet Nam,1996,sp,3544,3045,7137,10182
Viet Nam,1996,sp,4554,2504,5170,7674
Viet Nam,1996,sp,5564,3360,5839,9199
Viet Nam,1996,sp,65,3938,6292,10230
Viet Nam,1997,sp,014,73,103,176
Viet Nam,1997,sp,1524,1163,2162,3325
Viet Nam,1997,sp,2534,2809,6427,9236
Viet Nam,1997,sp,3544,3302,8363,11665
Viet Nam,1997,sp,4554,2590,5820,8410
Viet Nam,1997,sp,5564,3614,5892,9506
Viet Nam,1997,sp,65,4340,6989,11329
Viet Nam,1998,sp,014,60,56,116
Viet Nam,1998,sp,1524,1344,2441,3785
Viet Nam,1998,sp,2534,2749,6567,9316
Viet Nam,1998,sp,3544,3102,8765,11867
Viet Nam,1998,sp,4554,2576,6143,8719
Viet Nam,1998,sp,5564,3296,5925,9221
Viet Nam,1998,sp,65,4575,7274,11849
Viet Nam,1999,sp,014,68,58,126
Viet Nam,1999,sp,1524,1361,2254,3615
Viet Nam,1999,sp,2534,2511,6355,8866
Viet Nam,1999,sp,3544,3029,8392,11421
Viet Nam,1999,sp,4554,2549,6465,9014
Viet Nam,1999,sp,5564,3034,5530,8564
Viet Nam,1999,sp,65,4828,7371,12199
Viet Nam,2000,sp,014,64,51,115
Viet Nam,2000,sp,1524,1334,2367,3701
Viet Nam,2000,sp,2534,2320,6147,8467
Viet Nam,2000,sp,3544,2754,8209,10963
Viet Nam,2000,sp,4554,2594,6713,9307
Viet Nam,2000,sp,5564,2847,5150,7997
Viet Nam,2000,sp,65,4907,7712,12619
Viet Nam,2001,sp,014,48,39,87
Viet Nam,2001,sp,1524,1390,2756,4146
Viet Nam,2001,sp,2534,2357,6319,8676
Viet Nam,2001,sp,3544,2656,8457,11113
Viet Nam,2001,sp,4554,2574,7054,9628
Viet Nam,2001,sp,5564,2530,5205,7735
Viet Nam,2001,sp,65,5174,7643,12817
Viet Nam,2002,sp,014,68,57,125
Viet Nam,2002,sp,1524,1571,3250,4821
Viet Nam,2002,sp,2534,2357,6762,9119
Viet Nam,2002,sp,3544,2508,8855,11363
Viet Nam,2002,sp,4554,2619,8040,10659
Viet Nam,2002,sp,5564,2409,5162,7571
Viet Nam,2002,sp,65,4969,8184,13153
Viet Nam,2003,sp,014,66,49,115
Viet Nam,2003,sp,1524,1659,3475,5134
Viet Nam,2003,sp,2534,2262,7036,9298
Viet Nam,2003,sp,3544,2327,8486,10813
Viet Nam,2003,sp,4554,2574,7965,10539
Viet Nam,2003,sp,5564,2283,5066,7349
Viet Nam,2003,sp,65,4896,7793,12689
Viet Nam,2004,sp,014,66,54,120
Viet Nam,2004,sp,1524,1740,3486,5226
Viet Nam,2004,sp,2534,2398,7364,9762
Viet Nam,2004,sp,3544,2218,9110,11328
Viet Nam,2004,sp,4554,2551,8743,11294
Viet Nam,2004,sp,5564,2226,5257,7483
Viet Nam,2004,sp,65,4970,8206,13176
Viet Nam,2005,sp,014,47,54,101
Viet Nam,2005,sp,1524,1747,3408,5155
Viet Nam,2005,sp,2534,2293,7105,9398
Viet Nam,2005,sp,3544,2116,8738,10854
Viet Nam,2005,sp,4554,2298,8606,10904
Viet Nam,2005,sp,5564,2023,4958,6981
Viet Nam,2005,sp,65,4604,7573,12177
Viet Nam,2006,sp,014,62,49,111
Viet Nam,2006,sp,1524,1827,3761,5588
Viet Nam,2006,sp,2534,2381,7549,9930
Viet Nam,2006,sp,3544,2036,8931,10967
Viet Nam,2006,sp,4554,2283,8717,11000
Viet Nam,2006,sp,5564,1996,5037,7033
Viet Nam,2006,sp,65,4400,7408,11808
Viet Nam,2007,sp,014,59,48,107
Viet Nam,2007,sp,1524,1939,3587,5526
Viet Nam,2007,sp,2534,2354,7431,9785
Viet Nam,2007,sp,3544,1923,8391,10314
Viet Nam,2007,sp,4554,2170,8451,10621
Viet Nam,2007,sp,5564,1891,5046,6937
Viet Nam,2007,sp,65,4144,7026,11170
Viet Nam,2008,sp,014,48,36,84
Viet Nam,2008,sp,1524,1993,3401,5394
Viet Nam,2008,sp,2534,2416,7148,9564
Viet Nam,2008,sp,3544,1820,8230,10050
Viet Nam,2008,sp,4554,2087,8811,10898
Viet Nam,2008,sp,5564,1858,5158,7016
Viet Nam,2008,sp,65,3811,6667,10478
Viet Nam,2009,sp,014,47,41,88
Viet Nam,2009,sp,1524,1895,3122,5017
Viet Nam,2009,sp,2534,2401,7152,9553
Viet Nam,2009,sp,3544,1677,7731,9408
Viet Nam,2009,sp,4554,1989,8333,10322
Viet Nam,2009,sp,5564,1849,5494,7343
Viet Nam,2009,sp,65,3397,6162,9559
Viet Nam,2010,sp,014,53,59,112
Viet Nam,2010,sp,1524,1870,3205,5075
Viet Nam,2010,sp,2534,2454,7036,9490
Viet Nam,2010,sp,3544,1681,7851,9532
Viet Nam,2010,sp,4554,1864,8564,10428
Viet Nam,2010,sp,5564,1863,5790,7653
Viet Nam,2010,sp,65,3751,6248,9999
Viet Nam,2011,sp,014,64,61,125
Viet Nam,2011,sp,1524,1863,3099,4962
Viet Nam,2011,sp,2534,2325,6677,9002
Viet Nam,2011,sp,3544,1681,7763,9444
Viet Nam,2011,sp,4554,1814,8474,10288
Viet Nam,2011,sp,5564,1878,6107,7985
Viet Nam,2011,sp,65,3124,5821,8945
Viet Nam,2012,sp,014,84,58,142
Viet Nam,2012,sp,1524,1841,2993,4834
Viet Nam,2012,sp,2534,2481,6689,9170
Viet Nam,2012,sp,3544,1626,7680,9306
Viet Nam,2012,sp,4554,1683,8481,10164
Viet Nam,2012,sp,5564,1884,6315,8199
Viet Nam,2012,sp,65,3298,5920,9218
Viet Nam,2013,rel,014,78,65,143
Viet Nam,2013,rel,1524,1916,2951,4867
Viet Nam,2013,rel,2534,2487,6302,8789
Viet Nam,2013,rel,3544,1671,7487,9158
Viet Nam,2013,rel,4554,1715,8553,10268
Viet Nam,2013,rel,5564,1954,6484,8438
Viet Nam,2013,rel,65,3110,5834,8944
Wallis and Futuna Islands,1996,sp,014,0,0,0
Wallis and Futuna Islands,1996,sp,1524,1,1,2
Wallis and Futuna Islands,1996,sp,2534,3,1,4
Wallis and Futuna Islands,1996,sp,3544,1,0,1
Wallis and Futuna Islands,1996,sp,4554,1,0,1
Wallis and Futuna Islands,1996,sp,5564,0,0,0
Wallis and Futuna Islands,1996,sp,65,0,0,0
Wallis and Futuna Islands,1997,sp,014,0,NA,NA
Wallis and Futuna Islands,1997,sp,1524,0,NA,NA
Wallis and Futuna Islands,1997,sp,2534,0,NA,NA
Wallis and Futuna Islands,1997,sp,3544,0,NA,NA
Wallis and Futuna Islands,1997,sp,4554,0,NA,NA
Wallis and Futuna Islands,1997,sp,5564,0,NA,NA
Wallis and Futuna Islands,1997,sp,65,1,NA,NA
Wallis and Futuna Islands,2002,sp,1524,NA,1,NA
Wallis and Futuna Islands,2002,sp,3544,NA,1,NA
Wallis and Futuna Islands,2002,sp,4554,3,1,4
Wallis and Futuna Islands,2002,sp,5564,2,NA,NA
Wallis and Futuna Islands,2002,sp,65,1,1,2
Wallis and Futuna Islands,2003,sp,014,0,0,0
Wallis and Futuna Islands,2003,sp,1524,0,0,0
Wallis and Futuna Islands,2003,sp,2534,1,2,3
Wallis and Futuna Islands,2003,sp,3544,0,2,2
Wallis and Futuna Islands,2003,sp,4554,0,2,2
Wallis and Futuna Islands,2003,sp,5564,0,0,0
Wallis and Futuna Islands,2003,sp,65,0,0,0
Wallis and Futuna Islands,2007,ep,014,0,0,0
Wallis and Futuna Islands,2007,ep,1524,0,0,0
Wallis and Futuna Islands,2007,ep,2534,0,0,0
Wallis and Futuna Islands,2007,ep,3544,0,0,0
Wallis and Futuna Islands,2007,ep,4554,0,0,0
Wallis and Futuna Islands,2007,ep,5564,0,0,0
Wallis and Futuna Islands,2007,ep,65,0,0,0
Wallis and Futuna Islands,2007,sn,014,0,0,0
Wallis and Futuna Islands,2007,sn,1524,0,0,0
Wallis and Futuna Islands,2007,sn,2534,0,0,0
Wallis and Futuna Islands,2007,sn,3544,0,0,0
Wallis and Futuna Islands,2007,sn,4554,1,0,1
Wallis and Futuna Islands,2007,sn,5564,0,0,0
Wallis and Futuna Islands,2007,sn,65,0,0,0
Wallis and Futuna Islands,2007,sp,014,0,0,0
Wallis and Futuna Islands,2007,sp,1524,0,0,0
Wallis and Futuna Islands,2007,sp,2534,0,0,0
Wallis and Futuna Islands,2007,sp,3544,0,0,0
Wallis and Futuna Islands,2007,sp,4554,0,1,1
Wallis and Futuna Islands,2007,sp,5564,0,0,0
Wallis and Futuna Islands,2007,sp,65,0,0,0
Wallis and Futuna Islands,2009,ep,014,0,0,0
Wallis and Futuna Islands,2009,ep,1524,0,0,0
Wallis and Futuna Islands,2009,ep,2534,0,0,0
Wallis and Futuna Islands,2009,ep,3544,0,0,0
Wallis and Futuna Islands,2009,ep,4554,0,0,0
Wallis and Futuna Islands,2009,ep,5564,0,0,0
Wallis and Futuna Islands,2009,ep,65,0,0,0
Wallis and Futuna Islands,2009,sp,1524,1,NA,NA
Wallis and Futuna Islands,2009,sp,2534,NA,1,NA
Wallis and Futuna Islands,2009,sp,65,NA,1,NA
Wallis and Futuna Islands,2011,sn,014,1,NA,NA
Wallis and Futuna Islands,2011,sn,3544,NA,2,NA
Wallis and Futuna Islands,2011,sn,4554,NA,1,NA
Wallis and Futuna Islands,2011,sn,5564,1,1,2
Wallis and Futuna Islands,2011,sp,5564,NA,2,NA
Wallis and Futuna Islands,2013,rel,65,2,NA,NA
West Bank and Gaza Strip,1995,sp,014,0,1,1
West Bank and Gaza Strip,1995,sp,1524,1,2,3
West Bank and Gaza Strip,1995,sp,2534,0,0,0
West Bank and Gaza Strip,1995,sp,3544,0,0,0
West Bank and Gaza Strip,1995,sp,4554,1,1,2
West Bank and Gaza Strip,1995,sp,5564,0,0,0
West Bank and Gaza Strip,1995,sp,65,0,3,3
West Bank and Gaza Strip,1996,sp,014,1,0,1
West Bank and Gaza Strip,1996,sp,1524,2,2,4
West Bank and Gaza Strip,1996,sp,2534,1,2,3
West Bank and Gaza Strip,1996,sp,3544,2,2,4
West Bank and Gaza Strip,1996,sp,4554,0,2,2
West Bank and Gaza Strip,1996,sp,5564,3,2,5
West Bank and Gaza Strip,1996,sp,65,1,4,5
West Bank and Gaza Strip,1998,sp,1524,NA,1,NA
West Bank and Gaza Strip,1998,sp,2534,NA,1,NA
West Bank and Gaza Strip,1998,sp,3544,1,NA,NA
West Bank and Gaza Strip,1998,sp,4554,NA,2,NA
West Bank and Gaza Strip,1998,sp,5564,1,NA,NA
West Bank and Gaza Strip,1998,sp,65,1,1,2
West Bank and Gaza Strip,2003,sp,014,0,0,0
West Bank and Gaza Strip,2003,sp,1524,1,1,2
West Bank and Gaza Strip,2003,sp,2534,0,1,1
West Bank and Gaza Strip,2003,sp,3544,0,1,1
West Bank and Gaza Strip,2003,sp,4554,3,3,6
West Bank and Gaza Strip,2003,sp,5564,0,0,0
West Bank and Gaza Strip,2003,sp,65,3,2,5
West Bank and Gaza Strip,2004,sp,1524,NA,1,NA
West Bank and Gaza Strip,2004,sp,2534,NA,1,NA
West Bank and Gaza Strip,2004,sp,3544,1,NA,NA
West Bank and Gaza Strip,2004,sp,4554,NA,1,NA
West Bank and Gaza Strip,2005,sp,1524,NA,1,NA
West Bank and Gaza Strip,2005,sp,2534,1,NA,NA
West Bank and Gaza Strip,2005,sp,4554,1,1,2
West Bank and Gaza Strip,2005,sp,5564,NA,3,NA
West Bank and Gaza Strip,2006,ep,014,1,0,1
West Bank and Gaza Strip,2006,ep,1524,3,1,4
West Bank and Gaza Strip,2006,ep,2534,0,2,2
West Bank and Gaza Strip,2006,ep,3544,1,2,3
West Bank and Gaza Strip,2006,ep,4554,1,2,3
West Bank and Gaza Strip,2006,ep,5564,1,3,4
West Bank and Gaza Strip,2006,ep,65,0,2,2
West Bank and Gaza Strip,2006,sn,014,0,0,0
West Bank and Gaza Strip,2006,sn,1524,1,0,1
West Bank and Gaza Strip,2006,sn,2534,0,1,1
West Bank and Gaza Strip,2006,sn,3544,0,2,2
West Bank and Gaza Strip,2006,sn,4554,0,1,1
West Bank and Gaza Strip,2006,sn,5564,0,0,0
West Bank and Gaza Strip,2006,sn,65,0,2,2
West Bank and Gaza Strip,2006,sp,014,0,0,0
West Bank and Gaza Strip,2006,sp,1524,0,1,1
West Bank and Gaza Strip,2006,sp,2534,0,3,3
West Bank and Gaza Strip,2006,sp,3544,1,4,5
West Bank and Gaza Strip,2006,sp,4554,1,1,2
West Bank and Gaza Strip,2006,sp,5564,1,1,2
West Bank and Gaza Strip,2006,sp,65,1,2,3
West Bank and Gaza Strip,2007,ep,014,2,3,5
West Bank and Gaza Strip,2007,ep,1524,1,3,4
West Bank and Gaza Strip,2007,ep,2534,1,2,3
West Bank and Gaza Strip,2007,ep,3544,0,0,0
West Bank and Gaza Strip,2007,ep,4554,2,1,3
West Bank and Gaza Strip,2007,ep,5564,2,1,3
West Bank and Gaza Strip,2007,ep,65,0,0,0
West Bank and Gaza Strip,2007,sn,014,0,0,0
West Bank and Gaza Strip,2007,sn,1524,0,1,1
West Bank and Gaza Strip,2007,sn,2534,0,0,0
West Bank and Gaza Strip,2007,sn,3544,0,0,0
West Bank and Gaza Strip,2007,sn,4554,0,0,0
West Bank and Gaza Strip,2007,sn,5564,0,0,0
West Bank and Gaza Strip,2007,sn,65,1,0,1
West Bank and Gaza Strip,2007,sp,014,0,1,1
West Bank and Gaza Strip,2007,sp,1524,0,1,1
West Bank and Gaza Strip,2007,sp,2534,1,3,4
West Bank and Gaza Strip,2007,sp,3544,0,2,2
West Bank and Gaza Strip,2007,sp,4554,0,0,0
West Bank and Gaza Strip,2007,sp,5564,2,3,5
West Bank and Gaza Strip,2007,sp,65,0,1,1
West Bank and Gaza Strip,2008,ep,014,0,0,0
West Bank and Gaza Strip,2008,ep,1524,3,2,5
West Bank and Gaza Strip,2008,ep,2534,0,1,1
West Bank and Gaza Strip,2008,ep,3544,1,1,2
West Bank and Gaza Strip,2008,ep,4554,1,2,3
West Bank and Gaza Strip,2008,ep,5564,1,1,2
West Bank and Gaza Strip,2008,ep,65,2,2,4
West Bank and Gaza Strip,2008,sn,014,0,0,0
West Bank and Gaza Strip,2008,sn,1524,0,1,1
West Bank and Gaza Strip,2008,sn,2534,0,0,0
West Bank and Gaza Strip,2008,sn,3544,0,0,0
West Bank and Gaza Strip,2008,sn,4554,0,0,0
West Bank and Gaza Strip,2008,sn,5564,1,1,2
West Bank and Gaza Strip,2008,sn,65,0,0,0
West Bank and Gaza Strip,2008,sp,014,0,0,0
West Bank and Gaza Strip,2008,sp,1524,2,1,3
West Bank and Gaza Strip,2008,sp,2534,0,1,1
West Bank and Gaza Strip,2008,sp,3544,0,3,3
West Bank and Gaza Strip,2008,sp,4554,1,2,3
West Bank and Gaza Strip,2008,sp,5564,2,2,4
West Bank and Gaza Strip,2008,sp,65,0,2,2
West Bank and Gaza Strip,2009,ep,014,2,0,2
West Bank and Gaza Strip,2009,ep,1524,3,1,4
West Bank and Gaza Strip,2009,ep,2534,0,1,1
West Bank and Gaza Strip,2009,ep,3544,1,1,2
West Bank and Gaza Strip,2009,ep,4554,2,0,2
West Bank and Gaza Strip,2009,ep,5564,1,0,1
West Bank and Gaza Strip,2009,ep,65,2,1,3
West Bank and Gaza Strip,2009,sn,014,0,0,0
West Bank and Gaza Strip,2009,sn,1524,0,0,0
West Bank and Gaza Strip,2009,sn,2534,0,1,1
West Bank and Gaza Strip,2009,sn,3544,1,1,2
West Bank and Gaza Strip,2009,sn,4554,0,0,0
West Bank and Gaza Strip,2009,sn,5564,2,1,3
West Bank and Gaza Strip,2009,sn,65,0,3,3
West Bank and Gaza Strip,2009,sp,014,0,0,0
West Bank and Gaza Strip,2009,sp,1524,0,1,1
West Bank and Gaza Strip,2009,sp,2534,0,3,3
West Bank and Gaza Strip,2009,sp,3544,2,1,3
West Bank and Gaza Strip,2009,sp,4554,0,0,0
West Bank and Gaza Strip,2009,sp,5564,1,0,1
West Bank and Gaza Strip,2009,sp,65,1,1,2
West Bank and Gaza Strip,2010,ep,014,1,2,3
West Bank and Gaza Strip,2010,ep,1524,0,2,2
West Bank and Gaza Strip,2010,ep,2534,1,2,3
West Bank and Gaza Strip,2010,ep,3544,1,1,2
West Bank and Gaza Strip,2010,ep,4554,1,1,2
West Bank and Gaza Strip,2010,ep,5564,0,0,0
West Bank and Gaza Strip,2010,ep,65,0,0,0
West Bank and Gaza Strip,2010,sn,014,0,0,0
West Bank and Gaza Strip,2010,sn,1524,1,0,1
West Bank and Gaza Strip,2010,sn,2534,0,1,1
West Bank and Gaza Strip,2010,sn,3544,0,1,1
West Bank and Gaza Strip,2010,sn,4554,0,0,0
West Bank and Gaza Strip,2010,sn,5564,0,2,2
West Bank and Gaza Strip,2010,sn,65,0,1,1
West Bank and Gaza Strip,2010,sp,014,0,0,0
West Bank and Gaza Strip,2010,sp,1524,0,2,2
West Bank and Gaza Strip,2010,sp,2534,1,0,1
West Bank and Gaza Strip,2010,sp,3544,0,2,2
West Bank and Gaza Strip,2010,sp,4554,1,1,2
West Bank and Gaza Strip,2010,sp,5564,2,1,3
West Bank and Gaza Strip,2010,sp,65,0,3,3
West Bank and Gaza Strip,2011,ep,014,2,3,5
West Bank and Gaza Strip,2011,ep,1524,1,0,1
West Bank and Gaza Strip,2011,ep,2534,1,1,2
West Bank and Gaza Strip,2011,ep,3544,0,1,1
West Bank and Gaza Strip,2011,ep,4554,0,3,3
West Bank and Gaza Strip,2011,ep,5564,0,1,1
West Bank and Gaza Strip,2011,ep,65,0,0,0
West Bank and Gaza Strip,2011,sn,014,0,0,0
West Bank and Gaza Strip,2011,sn,1524,0,0,0
West Bank and Gaza Strip,2011,sn,2534,0,1,1
West Bank and Gaza Strip,2011,sn,3544,0,0,0
West Bank and Gaza Strip,2011,sn,4554,0,1,1
West Bank and Gaza Strip,2011,sn,5564,0,0,0
West Bank and Gaza Strip,2011,sn,65,2,1,3
West Bank and Gaza Strip,2011,sp,014,0,1,1
West Bank and Gaza Strip,2011,sp,1524,0,0,0
West Bank and Gaza Strip,2011,sp,2534,1,1,2
West Bank and Gaza Strip,2011,sp,3544,1,1,2
West Bank and Gaza Strip,2011,sp,4554,0,1,1
West Bank and Gaza Strip,2011,sp,5564,2,0,2
West Bank and Gaza Strip,2011,sp,65,0,3,3
West Bank and Gaza Strip,2012,ep,014,0,0,0
West Bank and Gaza Strip,2012,ep,1524,1,2,3
West Bank and Gaza Strip,2012,ep,2534,1,2,3
West Bank and Gaza Strip,2012,ep,3544,0,2,2
West Bank and Gaza Strip,2012,ep,4554,0,0,0
West Bank and Gaza Strip,2012,ep,5564,0,0,0
West Bank and Gaza Strip,2012,ep,65,0,0,0
West Bank and Gaza Strip,2012,sn,014,0,0,0
West Bank and Gaza Strip,2012,sn,1524,0,3,3
West Bank and Gaza Strip,2012,sn,2534,0,1,1
West Bank and Gaza Strip,2012,sn,3544,0,1,1
West Bank and Gaza Strip,2012,sn,4554,0,0,0
West Bank and Gaza Strip,2012,sn,5564,0,0,0
West Bank and Gaza Strip,2012,sn,65,1,0,1
West Bank and Gaza Strip,2012,sp,014,0,0,0
West Bank and Gaza Strip,2012,sp,1524,1,2,3
West Bank and Gaza Strip,2012,sp,2534,1,2,3
West Bank and Gaza Strip,2012,sp,3544,0,1,1
West Bank and Gaza Strip,2012,sp,4554,0,2,2
West Bank and Gaza Strip,2012,sp,5564,1,4,5
West Bank and Gaza Strip,2012,sp,65,1,2,3
Yemen,1995,sp,014,83,57,140
Yemen,1995,sp,1524,420,400,820
Yemen,1995,sp,2534,720,605,1325
Yemen,1995,sp,3544,348,256,604
Yemen,1995,sp,4554,200,201,401
Yemen,1995,sp,5564,106,148,254
Yemen,1995,sp,65,92,45,137
Yemen,1996,sp,014,14,15,29
Yemen,1996,sp,1524,89,91,180
Yemen,1996,sp,2534,100,92,192
Yemen,1996,sp,3544,73,71,144
Yemen,1996,sp,4554,41,45,86
Yemen,1996,sp,5564,14,15,29
Yemen,1996,sp,65,11,12,23
Yemen,1997,sp,014,196,87,283
Yemen,1997,sp,1524,872,307,1179
Yemen,1997,sp,2534,449,1249,1698
Yemen,1997,sp,3544,474,329,803
Yemen,1997,sp,4554,259,213,472
Yemen,1997,sp,5564,71,165,236
Yemen,1997,sp,65,13,34,47
Yemen,1998,sp,014,115,83,198
Yemen,1998,sp,1524,689,718,1407
Yemen,1998,sp,2534,632,698,1330
Yemen,1998,sp,3544,400,491,891
Yemen,1998,sp,4554,294,271,565
Yemen,1998,sp,5564,158,160,318
Yemen,1998,sp,65,72,115,187
Yemen,1999,sp,014,111,96,207
Yemen,1999,sp,1524,557,552,1109
Yemen,1999,sp,2534,532,531,1063
Yemen,1999,sp,3544,426,390,816
Yemen,1999,sp,4554,244,245,489
Yemen,1999,sp,5564,120,161,281
Yemen,1999,sp,65,80,85,165
Yemen,2000,sp,014,161,110,271
Yemen,2000,sp,1524,799,789,1588
Yemen,2000,sp,2534,627,689,1316
Yemen,2000,sp,3544,517,493,1010
Yemen,2000,sp,4554,345,314,659
Yemen,2000,sp,5564,247,255,502
Yemen,2000,sp,65,92,127,219
Yemen,2001,sp,014,154,82,236
Yemen,2001,sp,1524,647,695,1342
Yemen,2001,sp,2534,562,631,1193
Yemen,2001,sp,3544,452,491,943
Yemen,2001,sp,4554,293,350,643
Yemen,2001,sp,5564,192,252,444
Yemen,2001,sp,65,53,114,167
Yemen,2002,sp,014,163,266,429
Yemen,2002,sp,1524,500,650,1150
Yemen,2002,sp,2534,443,559,1002
Yemen,2002,sp,3544,334,377,711
Yemen,2002,sp,4554,244,265,509
Yemen,2002,sp,5564,122,148,270
Yemen,2002,sp,65,71,117,188
Yemen,2003,sp,014,74,40,114
Yemen,2003,sp,1524,470,581,1051
Yemen,2003,sp,2534,426,587,1013
Yemen,2003,sp,3544,317,399,716
Yemen,2003,sp,4554,204,250,454
Yemen,2003,sp,5564,114,154,268
Yemen,2003,sp,65,74,103,177
Yemen,2004,sp,014,72,49,121
Yemen,2004,sp,1524,442,571,1013
Yemen,2004,sp,2534,376,559,935
Yemen,2004,sp,3544,269,377,646
Yemen,2004,sp,4554,160,214,374
Yemen,2004,sp,5564,86,139,225
Yemen,2004,sp,65,44,76,120
Yemen,2005,sp,014,44,48,92
Yemen,2005,sp,1524,426,493,919
Yemen,2005,sp,2534,410,553,963
Yemen,2005,sp,3544,265,366,631
Yemen,2005,sp,4554,181,242,423
Yemen,2005,sp,5564,85,149,234
Yemen,2005,sp,65,39,78,117
Yemen,2006,sp,014,55,29,84
Yemen,2006,sp,1524,435,535,970
Yemen,2006,sp,2534,358,555,913
Yemen,2006,sp,3544,244,358,602
Yemen,2006,sp,4554,166,246,412
Yemen,2006,sp,5564,73,143,216
Yemen,2006,sp,65,42,103,145
Yemen,2007,ep,014,0,0,0
Yemen,2007,ep,1524,0,0,0
Yemen,2007,ep,2534,0,0,0
Yemen,2007,ep,3544,0,0,0
Yemen,2007,ep,4554,0,0,0
Yemen,2007,ep,5564,0,0,0
Yemen,2007,ep,65,0,0,0
Yemen,2007,sn,014,0,0,0
Yemen,2007,sn,1524,0,0,0
Yemen,2007,sn,2534,0,0,0
Yemen,2007,sn,3544,0,0,0
Yemen,2007,sn,4554,0,0,0
Yemen,2007,sn,5564,0,0,0
Yemen,2007,sn,65,0,0,0
Yemen,2007,sp,014,50,23,73
Yemen,2007,sp,1524,430,488,918
Yemen,2007,sp,2534,374,626,1000
Yemen,2007,sp,3544,272,379,651
Yemen,2007,sp,4554,189,252,441
Yemen,2007,sp,5564,113,165,278
Yemen,2007,sp,65,57,119,176
Yemen,2008,sp,014,57,29,86
Yemen,2008,sp,1524,473,547,1020
Yemen,2008,sp,2534,455,541,996
Yemen,2008,sp,3544,265,316,581
Yemen,2008,sp,4554,179,241,420
Yemen,2008,sp,5564,102,155,257
Yemen,2008,sp,65,61,119,180
Yemen,2009,sp,014,58,32,90
Yemen,2009,sp,1524,476,509,985
Yemen,2009,sp,2534,437,562,999
Yemen,2009,sp,3544,269,359,628
Yemen,2009,sp,4554,189,248,437
Yemen,2009,sp,5564,90,166,256
Yemen,2009,sp,65,60,121,181
Yemen,2010,ep,014,0,0,0
Yemen,2010,ep,1524,0,0,0
Yemen,2010,ep,2534,0,0,0
Yemen,2010,ep,3544,0,0,0
Yemen,2010,ep,4554,0,0,0
Yemen,2010,ep,5564,0,0,0
Yemen,2010,ep,65,0,0,0
Yemen,2010,sn,014,0,0,0
Yemen,2010,sn,1524,0,0,0
Yemen,2010,sn,2534,0,0,0
Yemen,2010,sn,3544,0,0,0
Yemen,2010,sn,4554,0,0,0
Yemen,2010,sn,5564,0,0,0
Yemen,2010,sn,65,0,0,0
Yemen,2010,sp,014,98,68,166
Yemen,2010,sp,1524,471,507,978
Yemen,2010,sp,2534,409,569,978
Yemen,2010,sp,3544,264,322,586
Yemen,2010,sp,4554,174,231,405
Yemen,2010,sp,5564,106,164,270
Yemen,2010,sp,65,63,138,201
Yemen,2011,sp,014,85,33,118
Yemen,2011,sp,1524,446,406,852
Yemen,2011,sp,2534,375,471,846
Yemen,2011,sp,3544,251,297,548
Yemen,2011,sp,4554,168,193,361
Yemen,2011,sp,5564,113,143,256
Yemen,2011,sp,65,58,96,154
Yemen,2012,ep,014,201,195,396
Yemen,2012,ep,1524,445,308,753
Yemen,2012,ep,2534,448,366,814
Yemen,2012,ep,3544,309,235,544
Yemen,2012,ep,4554,248,178,426
Yemen,2012,ep,5564,156,174,330
Yemen,2012,ep,65,112,111,223
Yemen,2012,sn,014,221,252,473
Yemen,2012,sn,1524,244,216,460
Yemen,2012,sn,2534,262,234,496
Yemen,2012,sn,3544,186,161,347
Yemen,2012,sn,4554,215,175,390
Yemen,2012,sn,5564,172,162,334
Yemen,2012,sn,65,123,185,308
Yemen,2012,sp,014,75,30,105
Yemen,2012,sp,1524,437,436,873
Yemen,2012,sp,2534,381,472,853
Yemen,2012,sp,3544,246,315,561
Yemen,2012,sp,4554,207,232,439
Yemen,2012,sp,5564,115,172,287
Yemen,2012,sp,65,81,122,203
Yemen,2013,rel,014,522,560,1082
Yemen,2013,rel,1524,1194,1011,2205
Yemen,2013,rel,2534,1087,1113,2200
Yemen,2013,rel,3544,825,799,1624
Yemen,2013,rel,4554,736,659,1395
Yemen,2013,rel,5564,512,503,1015
Yemen,2013,rel,65,360,446,806
Zambia,1995,sp,014,129,91,220
Zambia,1995,sp,1524,1125,659,1784
Zambia,1995,sp,2534,1779,1668,3447
Zambia,1995,sp,3544,717,1124,1841
Zambia,1995,sp,4554,257,487,744
Zambia,1995,sp,5564,117,231,348
Zambia,1995,sp,65,63,130,193
Zambia,2000,sp,014,150,349,499
Zambia,2000,sp,1524,932,2175,3107
Zambia,2000,sp,2534,1118,2610,3728
Zambia,2000,sp,3544,1305,3045,4350
Zambia,2000,sp,4554,186,435,621
Zambia,2000,sp,5564,112,261,373
Zambia,2000,sp,65,75,174,249
Zambia,2002,sp,014,1099,1135,2234
Zambia,2002,sp,1524,1383,1013,2396
Zambia,2002,sp,2534,2730,3051,5781
Zambia,2002,sp,3544,1434,2000,3434
Zambia,2002,sp,4554,657,788,1445
Zambia,2002,sp,5564,297,162,459
Zambia,2002,sp,65,197,405,602
Zambia,2003,sp,014,292,302,594
Zambia,2003,sp,1524,2061,1733,3794
Zambia,2003,sp,2534,3439,4182,7621
Zambia,2003,sp,3544,1626,2390,4016
Zambia,2003,sp,4554,680,995,1675
Zambia,2003,sp,5564,297,386,683
Zambia,2003,sp,65,243,308,551
Zambia,2004,sp,014,247,209,456
Zambia,2004,sp,1524,1811,1498,3309
Zambia,2004,sp,2534,2961,3963,6924
Zambia,2004,sp,3544,1646,2262,3908
Zambia,2004,sp,4554,608,968,1576
Zambia,2004,sp,5564,245,313,558
Zambia,2004,sp,65,192,324,516
Zambia,2005,sp,014,168,135,303
Zambia,2005,sp,1524,1507,1240,2747
Zambia,2005,sp,2534,2463,3166,5629
Zambia,2005,sp,3544,1433,2160,3593
Zambia,2005,sp,4554,569,917,1486
Zambia,2005,sp,5564,235,358,593
Zambia,2005,sp,65,185,321,506
Zambia,2006,sp,014,224,150,374
Zambia,2006,sp,1524,1500,945,2445
Zambia,2006,sp,2534,2834,3496,6330
Zambia,2006,sp,3544,1257,1645,2902
Zambia,2006,sp,4554,452,684,1136
Zambia,2006,sp,5564,207,323,530
Zambia,2006,sp,65,122,186,308
Zambia,2007,sp,014,195,152,347
Zambia,2007,sp,1524,1335,1235,2570
Zambia,2007,sp,2534,2193,2971,5164
Zambia,2007,sp,3544,1188,1848,3036
Zambia,2007,sp,4554,558,805,1363
Zambia,2007,sp,5564,244,319,563
Zambia,2007,sp,65,131,204,335
Zambia,2008,sp,014,165,101,266
Zambia,2008,sp,1524,1246,1120,2366
Zambia,2008,sp,2534,2062,3244,5306
Zambia,2008,sp,3544,1114,2094,3208
Zambia,2008,sp,4554,498,737,1235
Zambia,2008,sp,5564,187,299,486
Zambia,2008,sp,65,115,229,344
Zambia,2009,sp,014,145,92,237
Zambia,2009,sp,1524,1051,1057,2108
Zambia,2009,sp,2534,1935,3181,5116
Zambia,2009,sp,3544,1151,2169,3320
Zambia,2009,sp,4554,468,792,1260
Zambia,2009,sp,5564,192,270,462
Zambia,2009,sp,65,126,237,363
Zambia,2011,ep,014,729,800,1529
Zambia,2011,ep,1524,648,530,1178
Zambia,2011,ep,2534,1320,1524,2844
Zambia,2011,ep,3544,910,1459,2369
Zambia,2011,ep,4554,448,625,1073
Zambia,2011,ep,5564,256,226,482
Zambia,2011,ep,65,196,237,433
Zambia,2011,sn,014,970,1057,2027
Zambia,2011,sn,1524,1128,987,2115
Zambia,2011,sn,2534,2625,3731,6356
Zambia,2011,sn,3544,1836,3387,5223
Zambia,2011,sn,4554,849,1387,2236
Zambia,2011,sn,5564,422,672,1094
Zambia,2011,sn,65,362,591,953
Zambia,2011,sp,014,151,105,256
Zambia,2011,sp,1524,940,1033,1973
Zambia,2011,sp,2534,1683,2897,4580
Zambia,2011,sp,3544,1063,2194,3257
Zambia,2011,sp,4554,422,810,1232
Zambia,2011,sp,5564,162,280,442
Zambia,2011,sp,65,99,207,306
Zambia,2012,ep,014,630,744,1374
Zambia,2012,ep,1524,616,526,1142
Zambia,2012,ep,2534,1196,1423,2619
Zambia,2012,ep,3544,808,1364,2172
Zambia,2012,ep,4554,403,577,980
Zambia,2012,ep,5564,209,272,481
Zambia,2012,ep,65,158,248,406
Zambia,2012,sn,014,785,852,1637
Zambia,2012,sn,1524,983,855,1838
Zambia,2012,sn,2534,2131,3103,5234
Zambia,2012,sn,3544,1637,2877,4514
Zambia,2012,sn,4554,777,1252,2029
Zambia,2012,sn,5564,380,568,948
Zambia,2012,sn,65,314,536,850
Zambia,2012,sp,014,180,141,321
Zambia,2012,sp,1524,1024,1003,2027
Zambia,2012,sp,2534,1646,3088,4734
Zambia,2012,sp,3544,1077,2412,3489
Zambia,2012,sp,4554,376,846,1222
Zambia,2012,sp,5564,189,319,508
Zambia,2012,sp,65,124,220,344
Zambia,2013,rel,014,1517,1637,3154
Zambia,2013,rel,1524,2709,2428,5137
Zambia,2013,rel,2534,5157,7808,12965
Zambia,2013,rel,3544,3752,6918,10670
Zambia,2013,rel,4554,1754,2950,4704
Zambia,2013,rel,5564,941,1286,2227
Zambia,2013,rel,65,669,1112,1781
Zimbabwe,2002,sp,014,222,191,413
Zimbabwe,2002,sp,1524,914,600,1514
Zimbabwe,2002,sp,2534,2185,2548,4733
Zimbabwe,2002,sp,3544,1095,1662,2757
Zimbabwe,2002,sp,4554,421,744,1165
Zimbabwe,2002,sp,5564,140,315,455
Zimbabwe,2002,sp,65,65,159,224
Zimbabwe,2003,sp,014,180,133,313
Zimbabwe,2003,sp,1524,1232,874,2106
Zimbabwe,2003,sp,2534,2856,3048,5904
Zimbabwe,2003,sp,3544,1480,2228,3708
Zimbabwe,2003,sp,4554,565,981,1546
Zimbabwe,2003,sp,5564,225,367,592
Zimbabwe,2003,sp,65,114,205,319
Zimbabwe,2004,sp,014,225,187,412
Zimbabwe,2004,sp,1524,1140,833,1973
Zimbabwe,2004,sp,2534,2858,2908,5766
Zimbabwe,2004,sp,3544,1565,2298,3863
Zimbabwe,2004,sp,4554,622,1056,1678
Zimbabwe,2004,sp,5564,214,366,580
Zimbabwe,2004,sp,65,111,198,309
Zimbabwe,2005,sp,014,269,210,479
Zimbabwe,2005,sp,1524,1136,837,1973
Zimbabwe,2005,sp,2534,2242,2264,4506
Zimbabwe,2005,sp,3544,1255,1855,3110
Zimbabwe,2005,sp,4554,578,762,1340
Zimbabwe,2005,sp,5564,193,295,488
Zimbabwe,2005,sp,65,603,656,1259
Zimbabwe,2006,ep,014,278,288,566
Zimbabwe,2006,ep,1524,403,253,656
Zimbabwe,2006,ep,2534,1129,1024,2153
Zimbabwe,2006,ep,3544,821,1001,1822
Zimbabwe,2006,ep,4554,384,434,818
Zimbabwe,2006,ep,5564,148,177,325
Zimbabwe,2006,ep,65,92,127,219
Zimbabwe,2006,sn,014,1458,1558,3016
Zimbabwe,2006,sn,1524,1217,699,1916
Zimbabwe,2006,sn,2534,4013,3268,7281
Zimbabwe,2006,sn,3544,2806,3394,6200
Zimbabwe,2006,sn,4554,1400,1729,3129
Zimbabwe,2006,sn,5564,577,804,1381
Zimbabwe,2006,sn,65,309,543,852
Zimbabwe,2006,sp,014,237,215,452
Zimbabwe,2006,sp,1524,1020,736,1756
Zimbabwe,2006,sp,2534,2424,2391,4815
Zimbabwe,2006,sp,3544,1355,1939,3294
Zimbabwe,2006,sp,4554,632,896,1528
Zimbabwe,2006,sp,5564,230,348,578
Zimbabwe,2006,sp,65,96,199,295
Zimbabwe,2007,ep,014,193,241,434
Zimbabwe,2007,ep,1524,2670,2949,5619
Zimbabwe,2007,ep,2534,120,98,218
Zimbabwe,2007,ep,3544,0,0,0
Zimbabwe,2007,ep,4554,27,30,57
Zimbabwe,2007,ep,5564,12,18,30
Zimbabwe,2007,ep,65,9,14,23
Zimbabwe,2007,sn,014,3329,2347,5676
Zimbabwe,2007,sn,1524,7692,6460,14152
Zimbabwe,2007,sn,2534,748,740,1488
Zimbabwe,2007,sn,3544,0,0,0
Zimbabwe,2007,sn,4554,144,222,366
Zimbabwe,2007,sn,5564,82,89,171
Zimbabwe,2007,sn,65,46,65,111
Zimbabwe,2007,sp,014,185,138,323
Zimbabwe,2007,sp,1524,739,500,1239
Zimbabwe,2007,sp,2534,3311,3693,7004
Zimbabwe,2007,sp,3544,0,0,0
Zimbabwe,2007,sp,4554,553,716,1269
Zimbabwe,2007,sp,5564,213,292,505
Zimbabwe,2007,sp,65,90,153,243
Zimbabwe,2008,ep,014,224,222,446
Zimbabwe,2008,ep,1524,394,252,646
Zimbabwe,2008,ep,2534,0,0,0
Zimbabwe,2008,ep,3544,1622,1862,3484
Zimbabwe,2008,ep,4554,322,457,779
Zimbabwe,2008,ep,5564,142,183,325
Zimbabwe,2008,ep,65,104,147,251
Zimbabwe,2008,sn,014,1262,1364,2626
Zimbabwe,2008,sn,1524,1263,837,2100
Zimbabwe,2008,sn,2534,0,0,0
Zimbabwe,2008,sn,3544,5639,5521,11160
Zimbabwe,2008,sn,4554,1129,1388,2517
Zimbabwe,2008,sn,5564,490,613,1103
Zimbabwe,2008,sn,65,303,490,793
Zimbabwe,2008,sp,014,145,127,272
Zimbabwe,2008,sp,1524,840,614,1454
Zimbabwe,2008,sp,2534,0,0,0
Zimbabwe,2008,sp,3544,2890,3316,6206
Zimbabwe,2008,sp,4554,467,704,1171
Zimbabwe,2008,sp,5564,174,263,437
Zimbabwe,2008,sp,65,105,185,290
Zimbabwe,2009,ep,014,210,244,454
Zimbabwe,2009,ep,1524,394,266,660
Zimbabwe,2009,ep,2534,0,0,0
Zimbabwe,2009,ep,3544,1944,1922,3866
Zimbabwe,2009,ep,4554,438,491,929
Zimbabwe,2009,ep,5564,182,231,413
Zimbabwe,2009,ep,65,138,223,361
Zimbabwe,2009,sn,014,1425,1560,2985
Zimbabwe,2009,sn,1524,1334,860,2194
Zimbabwe,2009,sn,3544,7023,6496,13519
Zimbabwe,2009,sn,4554,1551,1655,3206
Zimbabwe,2009,sn,5564,729,882,1611
Zimbabwe,2009,sn,65,514,861,1375
Zimbabwe,2009,sp,014,180,125,305
Zimbabwe,2009,sp,1524,873,578,1451
Zimbabwe,2009,sp,3544,3028,3471,6499
Zimbabwe,2009,sp,4554,419,681,1100
Zimbabwe,2009,sp,5564,229,293,522
Zimbabwe,2009,sp,65,126,192,318
Zimbabwe,2010,ep,014,220,270,490
Zimbabwe,2010,ep,1524,319,243,562
Zimbabwe,2010,ep,2534,1058,902,1960
Zimbabwe,2010,ep,3544,677,868,1545
Zimbabwe,2010,ep,4554,338,418,756
Zimbabwe,2010,ep,5564,181,229,410
Zimbabwe,2010,ep,65,146,192,338
Zimbabwe,2010,sn,014,1732,1826,3558
Zimbabwe,2010,sn,1524,1282,821,2103
Zimbabwe,2010,sn,2534,4013,3342,7355
Zimbabwe,2010,sn,3544,2851,3270,6121
Zimbabwe,2010,sn,4554,1377,1545,2922
Zimbabwe,2010,sn,5564,789,882,1671
Zimbabwe,2010,sn,65,563,864,1427
Zimbabwe,2010,sp,014,173,150,323
Zimbabwe,2010,sp,1524,974,710,1684
Zimbabwe,2010,sp,2534,2185,2208,4393
Zimbabwe,2010,sp,3544,1283,1682,2965
Zimbabwe,2010,sp,4554,490,761,1251
Zimbabwe,2010,sp,5564,265,350,615
Zimbabwe,2010,sp,65,171,252,423
Zimbabwe,2011,ep,014,209,250,459
Zimbabwe,2011,ep,1524,318,195,513
Zimbabwe,2011,ep,2534,802,746,1548
Zimbabwe,2011,ep,3544,640,796,1436
Zimbabwe,2011,ep,4554,284,342,626
Zimbabwe,2011,ep,5564,137,172,309
Zimbabwe,2011,ep,65,129,172,301
Zimbabwe,2011,sn,014,1271,1364,2635
Zimbabwe,2011,sn,1524,947,596,1543
Zimbabwe,2011,sn,2534,2754,2473,5227
Zimbabwe,2011,sn,3544,2216,2813,5029
Zimbabwe,2011,sn,4554,962,1264,2226
Zimbabwe,2011,sn,5564,587,702,1289
Zimbabwe,2011,sn,65,495,728,1223
Zimbabwe,2011,sp,014,174,152,326
Zimbabwe,2011,sp,1524,1084,784,1868
Zimbabwe,2011,sp,2534,2161,2467,4628
Zimbabwe,2011,sp,3544,1386,2071,3457
Zimbabwe,2011,sp,4554,448,780,1228
Zimbabwe,2011,sp,5564,274,377,651
Zimbabwe,2011,sp,65,160,278,438
Zimbabwe,2012,ep,014,208,233,441
Zimbabwe,2012,ep,1524,319,214,533
Zimbabwe,2012,ep,2534,710,658,1368
Zimbabwe,2012,ep,3544,579,789,1368
Zimbabwe,2012,ep,4554,228,331,559
Zimbabwe,2012,ep,5564,140,178,318
Zimbabwe,2012,ep,65,143,182,325
Zimbabwe,2012,sn,014,1008,1169,2177
Zimbabwe,2012,sn,1524,888,613,1501
Zimbabwe,2012,sn,2534,2287,2302,4589
Zimbabwe,2012,sn,3544,1957,2657,4614
Zimbabwe,2012,sn,4554,829,1154,1983
Zimbabwe,2012,sn,5564,516,708,1224
Zimbabwe,2012,sn,65,432,796,1228
Zimbabwe,2012,sp,014,173,120,293
Zimbabwe,2012,sp,1524,939,783,1722
Zimbabwe,2012,sp,2534,2053,2421,4474
Zimbabwe,2012,sp,3544,1286,2086,3372
Zimbabwe,2012,sp,4554,483,796,1279
Zimbabwe,2012,sp,5564,231,360,591
Zimbabwe,2012,sp,65,161,271,432
Zimbabwe,2013,rel,014,1252,1315,2567
Zimbabwe,2013,rel,1524,2069,1642,3711
Zimbabwe,2013,rel,2534,4649,5331,9980
Zimbabwe,2013,rel,3544,3526,5363,8889
Zimbabwe,2013,rel,4554,1453,2349,3802
Zimbabwe,2013,rel,5564,811,1206,2017
Zimbabwe,2013,rel,65,725,1208,1933
